//MAP CONVERTED BY dmm2tgm.py THIS HEADER COMMENT PREVENTS RECONVERSION, DO NOT REMOVE
"a" = (
/obj/structure/window/reinforced/holowindow{
	dir = 8
	},
/turf/simulated/floor/holofloor/tiled/dark,
/area/holodeck/source_boxingcourt)
"d" = (
/obj/structure/table/holotable,
/obj/item/clothing/gloves/boxing/hologlove,
/turf/simulated/floor/holofloor/tiled/dark,
/area/holodeck/source_boxingcourt)
"e" = (
/obj/effect/floor_decal/corner/red/full{
	dir = 8
	},
/turf/simulated/floor/holofloor/tiled,
/area/holodeck/source_boxingcourt)
"h" = (
/obj/structure/table/holotable,
/obj/item/clothing/gloves/boxing/hologlove{
	icon_state = "boxinggreen";
	item_state = "boxinggreen"
	},
/turf/simulated/floor/holofloor/tiled/dark,
/area/holodeck/source_boxingcourt)
"j" = (
/obj/effect/floor_decal/corner/red{
	dir = 5
	},
/turf/simulated/floor/holofloor/tiled,
/area/holodeck/source_boxingcourt)
"m" = (
/obj/effect/floor_decal/corner/red{
	dir = 9
	},
/turf/simulated/floor/holofloor/tiled,
/area/holodeck/source_boxingcourt)
"p" = (
/obj/effect/floor_decal/corner/blue/full,
/turf/simulated/floor/holofloor/tiled,
/area/holodeck/source_boxingcourt)
"q" = (
/turf/simulated/floor/holofloor/tiled,
/area/holodeck/source_boxingcourt)
"r" = (
/obj/effect/floor_decal/corner/green{
	dir = 6
	},
/turf/simulated/floor/holofloor/tiled,
/area/holodeck/source_boxingcourt)
"s" = (
/obj/effect/floor_decal/corner/blue/full{
	dir = 4
	},
/turf/simulated/floor/holofloor/tiled,
/area/holodeck/source_boxingcourt)
"t" = (
/obj/structure/holostool,
/turf/simulated/floor/holofloor/tiled/dark,
/area/holodeck/source_boxingcourt)
"u" = (
/obj/structure/window/reinforced/holowindow{
	dir = 4
	},
/turf/simulated/floor/holofloor/tiled/dark,
/area/holodeck/source_boxingcourt)
"x" = (
/obj/machinery/door/window/holowindoor{
	dir = 1;
	name = "Green Corner"
	},
/turf/simulated/floor/holofloor/tiled/dark,
/area/holodeck/source_boxingcourt)
"y" = (
/obj/effect/floor_decal/corner/green{
	dir = 10
	},
/turf/simulated/floor/holofloor/tiled,
/area/holodeck/source_boxingcourt)
"A" = (
/obj/structure/window/reinforced/holowindow,
/turf/simulated/floor/holofloor/tiled/dark,
/area/holodeck/source_boxingcourt)
"B" = (
/obj/effect/floor_decal/corner/blue/full{
	dir = 8
	},
/turf/simulated/floor/holofloor/tiled,
/area/holodeck/source_boxingcourt)
"G" = (
/turf/simulated/floor/holofloor/tiled/dark,
/area/holodeck/source_boxingcourt)
"H" = (
/obj/machinery/door/window/holowindoor{
	base_state = "right";
	icon_state = "right";
	name = "Red Corner"
	},
/turf/simulated/floor/holofloor/tiled/dark,
/area/holodeck/source_boxingcourt)
"S" = (
/obj/effect/floor_decal/corner/green/full{
	dir = 4
	},
/turf/simulated/floor/holofloor/tiled,
/area/holodeck/source_boxingcourt)
"T" = (
/obj/effect/floor_decal/corner/blue/full{
	dir = 1
	},
/turf/simulated/floor/holofloor/tiled,
/area/holodeck/source_boxingcourt)
"V" = (
/obj/structure/window/reinforced/holowindow{
	dir = 1
	},
/turf/simulated/floor/holofloor/tiled/dark,
/area/holodeck/source_boxingcourt)

(1,1,1) = {"
d
G
G
G
G
G
G
G
G
G
"}
(2,1,1) = {"
d
G
G
t
t
t
t
G
G
G
"}
(3,1,1) = {"
G
G
G
u
u
u
u
G
G
G
"}
(4,1,1) = {"
G
G
H
e
m
m
q
V
t
G
"}
(5,1,1) = {"
G
t
A
j
B
p
y
V
t
G
"}
(6,1,1) = {"
G
t
A
j
T
s
y
V
t
G
"}
(7,1,1) = {"
G
t
A
q
r
r
S
x
G
G
"}
(8,1,1) = {"
G
G
G
a
a
a
a
G
G
G
"}
(9,1,1) = {"
G
G
G
t
t
t
t
G
G
h
"}
(10,1,1) = {"
G
G
G
G
G
G
G
G
G
h
"}
