//MAP CONVERTED BY dmm2tgm.py THIS HEADER COMMENT PREVENTS RECONVERSION, DO NOT REMOVE
"a" = (
/turf/simulated/floor/tiled/white,
/area/holodeck/source_chess)
"b" = (
/obj/item/chess/wrook,
/turf/simulated/floor/tiled/white,
/area/holodeck/source_chess)
"g" = (
/obj/item/chess/bpawn,
/turf/simulated/floor/holofloor/tiled/dark,
/area/holodeck/source_chess)
"j" = (
/obj/item/chess/wpawn,
/turf/simulated/floor/tiled/white,
/area/holodeck/source_chess)
"k" = (
/obj/effect/floor_decal/sign/a,
/turf/simulated/floor/holofloor/wood,
/area/holodeck/source_chess)
"m" = (
/obj/item/chess/bknight,
/turf/simulated/floor/holofloor/tiled/dark,
/area/holodeck/source_chess)
"n" = (
/obj/item/chess/wrook,
/turf/simulated/floor/holofloor/tiled/dark,
/area/holodeck/source_chess)
"o" = (
/obj/item/chess/bbishop,
/turf/simulated/floor/tiled/white,
/area/holodeck/source_chess)
"p" = (
/obj/item/chess/wking,
/turf/simulated/floor/holofloor/tiled/dark,
/area/holodeck/source_chess)
"t" = (
/obj/effect/floor_decal/sign/dock/three,
/turf/simulated/floor/holofloor/wood,
/area/holodeck/source_chess)
"v" = (
/obj/item/chess/brook,
/turf/simulated/floor/tiled/white,
/area/holodeck/source_chess)
"y" = (
/obj/item/chess/wpawn,
/turf/simulated/floor/holofloor/tiled/dark,
/area/holodeck/source_chess)
"z" = (
/obj/item/chess/wqueen,
/turf/simulated/floor/tiled/white,
/area/holodeck/source_chess)
"A" = (
/turf/simulated/floor/holofloor/wood,
/area/holodeck/source_chess)
"B" = (
/obj/effect/floor_decal/sign/b,
/turf/simulated/floor/holofloor/wood,
/area/holodeck/source_chess)
"E" = (
/obj/item/chess/bpawn,
/turf/simulated/floor/tiled/white,
/area/holodeck/source_chess)
"G" = (
/obj/item/chess/brook,
/turf/simulated/floor/holofloor/tiled/dark,
/area/holodeck/source_chess)
"H" = (
/obj/effect/floor_decal/sign/dock/two,
/turf/simulated/floor/holofloor/wood,
/area/holodeck/source_chess)
"I" = (
/obj/item/chess/bqueen,
/turf/simulated/floor/holofloor/tiled/dark,
/area/holodeck/source_chess)
"K" = (
/obj/item/chess/wknight,
/turf/simulated/floor/holofloor/tiled/dark,
/area/holodeck/source_chess)
"M" = (
/obj/item/chess/bknight,
/turf/simulated/floor/tiled/white,
/area/holodeck/source_chess)
"N" = (
/obj/item/chess/bbishop,
/turf/simulated/floor/holofloor/tiled/dark,
/area/holodeck/source_chess)
"P" = (
/turf/simulated/floor/holofloor/tiled/dark,
/area/holodeck/source_chess)
"R" = (
/obj/item/chess/wbishop,
/turf/simulated/floor/holofloor/tiled/dark,
/area/holodeck/source_chess)
"S" = (
/obj/item/chess/wbishop,
/turf/simulated/floor/tiled/white,
/area/holodeck/source_chess)
"T" = (
/obj/effect/floor_decal/sign/dock/one,
/turf/simulated/floor/holofloor/wood,
/area/holodeck/source_chess)
"V" = (
/obj/effect/floor_decal/sign/c,
/turf/simulated/floor/holofloor/wood,
/area/holodeck/source_chess)
"W" = (
/obj/item/chess/bking,
/turf/simulated/floor/tiled/white,
/area/holodeck/source_chess)
"Z" = (
/obj/item/chess/wknight,
/turf/simulated/floor/tiled/white,
/area/holodeck/source_chess)

(1,1,1) = {"
A
A
A
A
A
A
t
H
T
A
"}
(2,1,1) = {"
A
G
E
P
a
P
a
y
b
k
"}
(3,1,1) = {"
A
M
g
a
P
a
P
j
K
B
"}
(4,1,1) = {"
A
N
E
P
a
P
a
y
S
V
"}
(5,1,1) = {"
A
W
g
a
P
a
P
j
p
A
"}
(6,1,1) = {"
A
I
E
P
a
P
a
y
z
A
"}
(7,1,1) = {"
A
o
g
a
P
a
P
j
R
A
"}
(8,1,1) = {"
A
m
E
P
a
P
a
y
Z
A
"}
(9,1,1) = {"
A
v
g
a
P
a
P
j
n
A
"}
(10,1,1) = {"
A
A
A
A
A
A
A
A
A
A
"}
