//MAP CONVERTED BY dmm2tgm.py THIS HEADER COMMENT PREVENTS RECONVERSION, DO NOT REMOVE
"a" = (
/obj/structure/holostool,
/turf/simulated/floor/holofloor/tiled,
/area/holodeck/source_emptycourt)
"d" = (
/obj/effect/floor_decal/corner/green{
	dir = 6
	},
/turf/simulated/floor/holofloor/tiled,
/area/holodeck/source_emptycourt)
"e" = (
/obj/effect/floor_decal/corner/green/full,
/turf/simulated/floor/holofloor/tiled,
/area/holodeck/source_emptycourt)
"g" = (
/obj/effect/floor_decal/corner/red{
	dir = 6
	},
/turf/simulated/floor/holofloor/tiled,
/area/holodeck/source_emptycourt)
"p" = (
/obj/effect/floor_decal/corner/green{
	dir = 9
	},
/turf/simulated/floor/holofloor/tiled,
/area/holodeck/source_emptycourt)
"r" = (
/obj/structure/holostool,
/obj/structure/window/reinforced/holowindow{
	dir = 4
	},
/turf/simulated/floor/holofloor/tiled,
/area/holodeck/source_emptycourt)
"z" = (
/turf/simulated/floor/holofloor/tiled,
/area/holodeck/source_emptycourt)
"A" = (
/obj/machinery/door/window/holowindoor{
	dir = 4;
	name = "Red Team"
	},
/turf/simulated/floor/holofloor/tiled/dark,
/area/holodeck/source_emptycourt)
"D" = (
/obj/effect/floor_decal/corner/red{
	dir = 5
	},
/turf/simulated/floor/holofloor/tiled,
/area/holodeck/source_emptycourt)
"E" = (
/obj/machinery/door/window/holowindoor{
	base_state = "right";
	dir = 4;
	icon_state = "right";
	name = "Green Team"
	},
/turf/simulated/floor/holofloor/tiled/dark,
/area/holodeck/source_emptycourt)
"F" = (
/turf/simulated/floor/holofloor/tiled/dark,
/area/holodeck/source_emptycourt)
"H" = (
/obj/effect/floor_decal/corner/green/full{
	dir = 4
	},
/turf/simulated/floor/holofloor/tiled,
/area/holodeck/source_emptycourt)
"O" = (
/obj/effect/floor_decal/corner/green{
	dir = 10
	},
/turf/simulated/floor/holofloor/tiled,
/area/holodeck/source_emptycourt)
"P" = (
/obj/effect/floor_decal/corner/red/full{
	dir = 8
	},
/turf/simulated/floor/holofloor/tiled,
/area/holodeck/source_emptycourt)
"V" = (
/obj/effect/floor_decal/corner/red{
	dir = 9
	},
/turf/simulated/floor/holofloor/tiled,
/area/holodeck/source_emptycourt)
"Y" = (
/obj/effect/floor_decal/corner/red/full{
	dir = 1
	},
/turf/simulated/floor/holofloor/tiled,
/area/holodeck/source_emptycourt)

(1,1,1) = {"
F
F
F
F
F
F
F
F
F
F
"}
(2,1,1) = {"
a
a
F
a
a
a
a
F
a
a
"}
(3,1,1) = {"
r
r
A
r
r
r
r
E
r
r
"}
(4,1,1) = {"
P
V
V
V
V
p
p
p
p
e
"}
(5,1,1) = {"
D
z
z
z
z
z
z
z
z
O
"}
(6,1,1) = {"
D
z
z
z
z
z
z
z
z
O
"}
(7,1,1) = {"
D
z
z
z
z
z
z
z
z
O
"}
(8,1,1) = {"
D
z
z
z
z
z
z
z
z
O
"}
(9,1,1) = {"
D
z
z
z
z
z
z
z
z
O
"}
(10,1,1) = {"
Y
g
g
g
g
d
d
d
d
H
"}
