//MAP CONVERTED BY dmm2tgm.py THIS HEADER COMMENT PREVENTS RECONVERSION, DO NOT REMOVE
"a" = (
/turf/simulated/floor/holofloor/lino,
/area/holodeck/source_meetinghall)
"d" = (
/obj/structure/holostool,
/obj/effect/floor_decal/carpet{
	dir = 4
	},
/obj/effect/floor_decal/carpet{
	dir = 1
	},
/obj/effect/floor_decal/carpet{
	dir = 5
	},
/turf/simulated/floor/holofloor/carpet,
/area/holodeck/source_meetinghall)
"h" = (
/obj/structure/table/woodentable/holotable,
/turf/simulated/floor/holofloor/wood,
/area/holodeck/source_meetinghall)
"m" = (
/turf/simulated/floor/holofloor/tiled/dark,
/area/holodeck/source_meetinghall)
"n" = (
/obj/structure/holostool,
/obj/effect/floor_decal/carpet{
	dir = 1
	},
/turf/simulated/floor/holofloor/carpet,
/area/holodeck/source_meetinghall)
"v" = (
/obj/effect/floor_decal/carpet,
/obj/effect/floor_decal/carpet{
	dir = 1
	},
/turf/simulated/floor/holofloor/carpet,
/area/holodeck/source_meetinghall)
"w" = (
/obj/structure/holostool,
/obj/effect/floor_decal/carpet,
/obj/effect/floor_decal/carpet{
	dir = 4
	},
/obj/effect/floor_decal/carpet{
	dir = 6
	},
/turf/simulated/floor/holofloor/carpet,
/area/holodeck/source_meetinghall)
"x" = (
/obj/structure/holostool,
/obj/effect/floor_decal/carpet{
	dir = 8
	},
/obj/effect/floor_decal/carpet{
	dir = 1
	},
/obj/effect/floor_decal/carpet{
	dir = 9
	},
/turf/simulated/floor/holofloor/carpet,
/area/holodeck/source_meetinghall)
"z" = (
/obj/effect/floor_decal/carpet{
	dir = 4
	},
/obj/effect/floor_decal/carpet,
/obj/effect/floor_decal/carpet{
	dir = 1
	},
/obj/effect/floor_decal/carpet{
	dir = 5
	},
/obj/effect/floor_decal/carpet{
	dir = 6
	},
/turf/simulated/floor/holofloor/carpet,
/area/holodeck/source_meetinghall)
"A" = (
/obj/structure/holostool,
/obj/effect/floor_decal/carpet{
	dir = 4
	},
/turf/simulated/floor/holofloor/carpet,
/area/holodeck/source_meetinghall)
"E" = (
/obj/structure/holostool,
/obj/effect/floor_decal/carpet,
/turf/simulated/floor/holofloor/carpet,
/area/holodeck/source_meetinghall)
"F" = (
/obj/effect/floor_decal/carpet{
	dir = 8
	},
/obj/effect/floor_decal/carpet,
/obj/effect/floor_decal/carpet{
	dir = 1
	},
/obj/effect/floor_decal/carpet{
	dir = 9
	},
/obj/effect/floor_decal/carpet{
	dir = 10
	},
/turf/simulated/floor/holofloor/carpet,
/area/holodeck/source_meetinghall)
"M" = (
/obj/structure/holostool,
/obj/effect/floor_decal/carpet{
	dir = 4
	},
/turf/simulated/floor/holofloor/carpet{
	dir = 8
	},
/area/holodeck/source_meetinghall)
"N" = (
/obj/structure/holostool,
/turf/simulated/floor/holofloor/carpet,
/area/holodeck/source_meetinghall)
"O" = (
/obj/structure/flora/pottedplant{
	icon_state = "plant-06"
	},
/turf/simulated/floor/holofloor/wood,
/area/holodeck/source_meetinghall)
"P" = (
/obj/structure/holostool,
/obj/effect/floor_decal/carpet{
	dir = 8
	},
/turf/simulated/floor/holofloor/carpet,
/area/holodeck/source_meetinghall)
"Q" = (
/turf/simulated/floor/holofloor/wood,
/area/holodeck/source_meetinghall)
"U" = (
/obj/effect/floor_decal/carpet{
	dir = 5
	},
/obj/effect/floor_decal/carpet{
	dir = 6
	},
/obj/effect/floor_decal/carpet{
	dir = 9
	},
/obj/effect/floor_decal/carpet{
	dir = 10
	},
/turf/simulated/floor/holofloor/carpet,
/area/holodeck/source_meetinghall)
"Y" = (
/obj/structure/holostool,
/obj/effect/floor_decal/carpet{
	dir = 8
	},
/obj/effect/floor_decal/carpet,
/obj/effect/floor_decal/carpet{
	dir = 10
	},
/turf/simulated/floor/holofloor/carpet,
/area/holodeck/source_meetinghall)

(1,1,1) = {"
Q
Q
Q
a
U
U
a
a
a
a
"}
(2,1,1) = {"
Q
Q
Q
a
x
P
P
P
Y
a
"}
(3,1,1) = {"
Q
F
h
a
n
N
N
N
E
a
"}
(4,1,1) = {"
Q
v
h
a
n
N
N
N
E
a
"}
(5,1,1) = {"
Q
v
h
a
n
N
N
N
E
a
"}
(6,1,1) = {"
Q
v
h
a
n
N
N
N
E
a
"}
(7,1,1) = {"
Q
z
h
a
n
N
N
N
E
a
"}
(8,1,1) = {"
Q
Q
Q
a
d
A
A
M
w
a
"}
(9,1,1) = {"
Q
Q
Q
a
a
a
a
a
a
a
"}
(10,1,1) = {"
O
Q
Q
m
m
m
m
m
m
m
"}
