//MAP CONVERTED BY dmm2tgm.py THIS HEADER COMMENT PREVENTS RECONVERSION, DO NOT REMOVE
"a" = (
/obj/structure/flora/ausbushes/ywflowers,
/obj/effect/floor_decal/spline/fancy/wood{
	dir = 1
	},
/turf/simulated/floor/holofloor/grass,
/area/template_noop)
"d" = (
/obj/structure/flora/ausbushes/brflowers,
/obj/effect/floor_decal/spline/fancy/wood{
	dir = 8
	},
/turf/simulated/floor/holofloor/grass,
/area/template_noop)
"e" = (
/obj/structure/flora/ausbushes/ywflowers,
/obj/effect/floor_decal/spline/fancy/wood,
/obj/effect/floor_decal/spline/fancy/wood{
	dir = 6
	},
/turf/simulated/floor/holofloor/grass,
/area/template_noop)
"h" = (
/obj/structure/flora/ausbushes/ywflowers,
/obj/effect/floor_decal/spline/fancy/wood{
	dir = 1
	},
/obj/effect/floor_decal/spline/fancy/wood{
	dir = 5
	},
/turf/simulated/floor/holofloor/grass,
/area/template_noop)
"o" = (
/turf/simulated/floor/holofloor/desert,
/area/template_noop)
"q" = (
/obj/structure/flora/ausbushes/sparsegrass,
/turf/simulated/floor/holofloor/grass,
/area/template_noop)
"r" = (
/obj/structure/table/woodentable/holotable,
/turf/simulated/floor/holofloor/desert,
/area/template_noop)
"w" = (
/obj/effect/debris/cleanable/dirt,
/obj/structure/holostool,
/turf/simulated/floor/holofloor/desert,
/area/template_noop)
"x" = (
/obj/structure/flora/ausbushes/ywflowers,
/obj/effect/floor_decal/spline/fancy/wood{
	dir = 4
	},
/turf/simulated/floor/holofloor/grass,
/area/template_noop)
"y" = (
/obj/structure/flora/ausbushes/ywflowers,
/turf/simulated/floor/holofloor/grass,
/area/template_noop)
"A" = (
/obj/structure/flora/ausbushes/brflowers,
/obj/effect/floor_decal/spline/fancy/wood{
	dir = 4
	},
/turf/simulated/floor/holofloor/grass,
/area/template_noop)
"B" = (
/obj/structure/flora/ausbushes/brflowers,
/obj/effect/floor_decal/spline/fancy/wood/corner{
	dir = 1
	},
/turf/simulated/floor/holofloor/grass,
/area/template_noop)
"D" = (
/obj/effect/debris/cleanable/dirt,
/turf/simulated/floor/holofloor/desert,
/area/template_noop)
"I" = (
/obj/structure/flora/ausbushes/brflowers,
/obj/effect/floor_decal/spline/fancy/wood/corner,
/turf/simulated/floor/holofloor/grass,
/area/template_noop)
"L" = (
/obj/structure/flora/ausbushes/brflowers,
/obj/effect/floor_decal/spline/fancy/wood,
/turf/simulated/floor/holofloor/grass,
/area/template_noop)
"N" = (
/obj/structure/flora/ausbushes/ywflowers,
/obj/effect/floor_decal/spline/fancy/wood/corner{
	dir = 4
	},
/turf/simulated/floor/holofloor/grass,
/area/template_noop)
"Q" = (
/obj/structure/flora/ausbushes/fullgrass,
/turf/simulated/floor/holofloor/grass,
/area/template_noop)
"T" = (
/obj/structure/flora/ausbushes/brflowers,
/obj/effect/floor_decal/spline/fancy/wood{
	dir = 1
	},
/turf/simulated/floor/holofloor/grass,
/area/template_noop)
"U" = (
/obj/structure/flora/ausbushes/ywflowers,
/obj/effect/floor_decal/spline/fancy/wood,
/turf/simulated/floor/holofloor/grass,
/area/template_noop)
"W" = (
/obj/structure/flora/ausbushes/brflowers,
/turf/simulated/floor/holofloor/grass,
/area/template_noop)
"Y" = (
/obj/structure/flora/ausbushes/ywflowers,
/obj/effect/floor_decal/spline/fancy/wood/corner{
	dir = 8
	},
/turf/simulated/floor/holofloor/grass,
/area/template_noop)
"Z" = (
/obj/structure/flora/ausbushes/ywflowers,
/obj/effect/floor_decal/spline/fancy/wood{
	dir = 8
	},
/turf/simulated/floor/holofloor/grass,
/area/template_noop)

(1,1,1) = {"
Q
y
W
U
D
D
a
W
y
Q
"}
(2,1,1) = {"
q
W
y
L
D
D
T
y
W
q
"}
(3,1,1) = {"
Q
y
I
e
D
D
h
B
y
Q
"}
(4,1,1) = {"
q
W
U
o
D
D
o
a
W
q
"}
(5,1,1) = {"
Q
y
L
w
r
r
w
T
y
Q
"}
(6,1,1) = {"
Q
W
U
w
r
r
w
a
W
Q
"}
(7,1,1) = {"
q
y
L
D
D
D
D
T
y
q
"}
(8,1,1) = {"
Q
W
Y
d
Z
Z
d
N
W
Q
"}
(9,1,1) = {"
q
y
W
y
W
W
y
W
W
q
"}
(10,1,1) = {"
Q
W
y
A
x
x
A
y
y
Q
"}
