//MAP CONVERTED BY dmm2tgm.py THIS HEADER COMMENT PREVENTS RECONVERSION, DO NOT REMOVE
"a" = (
/obj/effect/floor_decal/corner/green{
	dir = 6
	},
/turf/simulated/floor/holofloor/tiled,
/area/holodeck/source_thunderdomecourt)
"c" = (
/obj/structure/window/reinforced/holowindow/disappearing,
/obj/effect/floor_decal/corner/red/full,
/turf/simulated/floor/holofloor/tiled,
/area/holodeck/source_thunderdomecourt)
"d" = (
/obj/machinery/door/window/holowindoor{
	base_state = "right";
	dir = 4;
	icon_state = "right";
	name = "Green Team"
	},
/turf/simulated/floor/holofloor/tiled/dark,
/area/holodeck/source_thunderdomecourt)
"f" = (
/obj/structure/table/holotable,
/obj/effect/floor_decal/corner/red/full{
	dir = 1
	},
/turf/simulated/floor/holofloor/tiled,
/area/holodeck/source_thunderdomecourt)
"g" = (
/obj/structure/table/holotable,
/obj/machinery/readybutton,
/obj/effect/floor_decal/corner/green/full{
	dir = 4
	},
/turf/simulated/floor/holofloor/tiled,
/area/holodeck/source_thunderdomecourt)
"h" = (
/obj/effect/floor_decal/corner/green{
	dir = 9
	},
/turf/simulated/floor/holofloor/tiled,
/area/holodeck/source_thunderdomecourt)
"i" = (
/obj/structure/window/reinforced/holowindow/disappearing{
	dir = 1
	},
/obj/effect/floor_decal/corner/green/full{
	dir = 8
	},
/turf/simulated/floor/holofloor/tiled,
/area/holodeck/source_thunderdomecourt)
"j" = (
/obj/structure/table/holotable,
/obj/effect/floor_decal/corner/green/full,
/turf/simulated/floor/holofloor/tiled,
/area/holodeck/source_thunderdomecourt)
"o" = (
/obj/structure/window/reinforced/holowindow/disappearing,
/obj/effect/floor_decal/corner/red/full{
	dir = 4
	},
/turf/simulated/floor/holofloor/tiled,
/area/holodeck/source_thunderdomecourt)
"p" = (
/obj/structure/window/reinforced/holowindow/disappearing{
	dir = 1
	},
/obj/effect/floor_decal/corner/green{
	dir = 5
	},
/turf/simulated/floor/holofloor/tiled,
/area/holodeck/source_thunderdomecourt)
"q" = (
/obj/structure/table/holotable,
/obj/item/clothing/head/helmet/thunderdome,
/obj/item/clothing/suit/armor/tdome/green,
/obj/item/clothing/under/color/green,
/obj/item/holo/esword/green,
/obj/effect/floor_decal/corner/green{
	dir = 10
	},
/turf/simulated/floor/holofloor/tiled,
/area/holodeck/source_thunderdomecourt)
"x" = (
/obj/effect/floor_decal/corner/red{
	dir = 9
	},
/turf/simulated/floor/holofloor/tiled,
/area/holodeck/source_thunderdomecourt)
"D" = (
/obj/effect/floor_decal/corner/red{
	dir = 6
	},
/turf/simulated/floor/holofloor/tiled,
/area/holodeck/source_thunderdomecourt)
"F" = (
/obj/structure/window/reinforced/holowindow/disappearing{
	dir = 1
	},
/obj/effect/floor_decal/corner/green/full{
	dir = 1
	},
/turf/simulated/floor/holofloor/tiled,
/area/holodeck/source_thunderdomecourt)
"H" = (
/obj/structure/table/holotable,
/obj/item/clothing/head/helmet/thunderdome,
/obj/item/clothing/suit/armor/tdome/red,
/obj/item/clothing/under/color/red,
/obj/item/holo/esword/red,
/obj/effect/floor_decal/corner/red{
	dir = 5
	},
/turf/simulated/floor/holofloor/tiled,
/area/holodeck/source_thunderdomecourt)
"K" = (
/obj/structure/window/reinforced/holowindow/disappearing,
/obj/effect/floor_decal/corner/red{
	dir = 10
	},
/turf/simulated/floor/holofloor/tiled,
/area/holodeck/source_thunderdomecourt)
"L" = (
/obj/structure/holostool,
/obj/structure/window/reinforced/holowindow{
	dir = 4
	},
/turf/simulated/floor/holofloor/tiled,
/area/holodeck/source_thunderdomecourt)
"N" = (
/turf/simulated/floor/holofloor/tiled/dark,
/area/holodeck/source_thunderdomecourt)
"Q" = (
/obj/structure/holostool,
/turf/simulated/floor/holofloor/tiled,
/area/holodeck/source_thunderdomecourt)
"S" = (
/obj/structure/table/holotable,
/obj/machinery/readybutton,
/obj/effect/floor_decal/corner/red/full{
	dir = 8
	},
/turf/simulated/floor/holofloor/tiled,
/area/holodeck/source_thunderdomecourt)
"V" = (
/obj/machinery/door/window/holowindoor{
	dir = 4;
	name = "Red Team"
	},
/turf/simulated/floor/holofloor/tiled/dark,
/area/holodeck/source_thunderdomecourt)
"W" = (
/turf/simulated/floor/holofloor/tiled,
/area/holodeck/source_thunderdomecourt)

(1,1,1) = {"
N
N
N
N
N
N
N
N
N
N
"}
(2,1,1) = {"
Q
Q
N
Q
Q
Q
Q
N
Q
Q
"}
(3,1,1) = {"
L
L
V
L
L
L
L
d
L
L
"}
(4,1,1) = {"
S
x
x
x
c
i
h
h
h
j
"}
(5,1,1) = {"
H
W
W
W
K
p
W
W
W
q
"}
(6,1,1) = {"
H
W
W
W
K
p
W
W
W
q
"}
(7,1,1) = {"
H
W
W
W
K
p
W
W
W
q
"}
(8,1,1) = {"
H
W
W
W
K
p
W
W
W
q
"}
(9,1,1) = {"
H
W
W
W
K
p
W
W
W
q
"}
(10,1,1) = {"
f
D
D
D
o
F
a
a
a
g
"}
