//MAP CONVERTED BY dmm2tgm.py THIS HEADER COMMENT PREVENTS RECONVERSION, DO NOT REMOVE
"a" = (
/turf/space,
/area/space/debrisfield/misc_debris)
"b" = (
/obj/structure/lattice,
/turf/space,
/area/space/debrisfield/misc_debris)
"J" = (
/obj/structure/lattice,
/obj/mob_spawner/carp,
/turf/space,
/area/space/debrisfield/misc_debris)

(1,1,1) = {"
b
b
a
"}
(2,1,1) = {"
b
b
b
"}
(3,1,1) = {"
J
b
a
"}
