//MAP CONVERTED BY dmm2tgm.py THIS HEADER COMMENT PREVENTS RECONVERSION, DO NOT REMOVE
"aa" = (
/turf/template_noop,
/area/space/debrisfield/explored)
"ab" = (
/turf/simulated/shuttle/wall,
/area/space/debrisfield/explodedship)
"ac" = (
/obj/structure/shuttle/engine/propulsion{
	dir = 1
	},
/turf/simulated/shuttle/plating/airless,
/area/space/debrisfield/explodedship)
"ad" = (
/obj/structure/closet/crate/secure/engineering,
/obj/item/tool/screwdriver/power,
/obj/item/tool/crowbar/power,
/obj/item/tool/screwdriver/power,
/obj/item/tool/crowbar/power,
/obj/effect/debris/cleanable/dirt,
/turf/simulated/shuttle/plating/airless,
/area/space/debrisfield/explodedship)
"ae" = (
/obj/structure/closet/crate/trashcart,
/turf/template_noop,
/area/space/debrisfield/explodedship)
"af" = (
/obj/structure/lattice,
/obj/structure/girder/displaced,
/turf/template_noop,
/area/space/debrisfield/explodedship)
"ag" = (
/obj/effect/debris/cleanable/dirt,
/turf/simulated/shuttle/plating/airless,
/area/space/debrisfield/explodedship)
"ah" = (
/obj/structure/lattice,
/turf/template_noop,
/area/space/debrisfield/explodedship)
"ai" = (
/turf/simulated/shuttle/plating/airless,
/area/space/debrisfield/explodedship)
"aj" = (
/turf/simulated/shuttle/floor/white/airless,
/area/space/debrisfield/explodedship)
"ak" = (
/obj/effect/debris/cleanable/dirt,
/obj/item/material/shard/shrapnel,
/turf/simulated/shuttle/plating/airless,
/area/space/debrisfield/explodedship)
"al" = (
/obj/structure/ghost_pod/manual/lost_drone/dogborg,
/turf/simulated/shuttle/floor/airless,
/area/space/debrisfield/explodedship)
"am" = (
/obj/effect/debris/cleanable/dirt,
/obj/effect/debris/cleanable/blood/oil,
/turf/simulated/shuttle/plating/airless,
/area/space/debrisfield/explodedship)
"an" = (
/obj/structure/girder/displaced,
/turf/template_noop,
/area/space/debrisfield/explodedship)
"ao" = (
/obj/structure/girder/displaced,
/turf/simulated/shuttle/floor/white/airless,
/area/space/debrisfield/explodedship)
"ap" = (
/obj/effect/debris/cleanable/dirt,
/obj/effect/debris/cleanable/generic,
/turf/simulated/shuttle/plating/airless,
/area/space/debrisfield/explodedship)
"aq" = (
/obj/item/stack/material/steel,
/obj/effect/debris/cleanable/dirt,
/turf/simulated/shuttle/plating/airless,
/area/space/debrisfield/explodedship)
"ar" = (
/obj/item/inflatable/torn,
/turf/simulated/shuttle/floor/white/airless,
/area/space/debrisfield/explodedship)
"as" = (
/obj/structure/shuttle/window,
/obj/structure/grille,
/turf/simulated/shuttle/plating/airless,
/area/space/debrisfield/explodedship)
"at" = (
/obj/item/inflatable/door/torn,
/turf/simulated/shuttle/floor/white/airless,
/area/space/debrisfield/explodedship)
"au" = (
/obj/structure/inflatable,
/turf/simulated/shuttle/floor/white/airless,
/area/space/debrisfield/explodedship)
"av" = (
/obj/structure/door_assembly/door_assembly_com{
	anchored = 1
	},
/turf/simulated/shuttle/floor/white/airless,
/area/space/debrisfield/explodedship)
"aw" = (
/obj/structure/lattice,
/obj/item/stack/material/steel,
/turf/template_noop,
/area/space/debrisfield/explodedship)
"ax" = (
/obj/structure/lattice,
/obj/item/stack/material/steel,
/obj/item/material/shard/shrapnel,
/turf/template_noop,
/area/space/debrisfield/explodedship)
"ay" = (
/obj/item/stack/rods,
/turf/template_noop,
/area/space/debrisfield/explodedship)
"az" = (
/obj/structure/girder,
/turf/simulated/shuttle/floor/white/airless,
/area/space/debrisfield/explodedship)
"aA" = (
/turf/simulated/shuttle/floor/airless,
/area/space/debrisfield/explodedship)
"aB" = (
/obj/structure/girder,
/obj/effect/debris/cleanable/dirt,
/turf/simulated/shuttle/plating/airless,
/area/space/debrisfield/explodedship)
"aD" = (
/obj/structure/girder/displaced,
/obj/effect/debris/cleanable/dirt,
/turf/simulated/shuttle/plating/airless,
/area/space/debrisfield/explodedship)
"aE" = (
/obj/structure/lattice,
/obj/effect/debris/cleanable/molten_item,
/turf/template_noop,
/area/space/debrisfield/explodedship)
"aF" = (
/obj/structure/closet/crate/secure/engineering,
/obj/item/weldingtool/experimental,
/obj/item/weldingtool/electric,
/obj/item/weldingtool/electric,
/turf/template_noop,
/area/space/debrisfield/explodedship)
"aG" = (
/obj/item/material/shard/shrapnel,
/turf/template_noop,
/area/space/debrisfield/explodedship)
"aH" = (
/obj/structure/lattice,
/obj/structure/closet/crate/secure/engineering,
/obj/fiftyspawner/plasteel,
/turf/template_noop,
/area/space/debrisfield/explodedship)
"aJ" = (
/obj/structure/grille,
/obj/item/material/shard,
/obj/effect/debris/cleanable/dirt,
/turf/simulated/shuttle/plating/airless,
/area/space/debrisfield/explodedship)
"aK" = (
/obj/item/material/shard,
/obj/effect/debris/cleanable/dirt,
/turf/simulated/shuttle/plating/airless,
/area/space/debrisfield/explodedship)
"aL" = (
/obj/item/inflatable/torn,
/obj/effect/decal/remains,
/obj/item/clothing/under/rank/cargotech,
/obj/item/clothing/head/soft,
/turf/simulated/shuttle/floor/white/airless,
/area/space/debrisfield/explodedship)
"aM" = (
/obj/structure/closet/secure_closet/cargotech{
	name = "cargotech locker";
	req_access = list()
	},
/obj/item/pickaxe/diamonddrill,
/turf/simulated/shuttle/floor/airless,
/area/space/debrisfield/explodedship)
"aN" = (
/obj/structure/closet/emcloset,
/turf/simulated/shuttle/floor/airless,
/area/space/debrisfield/explodedship)
"aO" = (
/obj/item/inflatable/door/torn,
/obj/effect/decal/remains,
/obj/item/clothing/under/rank/cargotech,
/obj/item/clothing/head/soft,
/turf/simulated/shuttle/floor/white/airless,
/area/space/debrisfield/explodedship)
"aP" = (
/obj/machinery/computer/shuttle{
	dir = 4
	},
/turf/simulated/shuttle/floor/airless,
/area/space/debrisfield/explodedship)
"aQ" = (
/obj/structure/bed/chair{
	dir = 8
	},
/turf/simulated/shuttle/floor/white/airless,
/area/space/debrisfield/explodedship)
"aR" = (
/obj/structure/closet/secure_closet/quartermaster{
	name = "quartermaster locker";
	req_access = list()
	},
/obj/item/clothing/under/brandjumpsuit/mbill,
/obj/item/clothing/head/soft/mbill,
/turf/simulated/shuttle/floor/white/airless,
/area/space/debrisfield/explodedship)
"aS" = (
/obj/structure/closet/crate/secure/bin,
/turf/simulated/shuttle/floor/white/airless,
/area/space/debrisfield/explodedship)
"aT" = (
/obj/structure/closet/emcloset,
/obj/mob_spawner/derelict/corrupt_maint_swarm,
/turf/simulated/shuttle/floor/white/airless,
/area/space/debrisfield/explodedship)
"aU" = (
/obj/structure/bed/chair{
	dir = 4
	},
/turf/simulated/shuttle/floor/white/airless,
/area/space/debrisfield/explodedship)
"aV" = (
/obj/machinery/computer/shuttle{
	dir = 8
	},
/turf/simulated/shuttle/floor/airless,
/area/space/debrisfield/explodedship)
"aW" = (
/obj/effect/decal/remains,
/obj/item/clothing/under/brandjumpsuit/mbill,
/obj/item/clothing/head/soft/mbill,
/turf/simulated/shuttle/floor/white/airless,
/area/space/debrisfield/explodedship)
"aX" = (
/obj/structure/bed/chair,
/turf/simulated/shuttle/floor/airless,
/area/space/debrisfield/explodedship)
"aY" = (
/obj/structure/bed/chair/comfy/teal,
/turf/simulated/shuttle/floor/white/airless,
/area/space/debrisfield/explodedship)
"aZ" = (
/obj/machinery/computer/shuttle{
	dir = 1
	},
/turf/simulated/shuttle/floor/airless,
/area/space/debrisfield/explodedship)
"bb" = (
/obj/structure/lattice,
/obj/item/material/shard/shrapnel,
/turf/template_noop,
/area/space/debrisfield/explodedship)
"bc" = (
/obj/structure/lattice,
/obj/effect/debris/cleanable/molten_item,
/obj/item/material/shard/shrapnel,
/turf/template_noop,
/area/space/debrisfield/explodedship)
"bd" = (
/turf/simulated/shuttle/wall/hard_corner,
/area/space/debrisfield/explodedship)
"jk" = (
/obj/machinery/giga_drill,
/turf/simulated/shuttle/floor/airless,
/area/space/debrisfield/explodedship)
"wb" = (
/obj/effect/gibspawner/human,
/turf/simulated/shuttle/floor/white/airless,
/area/space/debrisfield/explodedship)
"FW" = (
/turf/template_noop,
/area/space/debrisfield/explodedship)
"HF" = (
/obj/mob_spawner/derelict/corrupt_maint_swarm,
/turf/simulated/shuttle/floor/airless,
/area/space/debrisfield/explodedship)
"NO" = (
/obj/mob_spawner/derelict/corrupt_maint_swarm,
/turf/simulated/shuttle/floor/white/airless,
/area/space/debrisfield/explodedship)

(1,1,1) = {"
aa
aa
aa
aa
aa
aa
aa
aa
aa
aa
aa
aa
aa
aa
aa
aa
aa
aa
aa
aa
aa
aa
aa
aa
aa
aa
aa
aa
"}
(2,1,1) = {"
aa
ab
ab
ab
ab
ag
ak
FW
FW
FW
ah
bb
ah
ah
aB
aJ
as
ab
ab
as
as
ab
aa
aa
aa
aa
aa
aa
"}
(3,1,1) = {"
aa
ac
bd
ag
ad
am
bb
FW
FW
ah
ah
ah
ah
ah
ap
aK
HF
aN
ab
aP
aP
ab
ab
aa
aa
aa
aa
aa
"}
(4,1,1) = {"
aa
FW
aB
ag
am
ah
aw
bc
FW
FW
FW
FW
aH
ah
ah
ai
aj
aj
ab
aQ
aQ
aA
ab
ab
aa
aa
aa
aa
"}
(5,1,1) = {"
aa
FW
FW
af
FW
FW
FW
FW
FW
FW
aG
FW
ay
ah
ag
aB
ab
ab
ab
aj
wb
aj
aA
ab
as
ab
aa
aa
"}
(6,1,1) = {"
aa
FW
ac
bd
am
ah
FW
aw
FW
FW
FW
FW
bb
ah
ag
ag
ar
au
ab
aR
aj
NO
aj
aX
aZ
as
aa
aa
"}
(7,1,1) = {"
aa
FW
ae
ab
am
ax
ah
ah
FW
FW
an
ah
ah
am
ag
ar
aL
au
ab
aj
aj
aj
aj
aj
aZ
as
aa
aa
"}
(8,1,1) = {"
aa
FW
FW
aD
ah
FW
FW
FW
FW
FW
FW
ah
ah
ag
ap
aj
at
aO
av
aj
aj
aj
aW
aY
aZ
as
aa
aa
"}
(9,1,1) = {"
aa
FW
FW
ab
ah
ah
FW
FW
FW
FW
FW
ah
ag
ag
NO
ar
au
au
ab
aS
aj
wb
aj
aj
aZ
as
aa
aa
"}
(10,1,1) = {"
aa
FW
ac
ab
ap
ah
aG
aF
FW
FW
aG
aE
ap
ag
ao
aj
ar
au
ab
aT
aj
aj
aj
aX
aZ
as
aa
aa
"}
(11,1,1) = {"
aa
FW
ac
ab
aq
ag
bb
FW
FW
FW
aG
ag
aq
ag
ao
aj
az
ab
ab
aj
aj
NO
aA
ab
as
ab
aa
aa
"}
(12,1,1) = {"
aa
FW
ac
ab
aA
aD
ah
FW
ay
FW
ag
ag
ag
ab
aj
wb
aj
aj
ab
aU
aU
aA
ab
ab
aa
aa
aa
aa
"}
(13,1,1) = {"
aa
FW
ac
ab
aA
aA
ag
ag
ah
ah
ag
ag
am
ab
al
jk
aM
aM
ab
aV
aV
ab
ab
aa
aa
aa
aa
aa
"}
(14,1,1) = {"
aa
FW
ab
bd
aB
aB
aD
ag
ag
aB
aB
aB
ab
ab
ab
as
as
ab
ab
as
as
ab
aa
aa
aa
aa
aa
aa
"}
(15,1,1) = {"
aa
aa
aa
aa
aa
aa
aa
aa
aa
aa
aa
aa
aa
aa
aa
aa
aa
aa
aa
aa
aa
aa
aa
aa
aa
aa
aa
aa
"}
