"aN" = (/obj/machinery/atmospherics/pipe/simple/visible/cyan{dir = 10},/turf/simulated/floor/tiled/techfloor/grid,/area/engineering/engine_room)
"bF" = (/obj/machinery/atmospherics/pipe/simple/visible/red{dir = 6},/turf/simulated/floor/tiled/techfloor/grid,/area/engineering/engine_room)
"cg" = (/obj/machinery/door/firedoor/glass/hidden/steel{dir = 2},/obj/machinery/atmospherics/pipe/simple/visible/red{dir = 9},/turf/simulated/floor/tiled/techfloor/grid,/area/engineering/engine_room)
"cY" = (/obj/machinery/atmospherics/binary/pump{dir = 1},/turf/simulated/floor/tiled/techfloor/grid,/area/engineering/engine_room)
"di" = (/obj/machinery/power/apc{name = "south bump"; pixel_y = -28},/obj/structure/cable/cyan{d2 = 4; icon_state = "0-4"},/obj/machinery/atmospherics/pipe/manifold/hidden/supply,/obj/machinery/atmospherics/pipe/manifold/hidden/scrubbers,/obj/machinery/atmospherics/pipe/simple/hidden/fuel{dir = 8},/turf/simulated/floor/tiled/techfloor/grid,/area/engineering/engine_room)
"do" = (/obj/machinery/atmospherics/pipe/manifold/visible/red{dir = 1},/turf/simulated/floor/tiled/techfloor/grid,/area/engineering/engine_room)
"dN" = (/obj/machinery/atmospherics/binary/pump{dir = 8},/turf/simulated/floor/tiled/techfloor/grid,/area/engineering/engine_room)
"fd" = (/obj/machinery/door/firedoor/glass,/obj/structure/grille,/obj/structure/window/phoronreinforced/full,/obj/structure/window/phoronreinforced{dir = 8},/obj/structure/window/phoronreinforced{dir = 4},/obj/machinery/atmospherics/pipe/simple/visible/cyan{dir = 4},/turf/simulated/floor/tiled/techfloor/grid,/area/engineering/engine_room)
"fS" = (/obj/machinery/atmospherics/pipe/simple/visible/black,/obj/machinery/atmospherics/pipe/simple/hidden/scrubbers{dir = 10},/obj/structure/cable/yellow{d1 = 1; d2 = 2; icon_state = "1-2"},/turf/simulated/floor/tiled/techmaint,/area/engineering/engine_room)
"gx" = (/obj/machinery/atmospherics/binary/pump/high_power,/turf/simulated/floor/tiled/techfloor/grid,/area/engineering/engine_room)
"gX" = (/obj/machinery/atmospherics/pipe/simple/visible/black{dir = 8},/turf/simulated/floor/tiled/techfloor/grid,/area/engineering/engine_room)
"hg" = (/obj/structure/cable/yellow{d1 = 2; d2 = 4; icon_state = "2-4"},/obj/machinery/atmospherics/pipe/simple/visible/cyan{dir = 4},/turf/simulated/floor/tiled/techfloor/grid,/area/engineering/engine_room)
"hC" = (/obj/machinery/light{dir = 1},/turf/simulated/floor/tiled/techfloor/grid,/area/engineering/engine_room)
"hK" = (/obj/machinery/atmospherics/pipe/simple/visible/red{dir = 5},/turf/simulated/floor/reinforced,/area/engineering/engine_room)
"hO" = (/obj/machinery/atmospherics/pipe/simple/visible/red{dir = 9},/turf/simulated/floor/reinforced,/area/engineering/engine_room)
"iV" = (/obj/machinery/atmospherics/portables_connector{dir = 4},/turf/simulated/floor/tiled/techfloor/grid,/area/engineering/engine_room)
"jd" = (/obj/structure/cable/yellow{d1 = 1; d2 = 8; icon_state = "1-8"},/turf/simulated/floor/tiled/techfloor/grid,/area/engineering/engine_room)
"jj" = (/obj/machinery/atmospherics/binary/pump{dir = 4},/turf/simulated/floor/tiled/techfloor/grid,/area/engineering/engine_room)
"jI" = (/obj/structure/fans/tiny,/obj/machinery/atmospherics/pipe/simple/visible/black,/obj/machinery/atmospherics/pipe/simple/hidden/scrubbers,/obj/machinery/atmospherics/pipe/simple/hidden/supply,/obj/machinery/door/firedoor,/obj/structure/cable/yellow{d1 = 1; d2 = 2; icon_state = "1-2"},/obj/machinery/door/airlock/hatch,/turf/simulated/floor/tiled/techfloor/grid,/area/engineering/engine_room)
"km" = (/obj/machinery/atmospherics/pipe/simple/visible/red{dir = 10; icon_state = "intact"},/turf/simulated/floor/reinforced,/area/engineering/engine_room)
"ko" = (/turf/simulated/floor/tiled/techfloor/grid,/area/engineering/engine_room)
"ku" = (/obj/structure/cable/yellow{d1 = 4; d2 = 8; icon_state = "4-8"},/obj/machinery/atmospherics/pipe/simple/visible/red{dir = 5},/turf/simulated/floor/reinforced,/area/engineering/engine_room)
"kQ" = (/obj/machinery/atmospherics/pipe/manifold/visible/cyan{dir = 8},/turf/simulated/floor/tiled/techfloor/grid,/area/engineering/engine_room)
"kR" = (/turf/simulated/floor/reinforced,/area/engineering/engine_room)
"lT" = (/obj/structure/sign/vacuum,/turf/simulated/wall/r_wall,/area/engineering/engine_room)
"mk" = (/obj/machinery/door/firedoor/glass,/obj/structure/grille,/obj/structure/window/phoronreinforced/full,/obj/machinery/door/blast/regular{dir = 2; id = "SupermatterPort"; layer = 3.3; name = "Reactor Blast Door"},/obj/machinery/atmospherics/pipe/simple/visible/red{dir = 4},/turf/simulated/floor/tiled/techfloor/grid,/area/engineering/engine_room)
"mo" = (/obj/structure/cable/yellow{d1 = 1; d2 = 2; icon_state = "1-2"},/turf/simulated/floor/tiled/techfloor/grid,/area/engineering/engine_room)
"nz" = (/turf/simulated/floor/tiled/techmaint,/area/engineering/engine_room)
"nD" = (/obj/machinery/power/generator{anchored = 1; dir = 4},/obj/structure/cable/yellow{d2 = 2; icon_state = "0-2"},/turf/simulated/floor/tiled/techfloor/grid,/area/engineering/engine_room)
"nL" = (/obj/machinery/atmospherics/pipe/simple/hidden/fuel{dir = 6},/obj/machinery/atmospherics/pipe/manifold/hidden/supply{dir = 1},/obj/machinery/atmospherics/pipe/manifold/hidden/scrubbers{dir = 8},/turf/simulated/floor/tiled/techfloor/grid,/area/engineering/engine_room)
"od" = (/obj/machinery/camera/network/engine{dir = 9},/obj/structure/table/standard,/obj/item/multitool,/obj/item/tool/wrench,/obj/item/stack/cable_coil/yellow,/turf/simulated/floor/tiled/techmaint,/area/engineering/engine_room)
"ol" = (/turf/template_noop,/area/space)
"ox" = (/turf/simulated/wall/r_wall,/area/engineering/engine_room)
"oB" = (/obj/structure/sign/warning/radioactive{pixel_x = -32},/turf/simulated/floor/tiled/techfloor/grid,/area/engineering/engine_room)
"pd" = (/obj/machinery/atmospherics/pipe/manifold/visible/red{dir = 4},/turf/simulated/floor/tiled/techfloor/grid,/area/engineering/engine_room)
"qa" = (/obj/machinery/atmospherics/pipe/manifold/visible/green{dir = 1},/turf/simulated/floor/tiled/techfloor/grid,/area/engineering/engine_room)
"qn" = (/obj/machinery/atmospherics/pipe/simple/visible/red,/obj/machinery/atmospherics/pipe/simple/visible/yellow{dir = 4},/turf/simulated/floor/tiled/techfloor/grid,/area/engineering/engine_room)
"rQ" = (/obj/machinery/power/rad_collector,/obj/structure/cable/yellow{d2 = 2; icon_state = "0-2"},/obj/machinery/light/small{dir = 4},/turf/simulated/floor/reinforced,/area/engineering/engine_room)
"sc" = (/obj/machinery/atmospherics/pipe/simple/visible/red,/turf/simulated/floor/reinforced,/area/engineering/engine_room)
"se" = (/obj/machinery/power/rad_collector,/obj/structure/cable/yellow,/obj/machinery/light/small{dir = 4},/turf/simulated/floor/reinforced,/area/engineering/engine_room)
"si" = (/obj/machinery/atmospherics/pipe/simple/visible/red{dir = 4},/turf/simulated/floor/reinforced,/area/engineering/engine_room)
"sY" = (/obj/machinery/portable_atmospherics/canister/phoron,/turf/simulated/floor/tiled/techmaint,/area/engineering/engine_room)
"te" = (/obj/machinery/atmospherics/pipe/simple/visible/green{dir = 4},/obj/item/radio/intercom{dir = 1; name = "Station Intercom (General)"; pixel_y = 26},/turf/simulated/floor/tiled/techfloor/grid,/area/engineering/engine_room)
"tu" = (/obj/machinery/door/blast/regular{dir = 2; id = "SupermatterPort"; layer = 3.3; name = "Reactor Blast Door"},/obj/machinery/atmospherics/pipe/simple/visible/black{dir = 4},/obj/structure/cable/yellow{d1 = 4; d2 = 8; icon_state = "4-8"},/turf/simulated/floor/reinforced,/area/engineering/engine_room)
"tw" = (/obj/structure/table/standard,/obj/machinery/recharger,/turf/simulated/floor/tiled/techmaint,/area/engineering/engine_room)
"tW" = (/obj/machinery/atmospherics/pipe/simple/hidden/scrubbers,/obj/machinery/atmospherics/pipe/simple/hidden/supply,/obj/structure/cable/yellow{d1 = 1; d2 = 2; icon_state = "1-2"},/turf/simulated/floor/tiled/techmaint,/area/engineering/engine_room)
"tY" = (/obj/machinery/atmospherics/pipe/simple/visible/red{dir = 4},/turf/simulated/floor/tiled/techfloor/grid,/area/engineering/engine_room)
"ue" = (/obj/machinery/atmospherics/pipe/simple/visible/cyan{dir = 9},/turf/simulated/floor/tiled/techfloor/grid,/area/engineering/engine_room)
"uk" = (/obj/machinery/atmospherics/pipe/simple/visible/cyan{dir = 5},/turf/simulated/floor/tiled/techfloor/grid,/area/engineering/engine_room)
"uw" = (/obj/machinery/meter,/obj/machinery/atmospherics/pipe/manifold/visible/green{dir = 1},/obj/machinery/light{dir = 1},/turf/simulated/floor/tiled/techfloor/grid,/area/engineering/engine_room)
"uH" = (/obj/machinery/atmospherics/pipe/simple/visible/yellow{dir = 5},/turf/simulated/floor/tiled/techfloor/grid,/area/engineering/engine_room)
"uZ" = (/obj/machinery/atmospherics/binary/pump,/turf/simulated/floor/tiled/techfloor/grid,/area/engineering/engine_room)
"ve" = (/obj/machinery/atmospherics/pipe/simple/visible/black{dir = 5},/obj/machinery/atmospherics/pipe/simple/hidden/scrubbers,/obj/machinery/atmospherics/pipe/simple/hidden/supply,/obj/structure/cable/yellow{d1 = 1; d2 = 2; icon_state = "1-2"},/obj/structure/cable/yellow{d1 = 2; d2 = 4; icon_state = "2-4"},/turf/simulated/floor/reinforced,/area/engineering/engine_room)
"vr" = (/obj/machinery/door/firedoor/glass,/obj/structure/grille,/obj/structure/window/phoronreinforced/full,/obj/structure/window/phoronreinforced{dir = 8},/obj/structure/window/phoronreinforced{dir = 4},/obj/machinery/door/blast/regular{density = 0; icon_state = "pdoor0"; id = "EngineRadiatorViewport"; name = "Engine Radiator Viewport Shutter"; opacity = 0},/turf/simulated/floor/tiled/techfloor/grid,/area/engineering/engine_room)
"wo" = (/obj/machinery/door/airlock/vault{name = "REACTOR ROOM"; req_one_access = list(10)},/obj/machinery/atmospherics/pipe/simple/hidden/supply,/obj/machinery/atmospherics/pipe/simple/hidden/scrubbers,/obj/machinery/door/firedoor,/obj/machinery/atmospherics/pipe/simple/hidden/fuel,/turf/simulated/floor/tiled/techfloor/grid,/area/engineering/engine_room)
"yF" = (/obj/machinery/light,/obj/machinery/firealarm{dir = 1; pixel_y = -24},/turf/simulated/floor/tiled/techmaint,/area/engineering/engine_room)
"yJ" = (/obj/machinery/power/rad_collector,/obj/structure/cable/yellow{d2 = 2; icon_state = "0-2"},/obj/machinery/atmospherics/unary/vent_pump{dir = 8; external_pressure_bound = 0; external_pressure_bound_default = 0; icon_state = "map_vent_in"; initialize_directions = 1; internal_pressure_bound = 4000; internal_pressure_bound_default = 4000; pressure_checks = 2; pressure_checks_default = 2; pump_direction = 0; use_power = 1},/obj/machinery/light/small{dir = 8},/turf/simulated/floor/reinforced,/area/engineering/engine_room)
"yN" = (/obj/machinery/door/firedoor/glass,/obj/structure/grille,/obj/structure/window/phoronreinforced/full,/obj/structure/window/phoronreinforced,/obj/structure/window/phoronreinforced{dir = 1},/turf/simulated/floor/tiled/techfloor/grid,/area/engineering/engine_room)
"zt" = (/obj/machinery/light,/obj/machinery/atmospherics/pipe/simple/visible/red{dir = 4},/turf/simulated/floor/tiled/techfloor/grid,/area/engineering/engine_room)
"zz" = (/obj/machinery/camera/network/engineering{dir = 4},/obj/machinery/button/remote/blast_door{desc = "A remote control-switch for the engine charging port."; dir = 4; id = "SupermatterPort"; name = "Reactor Blast Doors"; pixel_x = -26; pixel_y = -5; req_access = list(10)},/turf/simulated/floor/tiled/techfloor/grid,/area/engineering/engine_room)
"zZ" = (/obj/machinery/atmospherics/pipe/simple/visible/yellow{dir = 4},/turf/simulated/floor/tiled/techfloor/grid,/area/engineering/engine_room)
"As" = (/obj/structure/closet/radiation,/obj/item/clothing/glasses/meson,/obj/item/clothing/glasses/meson,/obj/machinery/camera/network/engine{dir = 9},/obj/machinery/atmospherics/binary/pump/on{dir = 8},/turf/simulated/floor/tiled/techmaint,/area/engineering/engine_room)
"Au" = (/obj/machinery/firealarm{dir = 1; pixel_y = -24},/turf/simulated/floor/tiled/techfloor/grid,/area/engineering/engine_room)
"Ba" = (/obj/machinery/power/rad_collector,/obj/structure/cable/yellow,/obj/machinery/light/small{dir = 8},/turf/simulated/floor/reinforced,/area/engineering/engine_room)
"Bl" = (/obj/structure/cable/yellow{d1 = 4; d2 = 8; icon_state = "4-8"},/obj/machinery/mass_driver{dir = 8; id = "enginecore"},/obj/machinery/power/fission,/obj/structure/window/phoronreinforced{dir = 1},/obj/structure/window/phoronreinforced{dir = 4},/obj/structure/window/phoronreinforced,/obj/machinery/atmospherics/pipe/simple/visible/red{dir = 4},/obj/machinery/atmospherics/pipe/simple/visible/red,/turf/simulated/floor/reinforced,/area/engineering/engine_room)
"Bx" = (/obj/structure/cable/yellow{d1 = 4; d2 = 8; icon_state = "4-8"},/obj/machinery/atmospherics/pipe/simple/visible/cyan{dir = 9},/turf/simulated/floor/tiled/techfloor/grid,/area/engineering/engine_room)
"Cn" = (/obj/machinery/shield_diffuser,/obj/machinery/door/blast/regular{dir = 2; id = "SupermatterVent"; layer = 3.3; name = "Reactor Blast Door"},/turf/simulated/floor/reinforced,/area/engineering/engine_room)
"Di" = (/obj/structure/closet/crate/secure/engineering,/obj/item/storage/briefcase/fission/uranium,/obj/item/storage/briefcase/fission/uranium,/obj/machinery/door/window/northleft{dir = 2; name = "Fuel Rods"; req_access = list(11)},/obj/structure/window/reinforced{dir = 8; health = 1e+006},/obj/structure/window/reinforced{dir = 4},/obj/item/storage/briefcase/fission/plutonium,/obj/item/storage/briefcase/fission/plutonium,/turf/simulated/floor/tiled/techmaint,/area/engineering/engine_room)
"DA" = (/obj/machinery/atmospherics/pipe/simple/visible/red{dir = 10},/turf/simulated/floor/tiled/techfloor/grid,/area/engineering/engine_room)
"DB" = (/obj/structure/closet/radiation,/obj/item/clothing/glasses/meson,/obj/item/clothing/glasses/meson,/turf/simulated/floor/tiled/techmaint,/area/engineering/engine_room)
"DQ" = (/obj/machinery/atmospherics/binary/circulator{anchored = 1; dir = 1},/turf/simulated/floor/tiled/techfloor/grid,/area/engineering/engine_room)
"Ee" = (/obj/machinery/atmospherics/pipe/simple/visible/black{dir = 4},/obj/structure/cable/yellow{d1 = 4; d2 = 8; icon_state = "4-8"},/obj/machinery/button/remote/blast_door{desc = "A remote control-switch for the engine charging port."; dir = 8; id = "SupermatterPort"; name = "Reactor Blast Doors"; pixel_x = 26; pixel_y = 26; req_access = list(10)},/turf/simulated/floor/reinforced,/area/engineering/engine_room)
"Es" = (/obj/machinery/door/firedoor/glass,/obj/structure/grille,/obj/structure/window/phoronreinforced/full,/obj/structure/window/phoronreinforced,/obj/structure/window/phoronreinforced{dir = 1},/obj/structure/sign/warning/radioactive{pixel_x = 32},/turf/simulated/floor/tiled/techfloor/grid,/area/engineering/engine_room)
"Ew" = (/obj/structure/closet/crate/secure/engineering,/obj/item/storage/briefcase/fission/boron,/obj/machinery/door/window/northleft{dir = 4; name = "Control Rods"; req_access = list(11)},/obj/structure/window/reinforced,/obj/item/storage/briefcase/fission/controlmixed,/obj/item/storage/briefcase/fission/silver,/turf/simulated/floor/tiled/techmaint,/area/engineering/engine_room)
"EY" = (/obj/item/radio/intercom{dir = 1; name = "Station Intercom (General)"; pixel_y = 26},/turf/simulated/floor/tiled/techfloor/grid,/area/engineering/engine_room)
"Gj" = (/obj/machinery/door/firedoor/glass,/obj/structure/grille,/obj/structure/window/phoronreinforced/full,/obj/structure/window/phoronreinforced{dir = 8},/obj/structure/window/phoronreinforced{dir = 4},/turf/simulated/floor/tiled/techfloor/grid,/area/engineering/engine_room)
"Go" = (/obj/machinery/button/remote/blast_door{desc = "A remote control-switch for the engine charging port."; id = "SupermatterVent"; name = "REACTOR EMERGENCY VENTING"; pixel_y = -26; req_access = list(10)},/turf/simulated/floor/tiled/techmaint,/area/engineering/engine_room)
"GA" = (/obj/machinery/door/blast/regular{dir = 2; id = "SupermatterVent"; layer = 3.3; name = "Reactor Blast Door"},/turf/simulated/floor/reinforced,/area/engineering/engine_room)
"GT" = (/obj/machinery/atmospherics/pipe/simple/hidden/scrubbers{dir = 10},/turf/simulated/floor/tiled/techfloor/grid,/area/engineering/engine_room)
"Hx" = (/obj/structure/dispenser/phoron,/turf/simulated/floor/tiled/techmaint,/area/engineering/engine_room)
"HI" = (/obj/machinery/atmospherics/pipe/simple/visible/red{dir = 6},/turf/simulated/floor/reinforced,/area/engineering/engine_room)
"HK" = (/obj/machinery/atmospherics/pipe/simple/hidden/supply,/obj/machinery/atmospherics/pipe/simple/hidden/scrubbers,/obj/machinery/light{dir = 4},/obj/structure/cable/yellow{d1 = 1; d2 = 2; icon_state = "1-2"},/turf/simulated/floor/tiled/techfloor/grid,/area/engineering/engine_room)
"HO" = (/obj/machinery/atmospherics/pipe/simple/visible/yellow{dir = 10},/turf/simulated/floor/tiled/techfloor/grid,/area/engineering/engine_room)
"HP" = (/obj/machinery/atmospherics/pipe/simple/hidden/scrubbers,/obj/machinery/atmospherics/pipe/manifold/hidden/supply{dir = 4},/obj/structure/cable/yellow{d1 = 1; d2 = 2; icon_state = "1-2"},/turf/simulated/floor/tiled/techmaint,/area/engineering/engine_room)
"Iy" = (/obj/machinery/atmospherics/pipe/simple/visible/yellow{dir = 9},/turf/simulated/floor/tiled/techfloor/grid,/area/engineering/engine_room)
"JB" = (/obj/structure/cable/yellow{d1 = 1; d2 = 4; icon_state = "1-4"},/obj/structure/cable/yellow{d1 = 2; d2 = 4; icon_state = "2-4"},/obj/machinery/button/remote/blast_door{desc = "A remote control-switch for the engine charging port."; dir = 4; id = "SupermatterPort"; name = "Reactor Blast Doors"; pixel_x = -26; pixel_y = -25; req_access = list(10)},/obj/machinery/atmospherics/pipe/simple/visible/black{dir = 10},/obj/structure/cable/yellow{d1 = 4; d2 = 8; icon_state = "4-8"},/turf/simulated/floor/reinforced,/area/engineering/engine_room)
"Kd" = (/obj/structure/cable/yellow{d1 = 1; d2 = 2; icon_state = "1-2"},/turf/simulated/floor/reinforced,/area/engineering/engine_room)
"Kh" = (/obj/machinery/atmospherics/pipe/simple/hidden/supply,/obj/machinery/atmospherics/pipe/simple/hidden/scrubbers,/obj/structure/cable/yellow{d1 = 1; d2 = 2; icon_state = "1-2"},/turf/simulated/floor/plating,/area/engineering/engine_room)
"KB" = (/obj/machinery/atmospherics/pipe/simple/visible/red,/obj/machinery/door/firedoor/glass,/obj/structure/grille,/obj/structure/window/phoronreinforced/full,/obj/machinery/door/blast/regular{dir = 2; id = "SupermatterPort"; layer = 3.3; name = "Reactor Blast Door"},/turf/simulated/floor/tiled/techfloor/grid,/area/engineering/engine_room)
"KQ" = (/obj/machinery/atmospherics/pipe/simple/visible/red{dir = 4},/obj/structure/cable/yellow{d1 = 2; d2 = 8; icon_state = "2-8"},/obj/structure/cable/yellow{d1 = 1; d2 = 8; icon_state = "1-8"},/turf/simulated/floor/reinforced,/area/engineering/engine_room)
"Mf" = (/obj/machinery/button/remote/blast_door{desc = "A remote control-switch for the engine charging port."; dir = 4; id = "SupermatterPort"; name = "Reactor Blast Doors"; pixel_x = -26; pixel_y = -5; req_access = list(10)},/obj/machinery/light,/obj/item/radio/intercom{dir = 2; pixel_y = -24},/turf/simulated/floor/tiled/techfloor/grid,/area/engineering/engine_room)
"Mj" = (/obj/machinery/atmospherics/valve/digital{dir = 4; name = "Emergency Cooling Valve 1"},/turf/simulated/floor/tiled/techfloor/grid,/area/engineering/engine_room)
"Mt" = (/obj/machinery/door/firedoor/glass,/obj/structure/grille,/obj/structure/window/phoronreinforced/full,/obj/structure/window/phoronreinforced{dir = 8},/obj/structure/window/phoronreinforced{dir = 4},/obj/machinery/atmospherics/pipe/simple/visible/green{dir = 4},/turf/simulated/floor/tiled/techfloor/grid,/area/engineering/engine_room)
"My" = (/obj/machinery/atmospherics/pipe/simple/visible/green{dir = 4},/turf/simulated/floor/tiled/techfloor/grid,/area/engineering/engine_room)
"MI" = (/obj/structure/cable/yellow{d1 = 4; d2 = 8; icon_state = "4-8"},/obj/machinery/atmospherics/pipe/simple/visible/cyan{dir = 4},/turf/simulated/floor/tiled/techfloor/grid,/area/engineering/engine_room)
"Nn" = (/obj/machinery/door/airlock/maintenance/engi,/obj/machinery/door/firedoor,/turf/simulated/floor/plating,/area/engineering/engine_room)
"NI" = (/obj/structure/closet/radiation,/obj/item/clothing/glasses/meson,/obj/item/clothing/glasses/meson,/obj/machinery/firealarm{dir = 8; pixel_x = -26},/turf/simulated/floor/tiled/techmaint,/area/engineering/engine_room)
"NW" = (/obj/machinery/atmospherics/pipe/simple/hidden/scrubbers,/obj/machinery/atmospherics/pipe/simple/hidden/supply{dir = 10},/obj/machinery/atmospherics/pipe/manifold/visible/black{dir = 8},/obj/structure/cable/yellow{d1 = 1; d2 = 2; icon_state = "1-2"},/turf/simulated/floor/tiled/techmaint,/area/engineering/engine_room)
"OG" = (/obj/machinery/atmospherics/pipe/simple/hidden/scrubbers,/obj/machinery/atmospherics/pipe/simple/hidden/supply,/obj/machinery/door/firedoor/glass/hidden/steel{dir = 2},/obj/structure/cable/yellow{d1 = 1; d2 = 2; icon_state = "1-2"},/turf/simulated/floor/tiled/techfloor/grid,/area/engineering/engine_room)
"OR" = (/obj/machinery/atmospherics/pipe/simple/hidden/supply{dir = 4},/obj/machinery/atmospherics/pipe/simple/hidden/scrubbers{dir = 4},/obj/machinery/door/firedoor,/obj/structure/cable/cyan{d1 = 4; d2 = 8; icon_state = "4-8"},/obj/machinery/atmospherics/pipe/simple/hidden/fuel{dir = 8},/obj/machinery/door/airlock/vault{name = "REACTOR ROOM"; req_one_access = list(10)},/turf/simulated/floor/tiled/techfloor/grid,/area/engineering/engine_room)
"PH" = (/obj/machinery/light{dir = 1},/obj/machinery/alarm{pixel_y = 22},/turf/simulated/floor/tiled/techmaint,/area/engineering/engine_room)
"PZ" = (/obj/machinery/button/remote/driver{dir = 8; id = "enginecore"; name = "Emergency Core Eject"; pixel_x = -21},/obj/structure/window/phoronreinforced{dir = 1},/obj/structure/window/phoronreinforced{dir = 4},/obj/structure/window/phoronreinforced,/turf/simulated/floor/tiled/techmaint,/area/engineering/engine_room)
"Qv" = (/obj/machinery/atmospherics/pipe/simple/hidden/scrubbers,/obj/machinery/atmospherics/pipe/simple/hidden/supply,/obj/machinery/door/firedoor,/obj/machinery/door/airlock/vault{name = "REACTOR ROOM"; req_one_access = list(10)},/turf/simulated/floor/tiled/techfloor/grid,/area/engineering/engine_room)
"QK" = (/obj/machinery/door/firedoor,/obj/machinery/door/airlock/vault{name = "REACTOR ROOM"; req_one_access = list(10)},/turf/simulated/floor/tiled/techfloor/grid,/area/engineering/engine_room)
"Ra" = (/obj/machinery/atmospherics/binary/circulator{anchored = 1},/turf/simulated/floor/tiled/techfloor/grid,/area/engineering/engine_room)
"Ri" = (/obj/machinery/atmospherics/pipe/simple/visible/black{dir = 10},/obj/machinery/meter,/obj/structure/cable/yellow{d1 = 1; d2 = 2; icon_state = "1-2"},/turf/simulated/floor/tiled/techfloor/grid,/area/engineering/engine_room)
"Rk" = (/obj/machinery/atmospherics/binary/pump/high_power{dir = 4},/turf/simulated/floor/tiled/techfloor/grid,/area/engineering/engine_room)
"Rm" = (/obj/machinery/door/firedoor/glass/hidden/steel{dir = 2},/obj/machinery/atmospherics/pipe/simple/visible/red{dir = 4},/turf/simulated/floor/tiled/techfloor/grid,/area/engineering/engine_room)
"Rp" = (/obj/structure/cable/yellow{d1 = 4; d2 = 8; icon_state = "4-8"},/obj/machinery/atmospherics/pipe/simple/visible/red{dir = 4},/turf/simulated/floor/reinforced,/area/engineering/engine_room)
"Rw" = (/obj/structure/cable/yellow{d1 = 1; d2 = 2; icon_state = "1-2"},/obj/machinery/camera/network/engine{dir = 4},/obj/machinery/atmospherics/unary/outlet_injector{dir = 1; frequency = 1441; id = "atmos_out"; power_rating = 5000; use_power = 1},/turf/simulated/floor/reinforced,/area/engineering/engine_room)
"RA" = (/obj/structure/fans/tiny,/obj/machinery/atmospherics/pipe/simple/hidden/scrubbers,/obj/machinery/atmospherics/pipe/simple/hidden/supply,/obj/machinery/door/firedoor,/obj/structure/cable/yellow{d1 = 1; d2 = 2; icon_state = "1-2"},/obj/machinery/door/airlock/hatch,/turf/simulated/floor/tiled/techfloor/grid,/area/engineering/engine_room)
"RO" = (/obj/machinery/atmospherics/pipe/simple/visible/yellow{dir = 6},/turf/simulated/floor/tiled/techfloor/grid,/area/engineering/engine_room)
"RY" = (/obj/machinery/atmospherics/unary/vent_pump/on{dir = 4},/turf/simulated/floor/tiled/techmaint,/area/engineering/engine_room)
"Su" = (/obj/machinery/atmospherics/portables_connector{dir = 1},/turf/simulated/floor/tiled/techfloor/grid,/area/engineering/engine_room)
"SC" = (/turf/simulated/wall/r_lead,/area/engineering/engine_room)
"SE" = (/obj/machinery/atmospherics/pipe/manifold/visible/red,/turf/simulated/floor/reinforced,/area/engineering/engine_room)
"TI" = (/obj/machinery/door/firedoor/glass,/obj/structure/grille,/obj/structure/window/phoronreinforced/full,/obj/machinery/door/blast/regular{dir = 2; id = "SupermatterPort"; layer = 3.3; name = "Reactor Blast Door"},/turf/simulated/floor/tiled/techfloor/grid,/area/engineering/engine_room)
"TR" = (/obj/machinery/atmospherics/pipe/simple/visible/red{dir = 4},/obj/machinery/door/firedoor/glass,/obj/structure/grille,/obj/structure/window/phoronreinforced/full,/obj/machinery/door/blast/regular{dir = 2; id = "SupermatterPort"; layer = 3.3; name = "Reactor Blast Door"},/turf/simulated/floor/tiled/techfloor/grid,/area/engineering/engine_room)
"TU" = (/obj/machinery/light{dir = 8; light_range = 12},/obj/machinery/atmospherics/unary/freezer{dir = 4; name = "Reactor Room Cooling"},/turf/simulated/floor/tiled/techfloor/grid,/area/engineering/engine_room)
"Uj" = (/obj/effect/floor_decal/industrial/warning{dir = 4},/obj/machinery/atmospherics/valve/digital{name = "Emergency Cooling Valve 2"},/turf/simulated/floor/tiled/techfloor/grid,/area/engineering/engine_room)
"Uk" = (/obj/machinery/meter,/obj/machinery/atmospherics/pipe/simple/visible/yellow{dir = 4},/turf/simulated/floor/tiled/techfloor/grid,/area/engineering/engine_room)
"Us" = (/obj/machinery/camera/network/engineering{dir = 4},/obj/structure/sign/warning/radioactive{pixel_x = -32},/turf/simulated/floor/tiled/techfloor/grid,/area/engineering/engine_room)
"UY" = (/obj/machinery/door/firedoor/glass,/obj/structure/grille,/obj/structure/window/phoronreinforced,/obj/structure/window/phoronreinforced{dir = 1},/obj/structure/window/phoronreinforced/full,/turf/simulated/floor/tiled/techfloor/grid,/area/engineering/engine_room)
"Vc" = (/obj/machinery/atmospherics/pipe/manifold/visible/yellow{dir = 4},/turf/simulated/floor/tiled/techfloor/grid,/area/engineering/engine_room)
"VE" = (/obj/machinery/door/firedoor,/obj/structure/cable/yellow{d1 = 4; d2 = 8; icon_state = "4-8"},/obj/machinery/door/airlock/vault{name = "REACTOR ROOM"; req_one_access = list(10)},/turf/simulated/floor/tiled/techfloor/grid,/area/engineering/engine_room)
"VH" = (/obj/machinery/atmospherics/pipe/simple/visible/red,/turf/simulated/floor/tiled/techfloor/grid,/area/engineering/engine_room)
"VZ" = (/turf/simulated/floor/plating,/area/engineering/engine_room)
"WV" = (/obj/machinery/atmospherics/pipe/simple/hidden/black{dir = 4},/turf/simulated/wall/r_lead,/area/engineering/engine_room)
"Xi" = (/obj/machinery/door/firedoor/glass/hidden/steel{dir = 2},/turf/simulated/floor/tiled/techfloor/grid,/area/engineering/engine_room)
"Xk" = (/obj/machinery/atmospherics/pipe/simple/hidden/supply,/obj/machinery/atmospherics/pipe/simple/hidden/scrubbers,/obj/structure/cable/yellow{d1 = 1; d2 = 4; icon_state = "1-4"},/turf/simulated/floor/tiled/techfloor/grid,/area/engineering/engine_room)
"Xn" = (/obj/machinery/atmospherics/unary/vent_scrubber/on{dir = 4},/turf/simulated/floor/tiled/techmaint,/area/engineering/engine_room)
"XV" = (/obj/structure/closet/crate/secure/engineering,/obj/machinery/door/window/northleft{dir = 4; name = "Reflector Rods"; req_access = list(11)},/obj/structure/window/reinforced,/obj/item/storage/briefcase/fission/reflectormixed,/obj/item/storage/briefcase/fission/tungstencarbide,/obj/item/storage/briefcase/fission/beryllium,/turf/simulated/floor/tiled/techmaint,/area/engineering/engine_room)
"Ye" = (/obj/machinery/atmospherics/unary/vent_scrubber/on{dir = 4},/turf/simulated/floor/tiled/techfloor/grid,/area/engineering/engine_room)
"Yu" = (/obj/structure/cable/yellow{d1 = 4; d2 = 8; icon_state = "4-8"},/turf/simulated/floor/tiled/techfloor/grid,/area/engineering/engine_room)
"Yy" = (/obj/structure/cable/yellow{d1 = 1; d2 = 2; icon_state = "1-2"},/obj/machinery/atmospherics/pipe/simple/visible/red{dir = 4},/turf/simulated/floor/reinforced,/area/engineering/engine_room)
"YB" = (/obj/machinery/alarm{dir = 4; pixel_x = -22},/obj/machinery/atmospherics/unary/vent_pump/on{dir = 4},/obj/machinery/firealarm{dir = 1; pixel_y = -24},/turf/simulated/floor/tiled/techfloor/grid,/area/engineering/engine_room)
"YV" = (/turf/template_noop,/area/template_noop)

(1,1,1) = {"
olololoxoxNnoxoxoxoxoxoxoxoxoxoxoxoxox
olololMtMyMyteuwqaqaqaMjdoDAkoEYkohCko
olololGjkokokouZcYUjDQnDRaVHkokokokoko
olololfdaNkokoSuSukQuemouHqnzZzZUkHOko
olololoxukRkhgMIMIBxYujdkoVHkoiVdNVcko
oxoxoxoxTUgXRikokokoAubFztpdkoiVjjVcko
oxPZPHHxsYXnfSDBSCSCSCKBSCSCSCzzROIyko
oxNInzGonzRYNWAsWVyJHISEkmrQSCoBgxkoko
lTyNyNoxUYyNjIyNSCKdscHIhOKdTIkoVHkoko
GAkRkRCnkRkRveEetuJBkuBlRpKQmktYpdkoko
lTyNyNoxyNyNRAEsSCRwkRhKsiYyTRRmcgXiko
oxEwnzDiDBDBtWodSCBakRkRkRseSCUskokoko
oxXVyFnznzRYHPtwSCSCSCSCSCSCSCMfAukoko
oxoxoxoxVZVZKhoxoxoxoxoxoxoxoxoxoxQKQv
olololvrXiXiOGoxYVYVYVYVYVYVYVYVYVYVYV
olololvrkokoHKoxYVYVYVYVYVYVYVYVYVYVYV
olololvrYeGTXkVEYVYVYVYVYVYVYVYVYVYVYV
olololoxYBnLdiORYVYVYVYVYVYVYVYVYVYVYV
olololoxoxwooxoxYVYVYVYVYVYVYVYVYVYVYV
"}
