"a" = (/obj/structure/cable/green{icon_state = "0-10"},/obj/machinery/power/apc{dir = 1;name = "north bump";pixel_x = 0;pixel_y = 24;alarms_hidden = 1},/turf/simulated/floor/outdoors/dirt/virgo3b,/area/mine/explored/underdark)
"b" = (/obj/tether_away_spawner/shadekin{faction = "underdark"},/turf/simulated/mineral/floor/virgo3b,/area/mine/explored/underdark)
"c" = (/turf/simulated/mineral/floor/virgo3b{ignore_mapgen = 1},/area/mine/explored/underdark)
"d" = (/obj/effect/decal/remains/deer,/turf/simulated/mineral/floor/virgo3b{ignore_mapgen = 1},/area/mine/explored/underdark)
"e" = (/turf/unsimulated/mineral/virgo3b,/area/mine/explored/underdark)
"f" = (/turf/simulated/mineral/virgo3b/rich,/area/mine/unexplored/underdark)
"g" = (/turf/simulated/mineral/virgo3b/rich,/area/mine/explored/underdark)
"h" = (/turf/simulated/wall/r_wall,/area/mine/explored/underdark)
"i" = (/obj/structure/cable/green{icon_state = "2-4"},/turf/simulated/floor/outdoors/dirt/virgo3b,/area/mine/explored/underdark)
"j" = (/obj/machinery/power/port_gen/pacman,/obj/structure/cable/green{icon_state = "0-8"},/turf/simulated/floor/outdoors/dirt/virgo3b,/area/mine/explored/underdark)
"k" = (/obj/structure/cable/green{icon_state = "4-10"},/obj/machinery/light/small{icon_state = "bulb1";dir = 1},/turf/simulated/floor/outdoors/dirt/virgo3b,/area/mine/explored/underdark)
"l" = (/obj/structure/cable/green{icon_state = "2-8"},/turf/simulated/floor/outdoors/dirt/virgo3b,/area/mine/explored/underdark)
"n" = (/obj/structure/railing,/turf/simulated/floor/outdoors/dirt/virgo3b,/area/mine/explored/underdark)
"o" = (/turf/simulated/floor/outdoors/dirt/virgo3b,/area/mine/explored/underdark)
"p" = (/obj/structure/cable/green{icon_state = "1-4"},/turf/simulated/floor/outdoors/dirt/virgo3b,/area/mine/explored/underdark)
"q" = (/obj/structure/cable/green{icon_state = "5-8"},/turf/simulated/floor/outdoors/dirt/virgo3b,/area/mine/explored/underdark)
"r" = (/obj/structure/cable/green{icon_state = "1-5"},/turf/simulated/floor/outdoors/dirt/virgo3b,/area/mine/explored/underdark)
"s" = (/turf/simulated/floor/tiled/steel_dirty/virgo3b,/area/mine/explored/underdark)
"t" = (/obj/effect/step_trigger/teleporter/from_underdark{dir = 4;icon_state = "";pixel_x = -16},/turf/simulated/floor/tiled/steel_dirty/virgo3b,/area/mine/explored/underdark)
"u" = (/obj/item/newspaper{pixel_x = 4},/turf/simulated/floor/tiled/steel_dirty/virgo3b,/area/mine/explored/underdark)
"v" = (/obj/machinery/light/small{icon_state = "bulb1";dir = 4},/obj/structure/railing{icon_state = "railing0";dir = 8},/turf/simulated/floor/outdoors/dirt/virgo3b,/area/mine/explored/underdark)
"w" = (/obj/structure/railing{icon_state = "railing0";dir = 8},/turf/simulated/floor/outdoors/dirt/virgo3b,/area/mine/explored/underdark)
"x" = (/obj/structure/railing{icon_state = "railing0";dir = 1},/turf/simulated/floor/outdoors/dirt/virgo3b,/area/mine/explored/underdark)
"y" = (/turf/simulated/wall/iron,/area/mine/explored/underdark)
"z" = (/obj/structure/ore_box,/turf/simulated/floor/tiled/steel_dirty/virgo3b,/area/mine/explored/underdark)
"B" = (/obj/machinery/light/small{icon_state = "bulb1";dir = 8},/turf/simulated/floor/outdoors/dirt/virgo3b,/area/mine/explored/underdark)
"C" = (/obj/machinery/door/airlock/maintenance/cargo,/turf/simulated/floor/virgo3b,/area/mine/explored/underdark)
"D" = (/obj/machinery/light/small{icon_state = "bulb1";dir = 4},/turf/simulated/floor/tiled/steel_dirty/virgo3b,/area/mine/explored/underdark)
"E" = (/obj/item/tool/wrench,/turf/simulated/floor/tiled/steel_dirty/virgo3b,/area/mine/explored/underdark)
"F" = (/obj/structure/frame,/turf/simulated/floor/tiled/steel_dirty/virgo3b,/area/mine/explored/underdark)
"G" = (/obj/machinery/door/airlock/multi_tile/metal/mait{dir = 2},/turf/simulated/floor/tiled/steel_dirty/virgo3b,/area/mine/explored/underdark)
"H" = (/obj/machinery/light/small{icon_state = "bulb1";dir = 4},/turf/simulated/mineral/floor/virgo3b,/area/mine/explored/underdark)
"I" = (/obj/machinery/light/small,/turf/simulated/floor/outdoors/dirt/virgo3b,/area/mine/explored/underdark)
"J" = (/turf/simulated/mineral/floor/virgo3b,/area/mine/unexplored/underdark)
"K" = (/obj/structure/sign/graffiti/pisoff{pixel_x = 5;pixel_y = 3},/turf/simulated/wall/r_wall,/area/mine/explored/underdark)
"L" = (/obj/structure/sign/hostilefauna,/turf/simulated/wall/r_wall,/area/mine/explored/underdark)
"N" = (/obj/effect/decal/remains/posi,/turf/simulated/floor/outdoors/dirt/virgo3b,/area/mine/explored/underdark)
"R" = (/obj/item/bone,/turf/simulated/floor/outdoors/dirt/virgo3b,/area/mine/explored/underdark)
"S" = (/obj/item/bone,/turf/simulated/mineral/floor/virgo3b{ignore_mapgen = 1},/area/mine/explored/underdark)
"T" = (/obj/effect/decal/remains/mouse,/turf/simulated/floor/outdoors/dirt/virgo3b,/area/mine/explored/underdark)
"W" = (/obj/item/bone/skull,/turf/simulated/mineral/floor/virgo3b{ignore_mapgen = 1},/area/mine/explored/underdark)
"Z" = (/obj/effect/decal/remains/ribcage,/turf/simulated/mineral/floor/virgo3b{ignore_mapgen = 1},/area/mine/explored/underdark)

(1,1,1) = {"
eeeeeeeeeeeeeeeeeeeeeeeeeeeeeeeeeeeeeeeeeeeeeeeeeeeeeeeeeeeeeeeeeeeeeeeeeeeeeeeeeeeeeeeeeeeeeeeeeeeeeeeeeeeeeeeeeeeeeeeeeeeeeeeeeeeeeeeeeeee
egggggggggggggggggggggggggggggggggggggggggggggggggggggggggggggggggggggggggggggggggggggggggggggggggggggggggggggggggggggggggggggggggggggggggge
egfffffffffffffffffffffffffffffffffffffffffffffffffffffffffffffffffffffffffffffffffffffffffffffffffffffffffffffffffffgggggggggggggggggggggge
egfffffffffffffffffffffffffffffffffffffffffffffffffffffffffffffffffffffffffffffffffffffffffffffffffffffffffffffffffffgggggggggggggggggggggge
egfffffffffffffffffffffffffffffffffffffffffffffffffffffffffffffffffffffffffffffffffffffffffffffffffffffffffffffffffffgggggggggggggggggggggge
egfffffffffffffffffffffffffffffffffffffffffffffffffffffffffffffffffffffffffffffffffffffffffffffffffffffffffffffffffffgggggggggggggggggggggge
egfffffffffffffffffffffffffffffffffffffffffffffffffffffffffffffffffffffffffffffffffffffffffffffffffffffffffffffffffffggggghhhhhhhhhhhhhgggge
egfffffffffffffffffffffffffffffffffffffffffffffffffffffffffffffffffffffffffffffffffffffffffffffffffffffffffffffffffffggggghgggijklannohgggge
egfffffffffffffffffffffffffffffffffffffffffffffffffffffffffffffffffffffffffffffffffffffffffffffffffffffffffffffffffffggggghggNpqorstuvhgggge
egfffffffffffffffffffffffffffffffffffffffffffffffffffffffffffffffffffffffffffffffffffffffffffffffffffffffffffffffffffggggghggooooostswhgggge
egfffffffffffffffffffffffffffffffffffffffffffffffffffffffffffffffffffffffffffffffffffffffffffffffffffffffffffffffffffggggghgoooooooxxohgggge
egfffffffffffffffffffffffffffffffffffffffffffffffffffffffffffffffffffffffffffffffffffffffffffffffffffffffffffffffffffggggghTRooooyyyyohgggge
egfffffffffffffffffffffffffffffffffffffffffffffffffffffffffffffffffffffffffffffffffffffffffffffffffffffffffffffffffffggggghooooooyszyohgggge
egffffffffffffffffffffffffffffffffffffffffffffffffffffffffffffffffffffffffffffffffffffffffffffffffffffffffffffffffggggggcchBoooosCsDyohgggge
egffffffffffffffffffffffffffffffffffffffffffffffffffffffffffffffffffffffffffffffffffffffffffffffffffffffffffffffffgggcZccssooooooyEFyohgggge
egffffffffffffffffffffffffffffffffffffffffffffffffffffffffffffffffffffffffffffffffffffffffffffffffffffffffffffffffgggccccsGooosooyyyyohgggge
egffffffffffffffffffffffffffffffffffffffffffffffffffffffffffffffffffffffffffffffffffffffffffffffffffffffffffffffffggcccccHLoooooIooooRhgggge
egffffffffffffffffffffffffffffffffffffffffffffffffffffffffffffffffffffffffffffffffffffffffffffffffffffffffffffffggggcccccdhhhhhhhhhhhhhgggge
egffffffffffffffffffffffffffffffffffffffffffffffffffffffffffffffffffffffffffffffffffffffffffffffffffffffffffffffgggccccccgggggggggggggggggge
egffffffffffffffffffffffffffffffffffffffffffffffffffffffffffffffffffffffffffffffffffffffffffffffffffffffffffffffggcSKccccgggggggggggggggggge
egffffffffffffffffffffffffffffffffffffffffffffffffffffffffffffffffffffffffffffffffffffffffffffffffffffffffffffffggcccccccgggggggggggggggggge
egffffffffffffffffffffffffffffffffffffffffffffffffffffffffffffffffffffffffffffffffffffffffffffffffffffffffffffffggcccbccffffffffffffffffffge
egffffffffffffffffffffffffffffffffffffffffffffffffffffffffffffffffffffffffffffffffffffffffffffffffffffffffffffffccccccccffffffffffffffffffge
egffffffffffffffffffffffffffffffffffffffffffffffffffffffffffffffffffffffffffffffffffffffffffffffffffffffffffffffcccccccfffffffffffffffffffge
egffffffffffffffffffffffffffffffffffffffffffffffffffffffffffffffffffffffffffffffffffffffffffffffffffffffffffffffhccccccfffffffffffffffffffge
egffffffffffffffffffffffffffffffffffffffffffffffffffffffffffffffffffffffffffffffffffffffffffffffffffffffffffffffWcccchcfffffffffffffffffffge
egfffffffffffffffffffffffffffffffffffffffffffffffffffffffffffffffffffffffffffffffffffffffffffffffffffffffffffffffccccccfffffffffffffffffffge
egfffffffffffffffffffffffffffffffffffffffffffffffffffffffffffffffffffffffffffffffffffffffffffffffffffffffffffffffccccccfffffffffffffffffffge
egffffffffffffffffffffffffffffffffffffffffffffffffffffffffffffffffffffffffffffffffffffffffffffffffffffffffffffffffccccffffffffffffffffffffge
egffffffffffffffffffffffffffffffffffffffffffffffffffffffffffffffffffffffffffffffffffffffffffffffffffffffffffffffffccccffffffffffffffffffffge
egffffffffffffffffffffffffffffffffffffffffffffffffffffffffffffffffffffffffffffffffffffffffffffffffffffffffffffffffccccffffffffffffffffffffge
egfffffffffffffffffffffffffffffffffffffffffffffffffffffffffffffffffffffffffffffffffffffffffffffffffffffffffffffcccccccffffffffffffffffffffge
egfffffffffffffffffffffffffffffffffffffffffffffffffffffffffffffffffffffffffffffffffffffffffffffffffffffffffffffccccccfffffffffffffffffffffge
egffffffffffffffffffffffffffffffffffffffffffffffffffffffffffffffffffffffffffffffffffffffffffffffffffffffccccccccchcccfffffffffffffffffffffge
egffffffffffffffffffffffffffffffffffffffffffffffffffffffffffffffffffffffffffffffffffffffffffffffffffffcccccccccccccccfffffffffffffffffffffge
egfffffffffffffffffffffffffffffffffffffffffffffffffffffffffffffffffffffffffffffffffffffffffffffffffcccccccfcccccccffffffffffffffffffffffffge
egffffffffffffffffffffffffffffffffffffffffffffffffffffffffffffffffffffffffffffffffffffffffffffffcccccccffffccccccfffffffffffffffffffffffffge
egffffffffffffffffffffffffffffffffffffffffffffffffffffffffffffffffffffffffffffffffffffffffffffffcccffffffffccccccfffffffffffffffffffffffffge
egffffffffffffffffffffffffffffffffffffffffffffffffffffffffffffffffffffffffffffffffffffffffffffffffffffffffchccccffffffffffffffffffffffffffge
egfffffffffffffffffffffffffffffffffffffffffffffffffffffffffffffffffffffffffffffffffffffffffffffffffffffcccccccffffffffffffffffffffffffffffge
egfffffffffffffffffffffffffffffffffffffffffffffffffffffffffffffffffffffffffffffffffffffffffffffffffffccccccccccfffffffffffffffffffffffffffge
egfffffffffffffffffffffffffffffffffffffffffffffffffffffffffffffffffffffffffffffffffffffffffffffffffffccccccccccfffffffffffffffffffffffffffge
egffffffffffffffffffffffffffffffffffffffffffffffffffffffffffffffffffffffffffffffffffffffffffffffffffcccccccffccfffffffffffffffffffffffffffge
egfffffffffffffffffffffffffffffffffffffffffffffffffffffffffffffffffffffffffffffffffffffffffffffffccccchcccfffcffffffffffffffffffffffffffffge
egfffffffffffffffffffffffffffffffffffffffffffffffffffffffffffffffffffffffffffffffffffffffffffffffccccccccfffffffffffffffffffffffffffffffffge
egffffffffffffffffffffffffffffffffffffffffffffffffffffffffffffffffffffffffffffffffffffffffffffffcccccccccfffffffffffffffffffffffffffffffffge
egffffffffffffffffffffffffffffffffffffffffffffffffffffffffffffffffffffffffffffffffffffffffffffcccccffffccccfffffffffffffffffffffffffffffffge
egfffffffffffffffffffffffffffffffffffffffffffffffffffffffffffffffffffffffffffffffffffffffffffcccccffffffcccccfffffffffffffffffffffffffffffge
egffffffffffffffffffffffffffffffffffffffffffffffffffffffffffffffffffffffffffffffffffffffffffcccccfffffffcccccfffffffffffffffffffffffffffffge
egffffffffffffffffffffffffffffffffffffffffffffffffffffffffffffffffffffffffffffffffffffffffffccccfffffffffcccccffffffffffffffffffffffffffffge
egffffffffffffffffffffffffffffffffffffffffffffffffffffffffffffffffffffffffffffffffffffffffffchccfffffffffcccccffffffffffffffffffffffffffffge
egffffffffffffffffffffffffffffffffffffffffffffffffffffffffffffffffffffffffffffffffffffffffffccccfffffffffffcccffffffffffffffffffffffffffffge
egfffffffffffffffffffffffffffffffffffffffffffffffffffffffffffffffffffffffffffffffffffffffffccccfffffffffffffccccffffffffffffffffffffffffffge
egfffffffffffffffffffffffffffffffffffffffffffffffffffffffffffffffffffffffffffffffffffffffffccccffffffffffffffcccffffffffffffffffffffffffffge
egfffffffffffffffffffffffffffffffffffffffffffffffffffffffffffffffffffffffffffffffffffffffffccccffffffffffffffcccffffffffffffffffffffffffffge
egffffffffffffffffffffffffffffffffffffffffffffffffffffffffffffffffffffffffffffffffffffffffcccfffffffffffffffffffffffffffffffffffffffffffffge
egffffffffffffffffffffffffffffffffffffffffffffffffffffffffffffffffffffffffffffffffffffffffcccfffffffffffffffffffffffffffffffffffffffffffffge
egffffffffffffffffffffffffffffffffffffffffffffffffffffffffffffffffffffffffffffffffffffffffccffffffffffffffffffffffffffffffffffffffffffffffge
egfffffffffffffffffffffffffffffffffffffffffffffffffffffffffffffffffffffffffffffffffffffffcccffffffffffffffffffffffffffffffffffffffffffffffge
egfffffffffffffffffffffffffffffffffffffffffffffffffffffffffffffffffffffffffffffffffffffffccfffffffffffffffffffffffffffffffffffffffffffffffge
egfffffffffffffffffffffffffffffffffffffffffffffffffffffffffffffffffffffffffffffffffffffccccfffffffffffffffffffffffffffffffffffffffffffffffge
egfffffffffffffffffffffffffffffffffffffffffffffffffffffffffffffffffffffffffffffffffffffcccffffffffffffffffffffffffffffffffffffffffffffffffge
egffffffffffffffffffffffffffffffffffffffffffffffffffffffffffffffffffffffffffffffffffffccchffffffffffffffffffffffffffffffffffffffffffffffffge
egfffffffffffffffffffffffffffffffffffffffffffffffffffffffffffffffffffffffffffffffffffccccfffffffffffffffffffffffffffffffffffffffffffffffffge
egffffffffffffffffffffffffffffffffffffffffffffffffffffffffffffffffffffffffffffffffffcccccfffffffffffffffffffffffffffffffffffffffffffffffffge
egfffffffffffffffffffffffffffffffffffffffffffffffffffffffffffffffffffffffffffffffffcccccffffffffffffffffffffffffffffffffffffffffffffffffffge
egffffffffffffffffffffffffffffffffffffffffffffffffffffffffffffffffffffffffffffffffccccccffffffffffffffffffffffffffffffffffffffffffffffffffge
egfffffffffffffffffffffffffffffffffffffffffffffffffffffffffffffffffffffffffffffffcccccccffffffffffffffffffffffffffffffffffffffffffffffffffge
egfffffffffffffffffffffffffffffffffffffffffffffffffffffffffffffffffffffffffffffffcchccccffffffffffffffffffffffffffffffffffffffffffffffffffge
egffffffffffffffffffffffffffffffffffffffffffffffffffffffffffffffffffffffffffffffccccccffffffffffffffffffffffffffffffffffffffffffffffffffffge
egffffffffffffffffffffffffffffffffffffffffffffffffffffffffffffffffffffffffffffcccccccfffffffffffffffffffffffffffffffffffffffffffffffffffffge
egffffffffffffffffffffffffffffffffffffffffffffffffffffffffffffffffffffffffffffcccccccfffffffffffffffffffffffffffffffffffffffffffffffffffffge
egffffffffffffffffffffffffffffffffffffffffffffffffffffffffffffffffffffffffffffcccccfffffffffffffffffffffffffffffffffffffffffffffffffffffffge
egffffffffffffffffffffffffffffffffffffffffffffffffffffffffffffffffffffffffffcccccfffffffffffffffffffffffffffffffffffffffffffffffffffffffffge
egffffffffffffffffffffffffffffffffffffffffffffffffffffffffffffffffffffffffcccccccfffffffffffffffffffffffffffffffffffffffffffffffffffffffffge
egffffffffffffffffffffffffffffffffffffffffffffffffffffffffffffffffffffffffcccccfffffffffffffffffffffffffffffffffffffffffffffffffffffffffffge
egfffffffffffffffffffffffffffffffffffffffffffffffffffffffffffffffffffffffccchcccffffffffffffffffffffffffffffffffffffffffffffffffffffffffffge
egfffffffffffffffffffffffffffffffffffffffffffffffffffffffffffffffffffffffcccccccffffffffffffffffffffffffffffffffffffffffffffffffffffffffffge
egfffffffffffffffffffffffffffffffffffffffffffffffffffffffffffffffffffffcccccccccffffffffffffffffffffffffffffffffffffffffffffffffffffffffffge
egfffffffffffffffffffffffffffffffffffffffffffffffffffffffffffffffffffffccccfcccfffffffffffffffffffffffffffffffffffffffffffffffffffffffffffge
egfffffffffffffffffffffffffffffffffffffffffffffffffffffffffffffffffffffcccffccccccffffffffffffffffffffffffffffffffffffffffffffffffffffffffge
egfffffffffffffffffffffffffffffffffffffffffffffffffffffffffffffffffffffcccffcccccccfffffffffffffffffffffffffffffffffffffffffffffffffffffffge
egfffffffffffffffffffffffffffffffffffffffffffffffffffffffffffffffffffcccffffffccccccffffffffffffffffffffffffffffffffffffffffffffffffffffffge
egfffffffffffffffffffffffffffffffffffffffffffffffffffffffffffffffffffccfffffffcccccccfffffffffffffffffffffffffffffffffffffffffffffffffffffge
egffffffffffffffffffffffffffffffffffffffffffffffffffffffffffffffffffcccfffffffcccccccfffffffffffffffffffffffffffffffffffffffffffffffffffffge
egfffffffffffffffffffffffffffffffffffffffffffffffffffffffffffffffffcccfffffffffcccccffffffffffffffffffffffffffffffffffffffffffffffffffffffge
egffffffffffffffffffffffffffffffffffffffffffffffffffffffffffffffffccccffffffffffcccfffffffffffffffffffffffffffffffffffffffffffffffffffffffge
egffffffffffffffffffffffffffffffffffffffffffffffffffffffffffffffffcccfffffffffffffffffffffffffffffffffffffffffffffffffffffffffffffffffffffge
egfffffffffffffffffffffffffffffffffffffffffffffffffffffffffffffcccchffffffffffffffffffffffffffffffffffffffffffffffffffffffffffffffffffffffge
egffffffffffffffffffffffffffffffffffffffffffffffffffffffffffffcccccfffffffffffffffffffffffffffffffffffffffffffffffffffffffffffffffffffffffge
egffffffffffffffffffffffffffffffffffffffffffffffffffffffffffffcccccfffffffffffffffffffffffffffffffffffffffffffffffffffffffffffffffffffffffge
egfffffffffffffffffffffffffffffffffffffffffffffffffffffffffffcccccffffffffffffffffffffffffffffffffffffffffffffffffffffffffffffffffffffffffge
egfffffffffffffffffffffffffffffffffffffffffffffffffffffffffffccccfffffffffffffffffffffffffffffffffffffffffffffffffffffffffffffffffffffffffge
egfffffffffffffffffffffffffffffffffffffffffffffffffffffffffffcccffffffffffffffffffffffffffffffffffffffffffffffffffffffffffffffffffffffffffge
egfffffffffffffffffffffffffffffffffffffffffffffffffffffffffffcccffffffffffffffffffffffffffffffffffffffffffffffffffffffffffffffffffffffffffge
egffffffffffffffffffffffffffffffffffffffffffffffffffffffffffccffffffffffffffffffffffffffffffffffffffffffffffffffffffffffffffffffffffffffffge
egfffffffffffffffffffffffffffffffffffffffffffffffffffffffffcccffffffffffffffffffffffffffffffffffffffffffffffffffffffffffffffffffffffffffffge
egffffffffffffffffffffffffffffffffffffffffffffffffffffffffcccfffffffffffffffffffffffffffffffffffffffffffffffffffffffffffffffffffffffffffffge
egffffffffffffffffffffffffffffffffffffffffffffffffffffffffccffffffffffffffffffffffffffffffffffffffffffffffffffffffffffffffffffffffffffffffge
egffffffffffffffffffffffffffffffffffffffffffffffffffffffffcccfffffffffffffffffffffffffffffffffffffffffffffffffffffffffffffffffffffffffffffge
egffffffffffffffffffffffffffffffffffffffffffffffffffffffffcccfffffffffffffffffffffffffffffffffffffffffffffffffffffffffffffffffffffffffffffge
egffffffffffffffffffffffffffffffffffffffffffffffffffffffffcccfffffffffffffffffffffffffffffffffffffffffffffffffffffffffffffffffffffffffffffge
egfffffffffffffffffffffffffffffffffffffffffffffffffffffffccfffffffffffffffffffffffffffffffffffffffffffffffffffffffffffffffffffffffffffffffge
egffffffffffffffffffffffffffffffffffffffffffffffffffffffccffffffffffffffffffffffffffffffffffffffffffffffffffffffffffffffffffffffffffffffffge
egfffffffffffffffffffffffffffffffffffffffffffffffffffffcccffffffffffffffffffffffffffffffffffffffffffffffffffffffffffffffffffffffffffffffffge
egfffffffffffffffffffffffffffffffffffffffffffffffffffccccfffffffffffffffffffffffffffffffffffffffffffffffffffffffffffffffffffffffffffffffffge
egffffffffffffffffffffffffffffffffffffffffffffffffffcccccfffffffffffffffffffffffffffffffffffffffffffffffffffffffffffffffffffffffffffffffffge
egffffffffffffffffffffffffffffffffffffffffffffffffccccccffffffffffffffffffffffffffffffffffffffffffffffffffffffffffffffffffffffffffffffffffge
egffffffffffffffffffffffffffffffffffffffffffffffccccccffffffffffffffffffffffffffffffffffffffffffffffffffffffffffffffffffffffffffffffffffffge
egffffffffffffffffffffffffffffffffffffffffffffffccccccffffffffffffffffffffffffffffffffffffffffffffffffffffffffffffffffffffffffffffffffffffge
egfffffffffffffffffffffffffffffffffffffffffcccccccccccffffffffffffffffffffffffffffffffffffffffffffffffffffffffffffffffffffffffffffffffffffge
egffffffffffffffffffffffffffffffffffffffffcccccccccccfffffffffffffffffffffffffffffffffffffffffffffffffffffffffffffffffffffffffffffffffffffge
egffffffffffffffffffffffffffffffffffffffffcccccccccccfffffffffffffffffffffffffffffffffffffffffffffffffffffffffffffffffffffffffffffffffffffge
egfffffffffffffffffffffffffffffffffffffccccccccccccccfffffffffffffffffffffffffffffffffffffffffffffffffffffffffffffffffffffffffffffffffffffge
egffffffffffffffffffffffffffffffffffffcccccccccccccccfffffffffffffffffffffffffffffffffffffffffffffffffffffffffffffffffffffffffffffffffffffge
egffffffffffffffffffffffffffffffffffffccccccccccccccffffffffffffffffffffffffffffffffffffffffffffffffffffffffffffffffffffffffffffffffffffffge
egffffffffffffffffffffffffffffffffffffccfcccccccccccffffffffffffffffffffffffffffffffffffffffffffffffffffffffffffffffffffffffffffffffffffffge
egffffffffffffffffffffffffffffffffffffffffcccccccccfffffffffffffffffffffffffffffffffffffffffffffffffffffffffffffffffffffffffffffffffffffffge
egffffffffffffffffffffffffffffffffffffffffcccccccccfffffffffffffffffffffffffffffffffffffffffffffffffffffffffffffffffffffffffffffffffffffffge
egffffffffffffffffffffffffffffffffffffffffffccccccffffffffffffffffffffffffffffffffffffffffffffffffffffffffffffffffffffffffffffffffffffffffge
egfffffffffffffffffffffffffffffffffffffffffffcccccffffffffffffffffffffffffffffffffffffffffffffffffffffffffffffffffffffffffffffffffffffffffge
egfffffffffffffffffffffffffffffffffffffffffffffcffffffffffffffffffffffffffffffffffffffffffffffffffffffffffffffffffffffffffffffffffffffffffge
egfffffffffffffffffffffffffffffffffffffffffffffJffffffffffffffffffffffffffffffffffffffffffffffffffffffffffffffffffffffffffffffffffffffffffge
egffffffffffffffffffffffffffffffffffffffffffffffffffffffffffffffffffffffffffffffffffffffffffffffffffffffffffffffffffffffffffffffffffffffffge
egffffffffffffffffffffffffffffffffffffffffffffffffffffffffffffffffffffffffffffffffffffffffffffffffffffffffffffffffffffffffffffffffffffffffge
egffffffffffffffffffffffffffffffffffffffffffffffffffffffffffffffffffffffffffffffffffffffffffffffffffffffffffffffffffffffffffffffffffffffffge
egffffffffffffffffffffffffffffffffffffffffffffffffffffffffffffffffffffffffffffffffffffffffffffffffffffffffffffffffffffffffffffffffffffffffge
egffffffffffffffffffffffffffffffffffffffffffffffffffffffffffffffffffffffffffffffffffffffffffffffffffffffffffffffffffffffffffffffffffffffffge
egffffffffffffffffffffffffffffffffffffffffffffffffffffffffffffffffffffffffffffffffffffffffffffffffffffffffffffffffffffffffffffffffffffffffge
egffffffffffffffffffffffffffffffffffffffffffffffffffffffffffffffffffffffffffffffffffffffffffffffffffffffffffffffffffffffffffffffffffffffffge
egffffffffffffffffffffffffffffffffffffffffffffffffffffffffffffffffffffffffffffffffffffffffffffffffffffffffffffffffffffffffffffffffffffffffge
egffffffffffffffffffffffffffffffffffffffffffffffffffffffffffffffffffffffffffffffffffffffffffffffffffffffffffffffffffffffffffffffffffffffffge
egffffffffffffffffffffffffffffffffffffffffffffffffffffffffffffffffffffffffffffffffffffffffffffffffffffffffffffffffffffffffffffffffffffffffge
egffffffffffffffffffffffffffffffffffffffffffffffffffffffffffffffffffffffffffffffffffffffffffffffffffffffffffffffffffffffffffffffffffffffffge
egffffffffffffffffffffffffffffffffffffffffffffffffffffffffffffffffffffffffffffffffffffffffffffffffffffffffffffffffffffffffffffffffffffffffge
egffffffffffffffffffffffffffffffffffffffffffffffffffffffffffffffffffffffffffffffffffffffffffffffffffffffffffffffffffffffffffffffffffffffffge
egffffffffffffffffffffffffffffffffffffffffffffffffffffffffffffffffffffffffffffffffffffffffffffffffffffffffffffffffffffffffffffffffffffffffge
egffffffffffffffffffffffffffffffffffffffffffffffffffffffffffffffffffffffffffffffffffffffffffffffffffffffffffffffffffffffffffffffffffffffffge
egggggggggggggggggggggggggggggggggggggggggggggggggggggggggggggggggggggggggggggggggggggggggggggggggggggggggggggggggggggggggggggggggggggggggge
eeeeeeeeeeeeeeeeeeeeeeeeeeeeeeeeeeeeeeeeeeeeeeeeeeeeeeeeeeeeeeeeeeeeeeeeeeeeeeeeeeeeeeeeeeeeeeeeeeeeeeeeeeeeeeeeeeeeeeeeeeeeeeeeeeeeeeeeeeee
"}
