//MAP CONVERTED BY dmm2tgm.py THIS HEADER COMMENT PREVENTS RECONVERSION, DO NOT REMOVE
"a" = (
/obj/structure/table/woodentable/holotable,
/turf/simulated/floor/holofloor/wood,
/area/holodeck/holodorm/source_basic)
"w" = (
/obj/structure/bed/chair/holochair{
	dir = 4
	},
/turf/simulated/floor/holofloor/wood,
/area/holodeck/holodorm/source_basic)
"G" = (
/obj/structure/bed/chair/holochair{
	dir = 8
	},
/turf/simulated/floor/holofloor/wood,
/area/holodeck/holodorm/source_basic)
"U" = (
/obj/structure/bed/holobed,
/turf/simulated/floor/holofloor/wood,
/area/holodeck/holodorm/source_basic)
"Z" = (
/turf/simulated/floor/holofloor/wood,
/area/holodeck/holodorm/source_basic)

(1,1,1) = {"
Z
Z
Z
"}
(2,1,1) = {"
w
Z
U
"}
(3,1,1) = {"
a
Z
a
"}
(4,1,1) = {"
G
Z
Z
"}
(5,1,1) = {"
a
Z
U
"}
(6,1,1) = {"
a
Z
a
"}
