//MAP CONVERTED BY dmm2tgm.py THIS HEADER COMMENT PREVENTS RECONVERSION, DO NOT REMOVE
"a" = (
/turf/simulated/floor/holofloor/wood,
/area/holodeck/holodorm/source_seating)
"f" = (
/obj/structure/bed/chair/holochair{
	dir = 8
	},
/obj/effect/floor_decal/carpet{
	dir = 4
	},
/turf/simulated/floor/holofloor/carpet,
/area/holodeck/holodorm/source_seating)
"h" = (
/obj/structure/bed/chair/holochair{
	dir = 4
	},
/obj/effect/floor_decal/carpet{
	dir = 8
	},
/turf/simulated/floor/holofloor/carpet,
/area/holodeck/holodorm/source_seating)
"j" = (
/obj/structure/table/woodentable/holotable,
/turf/simulated/floor/holofloor/carpet,
/area/holodeck/holodorm/source_seating)
"m" = (
/obj/effect/floor_decal/carpet{
	dir = 1
	},
/obj/effect/floor_decal/carpet{
	dir = 4
	},
/obj/effect/floor_decal/carpet{
	dir = 5
	},
/turf/simulated/floor/holofloor/carpet,
/area/holodeck/holodorm/source_seating)
"x" = (
/obj/structure/bed/chair/holochair{
	dir = 1
	},
/obj/effect/floor_decal/carpet,
/turf/simulated/floor/holofloor/carpet,
/area/holodeck/holodorm/source_seating)
"B" = (
/obj/effect/floor_decal/carpet{
	dir = 8
	},
/obj/effect/floor_decal/carpet,
/obj/effect/floor_decal/carpet{
	dir = 10
	},
/turf/simulated/floor/holofloor/carpet,
/area/holodeck/holodorm/source_seating)
"D" = (
/obj/structure/bed/chair/holochair,
/obj/effect/floor_decal/carpet{
	dir = 1
	},
/turf/simulated/floor/holofloor/carpet,
/area/holodeck/holodorm/source_seating)
"K" = (
/obj/effect/floor_decal/carpet{
	dir = 4
	},
/obj/effect/floor_decal/carpet,
/obj/effect/floor_decal/carpet{
	dir = 6
	},
/turf/simulated/floor/holofloor/carpet,
/area/holodeck/holodorm/source_seating)
"Q" = (
/obj/effect/floor_decal/carpet{
	dir = 8
	},
/obj/effect/floor_decal/carpet{
	dir = 1
	},
/obj/effect/floor_decal/carpet{
	dir = 9
	},
/turf/simulated/floor/holofloor/carpet,
/area/holodeck/holodorm/source_seating)

(1,1,1) = {"
a
a
a
"}
(2,1,1) = {"
Q
h
B
"}
(3,1,1) = {"
D
j
x
"}
(4,1,1) = {"
D
j
x
"}
(5,1,1) = {"
m
f
K
"}
(6,1,1) = {"
a
a
a
"}
