//MAP CONVERTED BY dmm2tgm.py THIS HEADER COMMENT PREVENTS RECONVERSION, DO NOT REMOVE
"a" = (
/turf/simulated/floor/holofloor/snow,
/area/holodeck/holodorm/source_snow)
"b" = (
/obj/structure/flora/grass/green,
/turf/simulated/floor/holofloor/snow,
/area/holodeck/holodorm/source_snow)
"h" = (
/obj/structure/flora/grass/brown,
/turf/simulated/floor/holofloor/snow,
/area/holodeck/holodorm/source_snow)
"j" = (
/obj/structure/flora/grass/both,
/turf/simulated/floor/holofloor/snow,
/area/holodeck/holodorm/source_snow)
"n" = (
/obj/structure/flora/grass/green,
/obj/structure/flora/tree/pine,
/turf/simulated/floor/holofloor/snow,
/area/holodeck/holodorm/source_snow)
"F" = (
/obj/landmark{
	name = "Wolfgirl Spawn"
	},
/turf/simulated/floor/holofloor/snow,
/area/holodeck/holodorm/source_snow)
"W" = (
/obj/structure/flora/grass/brown,
/obj/structure/flora/tree/dead,
/turf/simulated/floor/holofloor/snow,
/area/holodeck/holodorm/source_snow)

(1,1,1) = {"
W
a
b
"}
(2,1,1) = {"
a
F
a
"}
(3,1,1) = {"
a
h
a
"}
(4,1,1) = {"
a
n
a
"}
(5,1,1) = {"
a
a
a
"}
(6,1,1) = {"
a
a
j
"}
