//MAP CONVERTED BY dmm2tgm.py THIS HEADER COMMENT PREVENTS RECONVERSION, DO NOT REMOVE
"a" = (
/turf/template_noop,
/area/space)
"A" = (
/turf/simulated/mineral/cave,
/area/space)
"Q" = (
/turf/simulated/floor/outdoors/dirt,
/area/space)
"Z" = (
/turf/simulated/shuttle/wall/voidcraft/red,
/area/space)

(1,1,1) = {"
a
a
a
a
a
a
a
a
a
a
a
a
a
a
a
a
a
a
a
a
a
a
a
a
a
a
a
a
a
a
a
a
a
a
a
a
a
a
a
a
a
a
a
a
a
a
a
a
a
a
a
a
a
a
a
"}
(2,1,1) = {"
a
a
a
a
a
a
a
a
a
a
a
a
a
a
a
a
a
a
a
a
a
a
a
a
a
a
a
a
a
a
A
A
A
A
A
A
a
a
a
a
a
a
a
a
a
a
a
a
a
a
a
a
a
a
a
"}
(3,1,1) = {"
a
a
a
a
a
a
a
a
a
a
a
a
a
a
a
a
a
a
a
a
a
a
a
a
A
A
A
A
A
A
A
Q
Q
Q
Q
A
A
A
A
a
a
a
a
a
a
a
a
a
a
a
a
a
a
a
a
"}
(4,1,1) = {"
a
a
a
a
a
a
a
a
a
a
a
a
a
a
a
a
a
a
a
a
a
A
A
A
A
Q
Q
Q
Q
Q
Q
Q
Q
Q
Q
Q
Q
Q
A
A
A
a
a
a
a
a
a
a
a
a
a
a
a
a
a
"}
(5,1,1) = {"
a
a
a
a
a
a
a
a
a
a
a
a
a
a
a
a
a
a
a
a
A
A
Z
Z
Z
Z
Z
Q
Q
Q
Q
Q
Q
Q
Q
Q
Q
Q
Q
Q
A
A
A
a
a
a
a
a
a
a
a
a
a
a
a
"}
(6,1,1) = {"
a
a
a
a
a
a
a
a
a
a
a
a
a
a
a
a
a
a
a
A
A
Q
Z
Q
Q
Q
Z
Q
Q
Q
Q
Q
Q
Q
Q
Q
Q
Q
Q
Q
Q
Q
A
A
a
a
a
a
a
a
a
a
a
a
a
"}
(7,1,1) = {"
a
a
a
a
a
a
a
a
a
a
a
a
a
a
a
a
A
A
A
A
Q
Q
Z
Q
Q
Q
Z
Q
Q
Q
Q
Q
Q
Q
Q
Q
Q
Q
Q
Q
Q
Q
Q
A
A
A
A
a
a
a
a
a
a
a
a
"}
(8,1,1) = {"
a
a
a
a
a
a
a
a
a
a
a
a
a
A
A
A
A
Q
Z
Z
Z
Z
Z
Q
Q
Q
Z
Z
Z
Z
Z
Q
Q
Q
Q
Q
Q
Q
Q
Q
Q
Q
Q
Q
Q
Q
A
A
A
a
a
a
a
a
a
"}
(9,1,1) = {"
a
a
a
a
a
a
a
a
a
a
A
A
A
A
Q
Q
Q
Q
Z
Q
Q
Q
Z
Z
Q
Z
Z
Q
Q
Q
Z
Q
Q
Q
Q
Q
Q
Q
Q
Q
Q
Q
Q
Q
Q
Q
Q
Q
A
a
a
a
a
a
a
"}
(10,1,1) = {"
a
a
a
a
a
a
a
a
A
A
A
Q
Q
Q
Q
Q
Q
Q
Z
Q
Q
Q
Q
Q
Q
Q
Q
Q
Q
Q
Z
Q
Q
Q
Q
Q
Q
Q
Q
Q
Q
Q
Q
Q
Q
Q
Q
Q
A
A
a
a
a
a
a
"}
(11,1,1) = {"
a
a
a
a
a
a
a
A
A
Q
Q
Q
Q
Q
Q
Q
Q
Q
Z
Z
Z
Z
Z
Q
Q
Q
Z
Z
Z
Z
Z
Q
Q
Q
Q
Q
Q
Q
Q
Q
Q
Q
Q
Q
Q
Q
Q
Q
Q
A
a
a
a
a
a
"}
(12,1,1) = {"
a
a
a
a
a
a
A
A
Q
Q
Q
Q
Q
Q
Q
Q
Q
Q
Z
Q
Q
Q
Z
Q
Q
Q
Z
Q
Q
Q
Z
Q
Q
Q
Q
Q
Q
Q
Q
Q
Q
Q
Q
Q
Q
Q
Q
Q
Q
A
A
a
a
a
a
"}
(13,1,1) = {"
a
a
a
a
a
A
A
Q
Q
Q
Q
Q
Q
Q
Q
Q
Q
Q
Z
Q
Q
Q
Q
Q
Q
Q
Q
Q
Q
Q
Z
Q
Q
Q
Q
Q
Q
Q
Q
Q
Q
Q
Q
Q
Q
Q
Q
Q
Q
Q
A
A
a
a
a
"}
(14,1,1) = {"
a
a
a
a
A
A
Q
Q
Q
Q
Q
Q
Q
Q
Q
Q
Q
Q
Z
Z
Z
Z
Z
Q
Q
Q
Z
Z
Z
Z
Z
Q
Q
Q
Q
Q
Q
Q
Q
Q
Q
Q
Q
Q
Q
A
A
Q
Q
Q
Q
A
A
a
a
"}
(15,1,1) = {"
a
a
a
A
A
Q
Q
Q
Q
Q
Q
Q
Q
Q
Q
Q
Q
Q
Z
Q
Q
Q
Z
Q
Q
Q
Z
Q
Q
Q
Z
Q
Q
Q
Z
Z
Z
Z
Z
Z
Z
Q
Q
A
A
A
A
A
A
Q
Q
Q
A
a
a
"}
(16,1,1) = {"
a
a
a
A
Q
Q
Q
Q
Q
Q
Q
Q
Q
Q
Q
Q
Q
Q
Z
Q
Q
Q
Q
Q
Q
Q
Q
Q
Q
Q
Z
Q
Q
Q
Z
Q
Q
Q
Q
Q
Z
A
A
A
Q
Q
Q
Q
A
A
A
Q
A
A
a
"}
(17,1,1) = {"
a
a
a
A
Q
Q
Q
Q
Q
Q
Q
Q
Q
Q
Q
Q
Q
Q
Z
Z
Z
Z
Z
Q
Q
Q
Z
Z
Z
Z
Z
Q
Q
Q
Z
Q
Q
Q
Q
Q
Z
A
Q
Q
Q
Q
Q
Q
Q
Q
A
A
Q
A
a
"}
(18,1,1) = {"
a
a
A
A
Q
Q
Q
Q
Q
Q
Q
Q
Q
Q
Q
Q
Q
Q
Z
Q
Q
Q
Z
Q
Q
Q
Z
Q
Q
Q
Z
Q
Q
Q
Z
Q
Q
Q
Q
Q
Q
Q
Q
Q
Q
Q
Q
Q
Q
Q
Q
A
Q
A
a
"}
(19,1,1) = {"
a
a
A
Q
Q
Z
Z
Z
Z
Z
Z
Q
Q
Q
Q
Q
Q
Q
Z
Q
Q
Q
Q
Q
Q
Q
Q
Q
Q
Q
Z
Q
Q
Q
Z
Q
Q
Q
Q
Q
Q
Q
Q
A
A
A
A
Q
Q
Q
Q
A
Q
A
a
"}
(20,1,1) = {"
a
a
A
Q
Q
Z
Q
Q
Q
Q
Z
Q
Q
Q
Q
Q
Q
Q
Z
Z
Z
Z
Z
Z
Q
Z
Z
Z
Z
Z
Z
Q
Q
Q
Z
Q
Q
Q
Q
Q
Z
A
A
A
Q
Q
A
A
A
Q
Q
A
Q
A
a
"}
(21,1,1) = {"
a
a
A
Q
Q
Z
Q
Q
Q
Q
Z
Q
Q
Q
Q
Q
Q
Q
Q
Z
Z
Q
Q
Q
Q
Q
Q
Q
Z
Z
Q
Q
Q
Q
Z
Q
Q
Q
Q
Q
Z
Q
Q
Q
Q
Q
Q
Q
A
Q
Q
A
A
A
A
"}
(22,1,1) = {"
a
a
A
Q
Q
Z
Z
Q
Q
Q
Z
Q
Q
Q
Q
Q
Q
Q
Q
Z
Q
Q
Q
Q
Q
Q
Q
Q
Q
Z
Q
Q
Q
Q
Z
Q
Q
Q
Q
Q
Z
Q
Q
Q
Q
Q
Q
Q
A
A
Q
Q
A
A
A
"}
(23,1,1) = {"
a
a
A
Q
Q
Q
Z
Q
Q
Q
Z
Q
Q
Q
Q
Q
Q
Q
Q
Z
Q
Q
Q
Q
Q
Q
Q
Q
Q
Z
Z
Z
Z
Z
Z
Z
Z
Q
Z
Z
Z
Z
A
A
A
A
A
A
Z
Z
Z
Z
Z
A
A
"}
(24,1,1) = {"
a
a
A
Q
Q
Z
Z
Z
Z
Q
Z
Z
Z
Z
Z
Z
Z
Z
Z
Z
Q
Q
Q
Q
Q
Q
Q
Q
Q
Z
Q
Z
Q
Z
Q
Z
Q
Q
Q
Z
Q
Z
Q
A
A
Z
Z
Z
Z
Q
Q
Q
Z
Z
A
"}
(25,1,1) = {"
a
a
A
Q
Q
Z
Q
Q
Z
Q
Z
Q
Z
Q
Z
Q
Z
Q
Z
Q
Q
Q
Q
Q
Q
Q
Q
Q
Q
Z
Q
Q
Q
Q
Q
Q
Q
Q
Q
Q
Q
Q
Q
A
A
Z
Q
Q
Q
Q
Q
Q
Q
Z
A
"}
(26,1,1) = {"
a
a
A
Q
Q
Q
Q
Q
Q
Q
Q
Q
Q
Q
Q
Q
Q
Q
Q
Q
Q
Q
Q
Q
Q
Q
Q
Q
Q
Q
Q
Q
Q
Q
Q
Q
Q
Q
Q
Q
Q
Q
Q
Q
A
Q
Q
Q
Q
Q
Q
Q
Q
Z
A
"}
(27,1,1) = {"
a
a
A
Q
Q
Q
Q
Q
Q
Q
Q
Q
Q
Q
Q
Q
Q
Q
Q
Q
Q
Q
Q
Q
Q
Q
Q
Q
Q
Q
Q
Q
Q
Q
Q
Q
Q
Q
Q
Q
Q
Q
Q
Q
A
Q
Q
Q
Q
Q
Q
Q
Q
Z
A
"}
(28,1,1) = {"
a
a
A
Q
Q
Z
Q
Q
Z
Q
Z
Q
Z
Q
Z
Q
Z
Q
Z
Q
Q
Q
Q
Q
Q
Q
Q
Q
Q
Z
Q
Q
Q
Q
Q
Q
Q
Q
Q
Q
Q
Q
Q
Q
A
Z
Q
Q
Q
Q
Q
Q
Q
Z
A
"}
(29,1,1) = {"
a
a
A
Q
Q
Z
Z
Z
Z
Q
Z
Z
Z
Z
Z
Z
Z
Z
Z
Z
Q
Q
Q
Q
Q
Q
Q
Q
Q
Z
Q
Z
Q
Z
Q
Z
Q
Q
Q
Z
Q
Z
Q
A
A
Z
Z
Z
Z
Q
Q
Q
Z
Z
A
"}
(30,1,1) = {"
a
a
A
Q
Q
Q
Z
Q
Q
Q
Z
Q
Q
Q
Q
Q
Q
Q
Q
Z
Q
Q
Q
Q
Q
Q
Q
Q
Q
Z
Z
Z
Z
Z
Z
Z
Z
Q
Z
Z
Z
Z
A
A
A
A
A
A
Z
Z
Z
Z
Z
Q
A
"}
(31,1,1) = {"
a
a
A
Q
Q
Z
Z
Q
Q
Q
Z
Q
Q
Q
Q
Q
Q
Q
Q
Z
Q
Q
Q
Q
Q
Q
Q
Q
Q
Z
Q
Q
Q
Q
Z
Q
Q
Q
Q
Q
Z
Q
Q
Q
Q
Q
Q
Q
Q
Q
Q
Q
Q
Q
A
"}
(32,1,1) = {"
a
a
A
Q
Q
Z
Q
Q
Q
Q
Z
Q
Q
Q
Q
Q
Q
Q
Q
Z
Z
Q
Q
Q
Q
Q
Q
Q
Z
Z
Q
Q
Q
Q
Z
Q
Q
Q
Q
Q
Z
Q
Q
Q
Q
Q
Q
Q
Q
Q
Q
Q
Q
Q
A
"}
(33,1,1) = {"
a
a
A
A
Q
Z
Q
Q
Q
Q
Z
Q
Q
Q
Q
Q
Q
Z
Z
Z
Z
Z
Z
Z
Q
Z
Z
Z
Z
Z
Z
Z
Q
Q
Z
Q
Q
Q
Q
Q
Z
Q
Q
Q
Q
Q
Q
Q
Q
Q
Q
Q
Q
Q
A
"}
(34,1,1) = {"
a
a
a
A
Q
Z
Z
Z
Z
Z
Z
Q
Q
Q
Q
Q
Q
Z
Q
Q
Q
Q
Z
Q
Q
Q
Z
Q
Q
Q
Q
Z
Q
Z
Z
Z
Z
Q
Z
Z
Z
Z
Z
Z
Z
Q
Q
Q
Q
Q
Q
Q
Q
A
A
"}
(35,1,1) = {"
a
a
a
A
Q
Q
Q
Q
Q
Q
Q
Q
Q
Q
Q
Q
Q
Z
Q
Q
Q
Q
Q
Q
Q
Q
Q
Q
Q
Q
Q
Z
Q
Z
Q
Q
Q
Q
Q
Q
Q
Q
Q
Q
Z
Q
Q
Q
Q
Q
Q
Q
Q
A
a
"}
(36,1,1) = {"
a
a
a
A
Q
Q
Q
Q
Q
Q
Q
Q
Q
Q
Q
Q
Q
Z
Q
Q
Q
Q
Z
Q
Q
Q
Z
Q
Q
Q
Q
Z
Q
Z
Q
Q
Q
Q
Q
Q
Q
Q
Q
Q
Z
Q
Q
Q
Q
Q
Q
Q
Q
A
a
"}
(37,1,1) = {"
a
a
a
A
A
Q
Q
Q
Q
Q
Q
Q
Q
Q
Q
Q
Q
Z
Q
Q
Q
Q
Z
Q
Q
Q
Z
Q
Q
Q
Q
Z
Q
Z
Q
Q
Q
Q
Q
Q
Q
Q
Q
Q
Z
Q
Q
Q
Q
Q
Q
Q
Q
A
a
"}
(38,1,1) = {"
a
a
a
a
A
A
A
Q
Q
Q
Q
Q
Q
Q
Q
Q
Q
Z
Z
Z
Z
Z
Z
Q
Q
Q
Z
Z
Z
Z
Z
Z
Q
Z
Q
Q
Q
Q
Q
Q
Q
Q
Q
Q
Z
Q
Q
Q
Q
Q
Q
Q
Q
A
a
"}
(39,1,1) = {"
a
a
a
a
a
a
A
A
A
Q
Q
Q
Q
Q
Q
Q
Q
Z
Q
Q
Q
Q
Z
Q
Q
Q
Z
Q
Q
Q
Q
Z
Q
Z
Q
Q
Q
Q
Q
Q
Q
Q
Q
Q
Z
Q
Q
Q
Q
Q
Q
Q
Q
A
a
"}
(40,1,1) = {"
a
a
a
a
a
a
a
a
A
A
Q
Q
Q
Q
Q
Q
Q
Z
Q
Q
Q
Q
Z
Q
Q
Q
Z
Q
Q
Q
Q
Z
Q
Z
Q
Q
Q
Q
Q
Q
Q
Q
Q
Q
Z
Q
Q
Q
Q
Q
Q
Q
Q
A
a
"}
(41,1,1) = {"
a
a
a
a
a
a
a
a
a
A
A
A
Q
Q
Q
Q
Q
Z
Q
Q
Q
Q
Q
Q
Q
Q
Q
Q
Q
Q
Q
Z
Q
Z
Q
Q
Q
Q
Q
Q
Q
Q
Q
Q
Z
Q
Q
Q
Q
Q
Q
Q
A
A
a
"}
(42,1,1) = {"
a
a
a
a
a
a
a
a
a
a
a
A
Q
Q
Q
Q
Q
Z
Q
Q
Q
Q
Z
Q
Q
Q
Z
Q
Q
Q
Q
Z
Q
Z
Q
Q
Q
Q
Q
Q
Q
Q
Q
Q
Z
Q
Q
Q
Q
Q
Q
Q
A
a
a
"}
(43,1,1) = {"
a
a
a
a
a
a
a
a
a
a
a
a
A
A
A
Q
Q
Z
Z
Z
Z
Z
Z
Q
Q
Q
Z
Z
Z
Z
Z
Z
Q
Z
Z
Z
Z
Z
Z
Z
Z
Z
Z
Z
Z
A
A
A
A
A
A
A
A
a
a
"}
(44,1,1) = {"
a
a
a
a
a
a
a
a
a
a
a
a
a
a
A
A
A
A
A
A
A
Q
Z
Z
Q
Z
Z
Q
Q
Q
Q
Q
Q
Q
Q
Q
Q
Q
Q
Q
Q
A
A
A
A
A
a
a
a
a
a
a
a
a
a
"}
(45,1,1) = {"
a
a
a
a
a
a
a
a
a
a
a
a
a
a
a
a
a
a
a
a
A
A
A
Z
Z
Z
Q
Q
Q
Q
Q
Q
Q
Q
Q
Q
Q
Q
Q
A
A
A
a
a
a
a
a
a
a
a
a
a
a
a
a
"}
(46,1,1) = {"
a
a
a
a
a
a
a
a
a
a
a
a
a
a
a
a
a
a
a
a
a
a
A
A
A
A
Q
Q
Q
Q
Q
Q
Q
Q
Q
Q
Q
A
A
A
a
a
a
a
a
a
a
a
a
a
a
a
a
a
a
"}
(47,1,1) = {"
a
a
a
a
a
a
a
a
a
a
a
a
a
a
a
a
a
a
a
a
a
a
a
a
a
A
A
A
A
Q
Q
Q
Q
Q
Q
A
A
A
a
a
a
a
a
a
a
a
a
a
a
a
a
a
a
a
a
"}
(48,1,1) = {"
a
a
a
a
a
a
a
a
a
a
a
a
a
a
a
a
a
a
a
a
a
a
a
a
a
a
a
a
A
A
A
A
A
A
A
A
a
a
a
a
a
a
a
a
a
a
a
a
a
a
a
a
a
a
a
"}
(49,1,1) = {"
a
a
a
a
a
a
a
a
a
a
a
a
a
a
a
a
a
a
a
a
a
a
a
a
a
a
a
a
a
a
a
a
a
a
a
a
a
a
a
a
a
a
a
a
a
a
a
a
a
a
a
a
a
a
a
"}
