//MAP CONVERTED BY dmm2tgm.py THIS HEADER COMMENT PREVENTS RECONVERSION, DO NOT REMOVE
"aY" = (
/turf/simulated/floor/trap/crystal/classp,
/area/space)
"cz" = (
/obj/effect/trap/pop_up/flame{
	id = "entry_corridor"
	},
/turf/simulated/floor/trap/phoron/classp{
	id = "entry_corridor"
	},
/area/space)
"ef" = (
/obj/machinery/door/blast/puzzle,
/turf/simulated/floor/outdoors/dirt/classp,
/area/space)
"eh" = (
/turf/simulated/floor/trap/wood/classp,
/area/space)
"fB" = (
/turf/simulated/floor/trap/delayed/gold/classp,
/area/space)
"fQ" = (
/turf/simulated/floor/outdoors/mud/classp,
/area/space)
"gr" = (
/turf/template_noop,
/area/space)
"gC" = (
/obj/structure/table/hardwoodtable,
/obj/item/flame/candle/everburn/black,
/turf/simulated/floor/bmarble/classp,
/area/space)
"hQ" = (
/obj/structure/table/hardwoodtable,
/obj/item/flame/candle/everburn/black,
/turf/simulated/floor/wood/classp,
/area/space)
"iX" = (
/turf/simulated/floor/wmarble/classp,
/area/space)
"jo" = (
/obj/effect/trap/launcher/fireball{
	dir = 4;
	id = "entry_corridor";
	pixel_x = -32
	},
/turf/simulated/floor/trap/delayed/phoron/classp{
	id = "entry_corridor"
	},
/area/space)
"jJ" = (
/obj/effect/trap/pop_up/thrower,
/turf/simulated/floor/outdoors/dirt/classp,
/area/space)
"kr" = (
/obj/structure/bookcase,
/turf/simulated/floor/wood/classp,
/area/space)
"kE" = (
/turf/simulated/floor/trap/delayed/bmarble/classp,
/area/space)
"kJ" = (
/obj/structure/table/marble,
/turf/simulated/floor/bmarble/classp,
/area/space)
"kT" = (
/obj/effect/trap/pit/tentacle{
	id = "headmaster_desk"
	},
/turf/simulated/floor/wood/classp,
/area/space)
"md" = (
/obj/structure/table/hardwoodtable,
/turf/simulated/floor/gold/classp,
/area/space)
"mp" = (
/turf/simulated/floor/trap/gold/classp,
/area/space)
"mN" = (
/obj/structure/table/marble,
/turf/simulated/floor/wmarble/classp,
/area/space)
"nD" = (
/turf/simulated/floor/trap/phoron/classp{
	id = "master_trigger"
	},
/area/space)
"nX" = (
/obj/structure/table/bench/wooden,
/turf/simulated/floor/wood/classp,
/area/space)
"od" = (
/turf/simulated/floor/silver/classp,
/area/space)
"ot" = (
/turf/simulated/floor/wood/classp,
/area/space)
"oW" = (
/turf/simulated/floor/trap/delayed/silver/classp,
/area/space)
"qo" = (
/turf/simulated/wall/ironphoron/classp,
/area/space)
"qE" = (
/obj/effect/trap/pop_up/pillar,
/turf/simulated/floor/outdoors/dirt/classp,
/area/space)
"rE" = (
/obj/effect/trap/launcher/fireball_aoe{
	dir = 4
	},
/turf/simulated/floor/outdoors/dirt/classp,
/area/space)
"rF" = (
/obj/effect/trap/pop_up/flame{
	id = "entry_corridor"
	},
/turf/simulated/floor/outdoors/dirt/classp,
/area/space)
"rU" = (
/turf/simulated/floor/outdoors/snow/classp,
/area/space)
"sH" = (
/obj/effect/trap/pop_up/spear,
/turf/simulated/floor/outdoors/dirt/classp,
/area/space)
"sV" = (
/turf/simulated/floor/trap/silver/classp,
/area/space)
"te" = (
/obj/structure/table/hardwoodtable,
/obj/item/flame/candle/candelabra/everburn,
/turf/simulated/floor/gold/classp,
/area/space)
"tY" = (
/obj/structure/bed/chair/wood/wings{
	dir = 4
	},
/turf/simulated/floor/wood/classp,
/area/space)
"we" = (
/obj/effect/trap/launcher/fireball_aoe{
	dir = 8
	},
/turf/simulated/floor/outdoors/dirt/classp,
/area/space)
"xl" = (
/turf/simulated/floor/trap/delayed/crystal/classp{
	id = "entry_corridor"
	},
/area/space)
"xR" = (
/turf/simulated/floor/trap/delayed/phoron/classp,
/area/space)
"zk" = (
/obj/structure/table/hardwoodtable,
/turf/simulated/floor/wood/classp,
/area/space)
"zC" = (
/turf/simulated/floor/water/indoors/classp,
/area/space)
"zY" = (
/turf/simulated/floor/gold/classp,
/area/space)
"AM" = (
/turf/simulated/mineral/floor/classp,
/area/space)
"AN" = (
/turf/simulated/floor/crystal/classp,
/area/space)
"Br" = (
/obj/effect/trap/pop_up/flame{
	id = "entry_corridor"
	},
/turf/simulated/floor/phoron/classp,
/area/space)
"BF" = (
/obj/structure/closet/cabinet,
/turf/simulated/floor/wood/classp,
/area/space)
"Ee" = (
/turf/simulated/wall/solidrock,
/area/space)
"Ek" = (
/turf/simulated/floor/trap/delayed/wmarble/classp,
/area/space)
"Fg" = (
/turf/simulated/floor/phoron/classp,
/area/space)
"GE" = (
/turf/simulated/floor/trap/phoron/classp,
/area/space)
"He" = (
/obj/structure/table/hardwoodtable,
/obj/item/flame/candle/everburn/black,
/turf/simulated/floor/crystal/classp,
/area/space)
"Hh" = (
/obj/effect/trap/launcher/fireball{
	dir = 4;
	id = "entry_corridor";
	pixel_x = -32
	},
/turf/simulated/floor/phoron/classp,
/area/space)
"Ij" = (
/turf/simulated/floor/outdoors/ice/classp,
/area/space)
"IE" = (
/turf/simulated/floor/trap/phoron/classp{
	id = "entry_corridor"
	},
/area/space)
"JP" = (
/obj/structure/table/hardwoodtable,
/turf/simulated/floor/wmarble/classp,
/area/space)
"Ks" = (
/turf/simulated/floor/bmarble/classp,
/area/space)
"La" = (
/turf/simulated/floor/trap/wood/classp{
	id = "headmaster_office"
	},
/area/space)
"Lh" = (
/obj/structure/table/hardwoodtable,
/obj/item/flame/candle/black,
/turf/simulated/floor/wood/classp,
/area/space)
"Lq" = (
/turf/simulated/floor/trap/delayed/wood/classp,
/area/space)
"Nt" = (
/obj/structure/table/hardwoodtable,
/turf/simulated/floor/crystal/classp,
/area/space)
"Pe" = (
/obj/effect/trap/launcher/fireball_aoe{
	dir = 1;
	id = "headmaster_office";
	pixel_y = -32
	},
/turf/simulated/floor/wood/classp,
/area/space)
"Qx" = (
/turf/simulated/floor/trap/delayed/crystal/classp,
/area/space)
"RF" = (
/obj/effect/trap/pop_up/buzzsaw,
/turf/simulated/floor/outdoors/dirt/classp,
/area/space)
"Sz" = (
/obj/structure/table/hardwoodtable,
/obj/item/flame/candle/black,
/turf/simulated/floor/bmarble/classp,
/area/space)
"TM" = (
/turf/simulated/mineral/cave,
/area/space)
"Vb" = (
/turf/simulated/floor/trap/wood/classp{
	id = "headmaster_desk"
	},
/area/space)
"VR" = (
/turf/simulated/floor/trap/bmarble/classp,
/area/space)
"We" = (
/turf/simulated/floor/outdoors/dirt/classp,
/area/space)
"XL" = (
/obj/structure/statue/bone{
	desc = "A towering menhir of bone, perhaps the colossal fang of some fallen beast.";
	name = "The Fang of Agrim'Maw"
	},
/turf/simulated/floor/outdoors/grass/heavy/interior/classp,
/area/space)
"XX" = (
/turf/simulated/floor/trap/wmarble/classp,
/area/space)
"Zc" = (
/obj/effect/trap/pop_up/flame{
	id = "entry_corridor"
	},
/turf/simulated/floor/crystal/classp,
/area/space)
"Zf" = (
/obj/effect/trap/launcher/fireball{
	dir = 8;
	id = "master_trigger";
	pixel_x = 32
	},
/obj/effect/trap/pop_up/flame{
	id = "entry_corridor"
	},
/turf/simulated/floor/phoron/classp,
/area/space)
"Zu" = (
/obj/effect/trap/pop_up/flame{
	id = "entry_corridor"
	},
/obj/effect/trap/launcher/fireball{
	dir = 8;
	id = "master_trigger";
	pixel_x = 32
	},
/turf/simulated/floor/phoron/classp,
/area/space)
"ZV" = (
/turf/simulated/floor/outdoors/grass/heavy/interior/classp,
/area/space)

(1,1,1) = {"
gr
gr
gr
gr
gr
gr
gr
gr
gr
gr
gr
gr
gr
gr
gr
gr
gr
gr
gr
gr
gr
gr
gr
gr
gr
gr
gr
gr
gr
gr
gr
gr
gr
gr
gr
gr
gr
gr
gr
gr
gr
gr
gr
gr
gr
gr
gr
gr
gr
gr
gr
gr
gr
gr
gr
"}
(2,1,1) = {"
gr
gr
gr
gr
gr
gr
gr
gr
gr
gr
gr
gr
gr
gr
gr
gr
gr
gr
gr
gr
gr
gr
gr
rU
rU
rU
rU
rU
rU
rU
TM
TM
TM
TM
TM
TM
gr
gr
gr
gr
gr
gr
gr
gr
gr
gr
gr
gr
rU
rU
gr
gr
gr
gr
gr
"}
(3,1,1) = {"
gr
gr
gr
gr
gr
gr
gr
gr
gr
gr
gr
gr
gr
gr
gr
gr
gr
gr
gr
rU
rU
rU
rU
rU
rU
rU
rU
TM
TM
TM
TM
TM
TM
TM
TM
TM
TM
TM
TM
gr
gr
gr
gr
gr
gr
gr
gr
rU
rU
rU
rU
rU
gr
gr
gr
"}
(4,1,1) = {"
gr
gr
gr
gr
gr
gr
gr
gr
gr
gr
gr
gr
gr
gr
gr
gr
gr
gr
rU
rU
rU
rU
rU
rU
rU
rU
TM
TM
TM
TM
TM
TM
TM
TM
TM
TM
TM
TM
TM
TM
TM
rU
rU
rU
gr
gr
rU
rU
rU
rU
rU
rU
gr
gr
gr
"}
(5,1,1) = {"
gr
gr
gr
gr
gr
gr
gr
gr
gr
gr
gr
gr
rU
rU
rU
gr
rU
rU
rU
rU
rU
rU
rU
rU
TM
TM
TM
TM
TM
TM
TM
TM
TM
TM
TM
AM
AM
TM
TM
TM
TM
TM
TM
rU
rU
rU
rU
rU
rU
rU
rU
rU
gr
gr
gr
"}
(6,1,1) = {"
gr
gr
gr
gr
gr
gr
gr
rU
rU
rU
rU
rU
rU
rU
rU
rU
rU
rU
rU
rU
rU
rU
TM
TM
TM
iX
qo
TM
TM
TM
TM
TM
TM
TM
AM
AM
AM
AM
TM
TM
TM
TM
TM
TM
rU
rU
rU
rU
rU
rU
rU
rU
gr
gr
gr
"}
(7,1,1) = {"
gr
gr
gr
gr
gr
gr
rU
rU
rU
rU
rU
rU
rU
rU
rU
rU
TM
TM
TM
TM
TM
TM
TM
Ks
iX
Ks
qo
TM
TM
TM
TM
TM
TM
TM
AM
AM
AM
AM
AM
TM
TM
AM
TM
TM
TM
TM
TM
rU
rU
rU
rU
rU
gr
gr
gr
"}
(8,1,1) = {"
gr
gr
gr
gr
gr
rU
rU
rU
rU
rU
rU
rU
rU
TM
TM
TM
TM
TM
qo
qo
qo
qo
qo
iX
Ks
iX
qo
qo
qo
qo
qo
TM
TM
AM
AM
AM
AM
AM
AM
AM
TM
AM
AM
TM
TM
TM
TM
TM
TM
rU
rU
rU
rU
gr
gr
"}
(9,1,1) = {"
gr
gr
gr
rU
rU
rU
rU
rU
rU
rU
TM
TM
TM
TM
TM
TM
TM
TM
qo
ot
ot
ot
qo
qo
iX
qo
qo
ot
ot
ot
qo
TM
TM
AM
AM
AM
AM
AM
AM
AM
AM
AM
AM
AM
TM
TM
TM
TM
TM
rU
rU
rU
rU
gr
gr
"}
(10,1,1) = {"
gr
gr
gr
rU
rU
rU
rU
rU
TM
TM
TM
TM
TM
TM
TM
TM
TM
TM
qo
ot
ot
ot
ot
iX
Ks
iX
ot
ot
ot
ot
qo
TM
TM
AM
AM
AM
AM
AM
AM
AM
AM
AM
AM
TM
TM
TM
TM
TM
TM
TM
rU
rU
rU
gr
gr
"}
(11,1,1) = {"
gr
gr
rU
rU
rU
rU
rU
TM
TM
TM
TM
TM
TM
TM
TM
TM
TM
TM
qo
qo
qo
qo
qo
Ks
iX
Ks
qo
qo
qo
qo
qo
TM
TM
TM
AM
AM
AM
AM
AM
AM
AM
AM
AM
AM
TM
TM
TM
TM
TM
TM
rU
rU
rU
gr
gr
"}
(12,1,1) = {"
gr
gr
rU
rU
rU
rU
TM
TM
TM
TM
TM
TM
TM
TM
TM
TM
TM
TM
qo
ot
ot
ot
qo
iX
Ks
iX
qo
ot
ot
ot
qo
TM
TM
TM
TM
AM
AM
AM
AM
AM
TM
AM
AM
AM
AM
TM
TM
TM
TM
TM
TM
rU
rU
gr
gr
"}
(13,1,1) = {"
gr
gr
rU
rU
rU
TM
TM
TM
TM
TM
TM
TM
TM
TM
TM
TM
TM
TM
qo
ot
ot
ot
ot
Ks
iX
Ks
ot
ot
ot
ot
qo
TM
TM
TM
TM
TM
TM
AM
AM
TM
TM
TM
AM
AM
AM
AM
TM
TM
TM
TM
TM
TM
rU
gr
gr
"}
(14,1,1) = {"
gr
rU
rU
rU
TM
TM
TM
TM
XX
VR
sV
mp
GE
aY
eh
TM
TM
TM
qo
qo
qo
qo
qo
iX
Ks
iX
qo
qo
qo
qo
qo
TM
TM
TM
TM
TM
TM
TM
TM
TM
TM
TM
TM
TM
AM
AM
AM
TM
TM
TM
TM
TM
TM
gr
gr
"}
(15,1,1) = {"
gr
rU
rU
TM
TM
TM
TM
TM
Ek
kE
oW
fB
xR
Qx
Lq
TM
TM
TM
qo
ot
ot
ot
qo
Ks
iX
Ks
qo
ot
ot
ot
qo
TM
TM
qo
qo
qo
qo
qo
qo
qo
qo
qo
TM
TM
TM
AM
AM
AM
TM
TM
TM
TM
TM
gr
gr
"}
(16,1,1) = {"
gr
rU
rU
TM
TM
TM
TM
TM
TM
TM
TM
TM
TM
We
jJ
We
TM
TM
qo
ot
ot
ot
ot
iX
Ks
iX
ot
ot
ot
ot
qo
TM
TM
qo
ZV
fQ
fQ
fQ
fQ
ZV
fQ
qo
TM
TM
AM
AM
AM
AM
TM
TM
TM
TM
TM
TM
gr
"}
(17,1,1) = {"
gr
gr
rU
TM
TM
TM
TM
TM
TM
TM
ef
TM
TM
We
RF
We
TM
TM
qo
qo
qo
qo
qo
Ks
iX
Ks
qo
qo
qo
qo
qo
TM
TM
qo
fQ
ZV
ZV
ZV
ZV
fQ
fQ
TM
AM
AM
AM
AM
AM
AM
AM
AM
TM
TM
TM
TM
gr
"}
(18,1,1) = {"
gr
gr
TM
TM
TM
TM
TM
TM
TM
TM
TM
TM
TM
We
rF
We
TM
TM
qo
ot
ot
ot
qo
iX
Ks
iX
qo
ot
ot
ot
qo
TM
TM
qo
fQ
ZV
fQ
zC
Ij
ZV
ZV
TM
AM
AM
AM
AM
AM
AM
AM
AM
AM
TM
TM
TM
gr
"}
(19,1,1) = {"
gr
gr
TM
TM
TM
qo
qo
qo
qo
qo
qo
TM
TM
We
qE
We
TM
TM
qo
ot
ot
ot
ot
Ks
iX
Ks
ot
ot
ot
ot
qo
TM
TM
qo
fQ
ZV
Ij
XL
zC
ZV
fQ
TM
TM
TM
TM
TM
TM
AM
AM
AM
AM
TM
TM
TM
gr
"}
(20,1,1) = {"
gr
gr
TM
TM
TM
qo
Ij
kJ
mN
Ij
qo
TM
TM
We
sH
We
TM
TM
qo
qo
qo
qo
qo
qo
iX
qo
qo
qo
qo
qo
qo
TM
TM
qo
fQ
fQ
zC
Ij
Ij
fQ
fQ
qo
We
We
We
We
TM
TM
TM
AM
AM
TM
TM
TM
gr
"}
(21,1,1) = {"
gr
gr
TM
TM
TM
qo
Ij
iX
Ks
Ij
qo
TM
TM
rE
We
We
TM
TM
TM
qo
qo
zY
zY
zY
AN
zY
zY
zY
qo
qo
TM
TM
TM
qo
fQ
ZV
ZV
fQ
ZV
ZV
fQ
qo
We
We
We
We
We
We
TM
AM
AM
TM
TM
TM
TM
"}
(22,1,1) = {"
gr
gr
TM
TM
TM
qo
Ij
Ks
iX
zC
qo
TM
TM
we
We
IE
TM
TM
TM
qo
zY
zY
AN
AN
AN
AN
AN
zY
zY
qo
TM
TM
TM
qo
ZV
fQ
fQ
fQ
fQ
fQ
ZV
qo
We
We
We
ef
We
Ee
Ee
Ee
AM
AM
TM
TM
TM
"}
(23,1,1) = {"
gr
gr
TM
TM
TM
qo
Ks
iX
Ks
iX
qo
TM
TM
TM
TM
TM
TM
TM
TM
qo
zY
AN
AN
AN
AN
AN
AN
AN
zY
qo
qo
qo
qo
qo
qo
qo
qo
AN
qo
qo
qo
qo
TM
TM
TM
Ee
Ee
Ee
qo
qo
qo
qo
qo
Ee
Ee
"}
(24,1,1) = {"
gr
gr
TM
TM
TM
qo
qo
ot
ot
qo
qo
qo
qo
qo
qo
qo
qo
qo
qo
qo
zY
AN
zY
od
od
od
zY
AN
zY
qo
od
qo
Fg
qo
od
qo
zY
AN
zY
qo
od
qo
Fg
TM
TM
qo
qo
qo
qo
od
od
od
qo
qo
Ee
"}
(25,1,1) = {"
gr
gr
TM
TM
TM
qo
AN
ot
ot
AN
qo
Hh
Zc
Hh
Zc
jo
Zc
Hh
qo
zY
zY
AN
od
Fg
zY
Fg
od
AN
zY
qo
AN
AN
AN
AN
AN
AN
AN
AN
AN
AN
AN
AN
AN
TM
TM
qo
od
od
od
Fg
zY
Fg
od
qo
Ee
"}
(26,1,1) = {"
gr
gr
TM
TM
TM
ot
ot
ot
ot
ot
Fg
AN
Br
AN
Br
AN
cz
AN
Fg
AN
AN
AN
od
zY
Fg
zY
od
AN
AN
AN
AN
AN
AN
AN
AN
AN
AN
AN
AN
AN
AN
AN
AN
AN
TM
AN
zY
zY
zY
zY
Fg
zY
od
qo
Ee
"}
(27,1,1) = {"
gr
gr
TM
TM
TM
ot
ot
ot
ot
ot
AN
Fg
Zc
Fg
Zc
Fg
Zc
IE
AN
AN
AN
AN
od
zY
Fg
zY
od
AN
AN
AN
AN
AN
AN
AN
AN
AN
AN
AN
AN
AN
AN
AN
AN
AN
TM
AN
zY
zY
zY
zY
Fg
zY
od
qo
Ee
"}
(28,1,1) = {"
gr
gr
TM
TM
TM
qo
AN
ot
ot
AN
qo
AN
Zu
AN
Zu
xl
Zf
AN
qo
zY
zY
AN
od
Fg
zY
Fg
od
AN
zY
qo
AN
AN
AN
AN
AN
AN
AN
AN
AN
AN
AN
AN
AN
AN
TM
qo
od
od
od
Fg
zY
Fg
od
qo
Ee
"}
(29,1,1) = {"
gr
gr
TM
TM
TM
qo
qo
ot
ot
qo
qo
qo
qo
qo
qo
qo
qo
qo
qo
qo
zY
AN
zY
od
od
od
zY
AN
zY
qo
od
qo
Fg
qo
od
qo
zY
AN
zY
qo
od
qo
Fg
TM
TM
qo
qo
qo
qo
od
od
od
qo
qo
Ee
"}
(30,1,1) = {"
gr
gr
TM
TM
TM
qo
Ks
iX
Ks
iX
qo
TM
TM
TM
TM
TM
TM
TM
TM
qo
zY
AN
AN
AN
AN
AN
AN
AN
zY
qo
qo
qo
qo
qo
qo
qo
qo
AN
qo
qo
qo
qo
TM
TM
TM
Ee
Ee
Ee
qo
qo
qo
qo
qo
Ee
Ee
"}
(31,1,1) = {"
gr
gr
TM
TM
TM
qo
zC
Ks
iX
Ij
qo
TM
TM
TM
nD
TM
TM
TM
TM
qo
zY
zY
AN
AN
AN
AN
AN
zY
zY
qo
TM
TM
TM
TM
qo
Sz
iX
od
iX
Sz
qo
TM
TM
TM
TM
TM
TM
Ee
Ee
Ee
Ee
Ee
Ee
Ee
rU
"}
(32,1,1) = {"
gr
gr
TM
TM
TM
qo
zC
iX
Ks
Ij
qo
TM
TM
TM
TM
TM
TM
TM
TM
qo
qo
zY
zY
zY
AN
zY
zY
zY
qo
qo
TM
TM
TM
TM
qo
JP
od
zY
od
JP
qo
TM
TM
TM
TM
TM
qo
qo
qo
qo
qo
TM
TM
TM
rU
"}
(33,1,1) = {"
gr
gr
TM
TM
TM
qo
Ij
kJ
mN
Ij
qo
TM
TM
TM
TM
TM
qo
qo
qo
qo
qo
qo
qo
qo
Ks
qo
qo
qo
qo
qo
qo
qo
qo
qo
qo
Sz
iX
od
iX
gC
qo
TM
TM
TM
TM
TM
qo
kr
kr
BF
qo
TM
TM
rU
rU
"}
(34,1,1) = {"
gr
gr
rU
TM
TM
qo
qo
qo
qo
qo
qo
TM
TM
TM
TM
TM
qo
zk
ot
zk
ot
zk
qo
zY
iX
zY
qo
kr
kr
kr
kr
kr
kr
qo
qo
qo
qo
ot
qo
qo
qo
qo
qo
qo
qo
qo
qo
tY
ot
kT
qo
TM
rU
rU
rU
"}
(35,1,1) = {"
gr
gr
rU
TM
TM
TM
TM
TM
TM
TM
TM
TM
TM
TM
TM
TM
qo
ot
ot
ot
ot
ot
ot
iX
Ks
iX
ot
ot
ot
ot
ot
ot
ot
qo
zY
Fg
zY
ot
Fg
zY
Fg
zY
Fg
zY
Fg
qo
qo
zk
hQ
Vb
qo
TM
rU
rU
gr
"}
(36,1,1) = {"
gr
gr
rU
TM
TM
TM
TM
TM
TM
TM
TM
TM
TM
TM
TM
TM
qo
zk
ot
ot
ot
zk
qo
Ks
iX
Ks
qo
kr
ot
Lh
zk
ot
kr
qo
Fg
nX
Lh
ot
nX
Lh
nX
zk
ot
ot
zY
qo
qo
nX
nX
ot
qo
TM
TM
rU
gr
"}
(37,1,1) = {"
gr
rU
rU
TM
TM
TM
TM
TM
TM
TM
TM
TM
TM
TM
TM
TM
qo
ot
ot
zk
ot
ot
qo
iX
Ks
iX
qo
kr
ot
nX
nX
ot
kr
qo
zY
nX
zk
ot
nX
zk
nX
Lh
ot
AN
AN
AN
La
ot
ot
Pe
qo
TM
TM
rU
gr
"}
(38,1,1) = {"
gr
rU
rU
rU
TM
TM
TM
TM
TM
TM
TM
TM
TM
TM
TM
TM
qo
zk
ot
ot
ot
zk
qo
Ks
iX
Ks
qo
kr
ot
ot
ot
ot
kr
qo
zY
ot
ot
ot
ot
ot
ot
ot
ot
He
AN
AN
qo
qo
qo
qo
qo
TM
TM
rU
gr
"}
(39,1,1) = {"
gr
rU
rU
rU
rU
rU
TM
TM
TM
TM
TM
TM
TM
TM
TM
TM
qo
ot
ot
zk
ot
ot
qo
iX
Ks
iX
qo
kr
ot
nX
nX
ot
kr
qo
zY
ot
ot
ot
ot
ot
ot
ot
ot
Nt
AN
AN
qo
TM
TM
TM
TM
TM
rU
rU
gr
"}
(40,1,1) = {"
gr
rU
rU
rU
rU
rU
rU
rU
TM
TM
TM
TM
TM
TM
TM
TM
qo
zk
ot
ot
ot
zk
qo
Ks
iX
Ks
qo
kr
ot
zk
hQ
ot
kr
qo
zY
nX
zk
ot
nX
zk
nX
zk
ot
AN
AN
AN
qo
TM
TM
TM
TM
rU
rU
rU
gr
"}
(41,1,1) = {"
gr
gr
rU
rU
rU
rU
rU
rU
rU
TM
TM
TM
TM
TM
TM
TM
qo
ot
ot
ot
ot
ot
ot
iX
Ks
iX
ot
ot
ot
ot
ot
ot
ot
qo
Fg
nX
hQ
ot
nX
zk
nX
Lh
ot
ot
zY
qo
qo
TM
TM
TM
TM
rU
rU
rU
gr
"}
(42,1,1) = {"
gr
gr
rU
rU
rU
rU
rU
rU
rU
rU
rU
TM
TM
TM
TM
TM
qo
zk
ot
zk
ot
zk
qo
Ks
iX
Ks
qo
kr
kr
kr
kr
kr
kr
qo
zY
Fg
zY
zY
Fg
zY
Fg
zY
Fg
zY
Fg
qo
TM
TM
TM
TM
rU
rU
rU
gr
gr
"}
(43,1,1) = {"
gr
gr
gr
gr
gr
rU
rU
rU
rU
rU
rU
rU
TM
TM
TM
TM
qo
qo
qo
qo
qo
qo
qo
md
te
md
qo
qo
qo
qo
qo
qo
qo
qo
qo
qo
qo
qo
qo
qo
qo
qo
qo
qo
qo
qo
TM
TM
TM
rU
rU
rU
rU
gr
gr
"}
(44,1,1) = {"
gr
gr
gr
gr
gr
gr
rU
rU
rU
rU
rU
rU
rU
rU
TM
TM
TM
TM
TM
TM
TM
TM
qo
qo
qo
qo
qo
TM
TM
TM
TM
TM
TM
TM
TM
TM
TM
TM
TM
TM
TM
TM
TM
TM
TM
TM
TM
rU
rU
rU
rU
rU
rU
gr
gr
"}
(45,1,1) = {"
gr
gr
gr
gr
gr
gr
gr
rU
rU
rU
rU
rU
rU
rU
rU
rU
rU
rU
rU
rU
TM
TM
TM
TM
TM
TM
TM
TM
TM
TM
TM
TM
TM
TM
TM
TM
TM
TM
TM
TM
TM
TM
rU
rU
rU
rU
rU
rU
rU
rU
rU
rU
gr
gr
gr
"}
(46,1,1) = {"
gr
gr
gr
gr
gr
gr
gr
gr
rU
rU
rU
rU
rU
rU
rU
rU
rU
rU
rU
rU
rU
rU
TM
TM
TM
TM
TM
TM
TM
TM
TM
TM
TM
TM
TM
TM
TM
TM
TM
TM
rU
rU
rU
rU
rU
rU
rU
rU
rU
rU
rU
gr
gr
gr
gr
"}
(47,1,1) = {"
gr
gr
gr
gr
gr
gr
gr
gr
gr
gr
gr
gr
rU
rU
rU
rU
rU
rU
rU
rU
rU
gr
gr
gr
gr
TM
TM
TM
TM
TM
TM
TM
TM
rU
rU
TM
TM
TM
rU
rU
rU
rU
rU
rU
rU
rU
rU
rU
rU
rU
rU
gr
gr
gr
gr
"}
(48,1,1) = {"
gr
gr
gr
gr
gr
gr
gr
gr
gr
gr
gr
gr
gr
gr
gr
rU
rU
rU
gr
gr
gr
gr
gr
gr
gr
gr
gr
gr
TM
TM
TM
TM
rU
rU
rU
rU
rU
rU
rU
rU
gr
gr
gr
gr
gr
rU
rU
gr
gr
rU
gr
gr
gr
gr
gr
"}
(49,1,1) = {"
gr
gr
gr
gr
gr
gr
gr
gr
gr
gr
gr
gr
gr
gr
gr
gr
gr
gr
gr
gr
gr
gr
gr
gr
gr
gr
gr
gr
gr
gr
gr
gr
gr
gr
gr
gr
gr
gr
gr
gr
gr
gr
gr
gr
gr
gr
gr
gr
gr
gr
gr
gr
gr
gr
gr
"}
