//MAP CONVERTED BY dmm2tgm.py THIS HEADER COMMENT PREVENTS RECONVERSION, DO NOT REMOVE
"av" = (
/obj/structure/bed{
	material = "wood"
	},
/obj/item/bedsheet/purple,
/turf/simulated/floor/wood/classp,
/area/space)
"aY" = (
/mob/living/simple_mob/living_statue{
	name = "eroded male statue"
	},
/turf/simulated/floor/crystal/classp,
/area/space)
"bv" = (
/obj/structure/bed{
	material = "wood"
	},
/turf/simulated/floor/wood/classp,
/area/space)
"bJ" = (
/obj/effect/trap/pop_up/buzzsaw{
	id = "vault"
	},
/turf/simulated/floor/gold/classp,
/area/space)
"ct" = (
/obj/effect/decal/cleanable/dirt,
/turf/simulated/floor/trap/delayed/bmarble/classp{
	id = "east_hall_2"
	},
/area/space)
"cz" = (
/obj/effect/trap/pop_up/flame{
	id = "entry_corridor"
	},
/turf/simulated/floor/trap/phoron/classp{
	id = "entry_corridor"
	},
/area/space)
"dv" = (
/turf/simulated/floor/trap/delayed/wmarble/classp{
	id = "east_hall_1"
	},
/area/space)
"dN" = (
/obj/effect/trap/pop_up/flame{
	id = "entry_corridor"
	},
/obj/effect/decal/cleanable/dirt,
/turf/simulated/floor/crystal/classp,
/area/space)
"ef" = (
/obj/structure/simple_door/hardwood,
/turf/simulated/floor/wood/classp,
/area/space)
"eh" = (
/obj/structure/bookcase,
/obj/item/spellbook/oneuse/charge,
/turf/simulated/floor/wood/classp,
/area/space)
"et" = (
/obj/structure/prop/prism/externalcont,
/turf/simulated/floor/classp,
/area/space)
"eJ" = (
/obj/structure/table/marble,
/obj/item/flame/candle/black,
/turf/simulated/floor/classp,
/area/space)
"fB" = (
/mob/living/simple_mob/living_statue{
	name = "eroded male statue"
	},
/turf/simulated/floor/silver/classp,
/area/space)
"fQ" = (
/turf/simulated/floor/outdoors/mud/classp,
/area/space)
"fS" = (
/obj/structure/window/reinforced/polarized/full{
	color = "#222222";
	name = "reflective window";
	opacity = 1
	},
/obj/structure/grille/cult,
/turf/simulated/floor/classp,
/area/space)
"gr" = (
/turf/template_noop,
/area/space)
"gC" = (
/obj/structure/table/hardwoodtable,
/obj/item/flame/candle/everburn/black,
/turf/simulated/floor/bmarble/classp,
/area/space)
"gS" = (
/obj/structure/boulder,
/turf/simulated/floor/outdoors/grass/heavy/interior/classp,
/area/space)
"hQ" = (
/obj/structure/table/hardwoodtable,
/obj/item/flame/candle/everburn/black,
/turf/simulated/floor/wood/classp,
/area/space)
"if" = (
/obj/structure/prop/lock/projectile{
	lockID = "anak"
	},
/obj/effect/floor_decal/rust,
/turf/simulated/floor/classp,
/area/space)
"ik" = (
/obj/structure/statue/marble/male{
	name = "eroded male statue"
	},
/turf/simulated/floor/silver/classp,
/area/space)
"iX" = (
/turf/simulated/floor/wmarble/classp,
/area/space)
"jo" = (
/obj/effect/trap/launcher/fireball{
	dir = 4;
	id = "entry_corridor";
	pixel_x = -32
	},
/turf/simulated/floor/trap/delayed/phoron/classp{
	id = "entry_corridor"
	},
/area/space)
"jJ" = (
/obj/effect/trap/pop_up/thrower,
/turf/simulated/mineral/cave,
/area/space)
"jS" = (
/obj/structure/table/hardwoodtable,
/obj/effect/decal/cleanable/dirt,
/turf/simulated/floor/wood/classp,
/area/space)
"kr" = (
/obj/structure/bookcase,
/turf/simulated/floor/wood/classp,
/area/space)
"kE" = (
/obj/effect/trap/launcher/fireball_aoe{
	dir = 1;
	id = "vault";
	pixel_y = -32
	},
/obj/structure/table/marble,
/turf/simulated/floor/silver/classp,
/area/space)
"kJ" = (
/obj/structure/table/marble,
/turf/simulated/floor/bmarble/classp,
/area/space)
"kT" = (
/obj/effect/trap/pit/tentacle{
	id = "headmaster_desk"
	},
/turf/simulated/floor/wood/classp,
/area/space)
"lc" = (
/obj/structure/window/reinforced/polarized/full{
	color = "#222222";
	name = "reflective window";
	opacity = 1
	},
/obj/structure/grille/cult,
/turf/simulated/floor/trap/delayed/plating/classp{
	id = "tunnel_south"
	},
/area/space)
"lf" = (
/obj/effect/trap/pit/deep{
	id = "tunnel_north"
	},
/turf/simulated/floor/classp,
/area/space)
"lh" = (
/obj/structure/statue/marble/female{
	name = "eroded female statue"
	},
/turf/simulated/floor/gold/classp,
/area/space)
"md" = (
/obj/structure/table/hardwoodtable,
/obj/item/flame/candle/candelabra/everburn,
/turf/simulated/floor/gold/classp,
/area/space)
"mr" = (
/obj/effect/trap/pop_up/spear{
	id = "west_hall_3"
	},
/obj/effect/decal/cleanable/dirt,
/turf/simulated/floor/wmarble/classp,
/area/space)
"mx" = (
/obj/structure/simple_door/phoron,
/turf/simulated/floor/wmarble/classp,
/area/space)
"my" = (
/obj/structure/grille/cult,
/obj/structure/window/reinforced/polarized/full{
	color = "#222222";
	name = "reflective window";
	opacity = 1
	},
/turf/simulated/floor/trap/delayed/plating/classp{
	id = "tunnel_class_south"
	},
/area/space)
"mN" = (
/obj/structure/table/marble,
/turf/simulated/floor/wmarble/classp,
/area/space)
"nd" = (
/obj/structure/window/reinforced/polarized/full{
	color = "#222222";
	name = "reflective window";
	opacity = 1
	},
/obj/structure/grille/cult,
/turf/simulated/floor/trap/delayed/plating/classp{
	id = "tunnel_west"
	},
/area/space)
"nD" = (
/obj/structure/simple_door/phoron,
/turf/simulated/floor/phoron/classp,
/area/space)
"nX" = (
/obj/structure/table/bench/wooden,
/turf/simulated/floor/wood/classp,
/area/space)
"od" = (
/turf/simulated/floor/silver/classp,
/area/space)
"oq" = (
/obj/structure/statue/marble/male{
	density = 0;
	name = "shimmering male statue"
	},
/turf/simulated/floor/phoron/classp,
/area/space)
"ot" = (
/turf/simulated/floor/wood/classp,
/area/space)
"oZ" = (
/obj/effect/trap/pit/punji{
	id = "west_hall_2"
	},
/obj/effect/decal/cleanable/dirt,
/turf/simulated/floor/wmarble/classp,
/area/space)
"qo" = (
/turf/simulated/wall/ironphoron/classp,
/area/space)
"rq" = (
/obj/effect/decal/cleanable/dirt,
/turf/simulated/floor/trap/delayed/wood/classp{
	id = "library"
	},
/area/space)
"rt" = (
/obj/structure/table/hardwoodtable,
/obj/effect/decal/cleanable/dirt,
/obj/machinery/artifact,
/obj/structure/window/phoronbasic{
	dir = 4
	},
/obj/structure/window/phoronbasic{
	dir = 8
	},
/obj/structure/window/phoronbasic,
/obj/structure/window/phoronbasic{
	dir = 1
	},
/turf/simulated/floor/phoron/classp,
/area/space)
"ru" = (
/obj/structure/bed{
	material = "wood"
	},
/obj/item/bedsheet,
/turf/simulated/floor/wood/classp,
/area/space)
"rE" = (
/obj/structure/simple_door/phoron,
/turf/simulated/floor/crystal/classp,
/area/space)
"rO" = (
/obj/structure/boulder,
/turf/simulated/floor/outdoors/mud/classp,
/area/space)
"rU" = (
/turf/simulated/floor/outdoors/snow/classp,
/area/space)
"se" = (
/turf/simulated/floor/classp,
/area/space)
"sj" = (
/obj/structure/prop/prism/externalcont{
	dialID = "bchar"
	},
/turf/simulated/floor/classp,
/area/space)
"sW" = (
/obj/structure/prop/prismcontrol{
	dialID = "anak";
	name = "Sundial of Anak-Hun-Tamuun"
	},
/obj/structure/table/marble,
/turf/simulated/floor/outdoors/mud/classp,
/area/space)
"tc" = (
/obj/machinery/door/blast/puzzle{
	icon = 'icons/obj/doors/material_doors.dmi';
	icon_state = "metal";
	lockID = "bchar";
	name = "enchanted door"
	},
/turf/simulated/floor/crystal/classp,
/area/space)
"te" = (
/obj/structure/table/hardwoodtable,
/turf/simulated/floor/gold/classp,
/area/space)
"tt" = (
/obj/structure/simple_door/phoron,
/turf/simulated/floor/bmarble/classp,
/area/space)
"tY" = (
/obj/structure/bed/chair/wood/wings{
	dir = 4
	},
/turf/simulated/floor/wood/classp,
/area/space)
"uh" = (
/obj/structure/statue/marble/female{
	name = "eroded female statue"
	},
/turf/simulated/floor/phoron/classp,
/area/space)
"uk" = (
/obj/structure/statue/marble/female{
	name = "eroded female statue"
	},
/turf/simulated/floor/silver/classp,
/area/space)
"we" = (
/obj/structure/table/marble,
/obj/item/flame/candle/everburn/black,
/turf/simulated/floor/classp,
/area/space)
"xl" = (
/turf/simulated/floor/trap/delayed/crystal/classp{
	id = "entry_corridor"
	},
/area/space)
"xO" = (
/obj/structure/simple_door/gold,
/turf/simulated/floor/wood/classp,
/area/space)
"xQ" = (
/obj/effect/trap/pit/deep{
	id = "tunnel_class_south"
	},
/turf/simulated/floor/classp,
/area/space)
"yw" = (
/obj/structure/statue/marble/male{
	name = "eroded male statue"
	},
/turf/simulated/floor/gold/classp,
/area/space)
"zk" = (
/obj/structure/table/hardwoodtable,
/turf/simulated/floor/wood/classp,
/area/space)
"zz" = (
/obj/effect/trap/pop_up/spear{
	id = "west_hall_3"
	},
/turf/simulated/floor/wmarble/classp,
/area/space)
"zC" = (
/turf/simulated/floor/water/indoors/classp,
/area/space)
"zY" = (
/turf/simulated/floor/gold/classp,
/area/space)
"Ak" = (
/obj/structure/table/bench/wooden,
/obj/effect/decal/cleanable/dirt,
/turf/simulated/floor/wood/classp,
/area/space)
"Ar" = (
/obj/effect/trap/launcher/dart{
	dir = 1;
	id = "east_hall_2";
	pixel_y = -32
	},
/turf/simulated/floor/wmarble/classp,
/area/space)
"At" = (
/obj/effect/decal/cleanable/blood/writing{
	desc = "It looks like blood."
	},
/turf/simulated/floor/wood/classp,
/area/space)
"AM" = (
/obj/structure/statue/marble/male{
	name = "eroded male statue"
	},
/turf/simulated/floor/crystal/classp,
/area/space)
"AN" = (
/turf/simulated/floor/crystal/classp,
/area/space)
"Bk" = (
/obj/structure/boulder,
/turf/simulated/floor/wmarble/classp,
/area/space)
"Br" = (
/obj/effect/trap/pop_up/flame{
	id = "entry_corridor"
	},
/turf/simulated/floor/phoron/classp,
/area/space)
"Bw" = (
/turf/simulated/bone,
/area/space)
"BF" = (
/obj/structure/closet/cabinet,
/turf/simulated/floor/wood/classp,
/area/space)
"BP" = (
/obj/structure/boulder,
/turf/simulated/floor/bmarble/classp,
/area/space)
"BS" = (
/obj/effect/trap/pit/deep{
	id = "tunnel_class_north"
	},
/turf/simulated/floor/classp,
/area/space)
"Ci" = (
/obj/structure/table/hardwoodtable,
/obj/machinery/artifact,
/obj/structure/window/phoronbasic{
	dir = 4
	},
/obj/structure/window/phoronbasic{
	dir = 8
	},
/obj/structure/window/phoronbasic,
/obj/structure/window/phoronbasic{
	dir = 1
	},
/turf/simulated/floor/gold/classp,
/area/space)
"Dl" = (
/obj/effect/decal/cleanable/dirt,
/turf/simulated/floor/crystal/classp,
/area/space)
"Dy" = (
/obj/machinery/door/blast/puzzle{
	icon = 'icons/obj/doors/material_doors.dmi';
	icon_state = "metal";
	lockID = "dmirr";
	name = "enchanted door"
	},
/turf/simulated/floor/gold/classp,
/area/space)
"DA" = (
/obj/effect/decal/cleanable/dirt,
/turf/simulated/floor/wmarble/classp,
/area/space)
"DI" = (
/obj/effect/trap/pop_up/spear{
	id = "west_hall_1"
	},
/turf/simulated/floor/wmarble/classp,
/area/space)
"Ee" = (
/obj/structure/statue/marble/female{
	name = "eroded female statue"
	},
/turf/simulated/floor/crystal/classp,
/area/space)
"EY" = (
/obj/structure/simple_door/hardwood,
/turf/simulated/floor/trap/wood/classp{
	id = "west_hall_3"
	},
/area/space)
"EZ" = (
/obj/structure/table/hardwoodtable,
/obj/structure/window/phoronbasic{
	dir = 8
	},
/obj/structure/window/phoronbasic,
/obj/structure/window/phoronbasic{
	dir = 1
	},
/obj/item/material/shard/phoron,
/turf/simulated/floor/gold/classp,
/area/space)
"Fg" = (
/turf/simulated/floor/phoron/classp,
/area/space)
"Fp" = (
/obj/structure/bed/chair/wood/wings{
	dir = 8
	},
/obj/effect/decal/cleanable/dirt,
/turf/simulated/floor/wood/classp,
/area/space)
"Fu" = (
/obj/structure/bed/chair/wood/wings{
	dir = 8
	},
/turf/simulated/floor/wood/classp,
/area/space)
"Fw" = (
/turf/simulated/floor/trap/delayed/wood/classp{
	id = "library"
	},
/area/space)
"FF" = (
/obj/effect/trap/pit/deep{
	id = "tunnel_east"
	},
/turf/simulated/floor/classp,
/area/space)
"FY" = (
/obj/structure/bed/chair/wood/wings,
/turf/simulated/floor/wood/classp,
/area/space)
"GF" = (
/obj/effect/decal/cleanable/dirt,
/turf/simulated/floor/gold/classp,
/area/space)
"GP" = (
/obj/effect/trap/pit/punji{
	id = "library"
	},
/turf/simulated/floor/wood/classp,
/area/space)
"He" = (
/obj/structure/table/hardwoodtable,
/obj/item/flame/candle/everburn/black,
/turf/simulated/floor/crystal/classp,
/area/space)
"Hh" = (
/obj/effect/trap/launcher/fireball{
	dir = 4;
	id = "entry_corridor";
	pixel_x = -32
	},
/turf/simulated/floor/phoron/classp,
/area/space)
"Hw" = (
/turf/simulated/floor/trap/wmarble/classp{
	id = "east_hall_1"
	},
/area/space)
"HB" = (
/obj/structure/table/hardwoodtable,
/obj/structure/window/phoronbasic{
	dir = 4
	},
/obj/structure/window/phoronbasic{
	dir = 8
	},
/obj/structure/window/phoronbasic,
/obj/item/material/shard/phoron,
/turf/simulated/floor/phoron/classp,
/area/space)
"HM" = (
/obj/effect/trap/pop_up/pillar,
/obj/effect/decal/cleanable/dirt,
/turf/simulated/floor/crystal/classp,
/area/space)
"Ia" = (
/obj/structure/boulder,
/turf/simulated/floor/crystal/classp,
/area/space)
"Ij" = (
/turf/simulated/floor/outdoors/ice/classp,
/area/space)
"IE" = (
/turf/simulated/floor/trap/phoron/classp{
	id = "entry_corridor"
	},
/area/space)
"Jv" = (
/turf/simulated/floor/trap/gold/classp{
	id = "vault"
	},
/area/space)
"Jw" = (
/obj/structure/bed/chair/wood/wings{
	dir = 1
	},
/turf/simulated/floor/wood/classp,
/area/space)
"JL" = (
/turf/simulated/floor/trap/phoron/classp{
	id = "master_trigger"
	},
/area/space)
"JP" = (
/obj/structure/table/hardwoodtable,
/turf/simulated/floor/wmarble/classp,
/area/space)
"JT" = (
/turf/simulated/floor/trap/delayed/gold/classp{
	id = "master_trigger"
	},
/area/space)
"JU" = (
/obj/structure/table/marble,
/obj/item/flame/candle/candelabra/everburn,
/turf/simulated/floor/outdoors/mud/classp,
/area/space)
"Kf" = (
/obj/effect/trap/pop_up/spear{
	id = "west_hall_3"
	},
/obj/effect/decal/cleanable/dirt,
/turf/simulated/floor/bmarble/classp,
/area/space)
"Kl" = (
/mob/living/simple_mob/living_statue{
	name = "eroded male statue"
	},
/turf/simulated/floor/phoron/classp,
/area/space)
"Ks" = (
/turf/simulated/floor/bmarble/classp,
/area/space)
"Ku" = (
/obj/structure/simple_door/gold,
/turf/simulated/floor/crystal/classp,
/area/space)
"Kv" = (
/obj/effect/decal/cleanable/dirt,
/turf/simulated/floor/bmarble/classp,
/area/space)
"KP" = (
/obj/effect/trap/launcher/dart{
	id = "east_hall_1";
	pixel_y = 32
	},
/turf/simulated/floor/bmarble/classp,
/area/space)
"La" = (
/obj/structure/simple_door/hardwood,
/turf/simulated/floor/trap/wood/classp{
	id = "headmaster_office"
	},
/area/space)
"Lh" = (
/obj/structure/table/hardwoodtable,
/obj/item/flame/candle/black,
/turf/simulated/floor/wood/classp,
/area/space)
"LP" = (
/obj/structure/prop/prism/incremental{
	degrees_from_north = 180
	},
/turf/simulated/floor/classp,
/area/space)
"Mq" = (
/turf/simulated/wall/dungeon,
/area/space)
"Mx" = (
/obj/structure/grille/cult,
/obj/structure/window/reinforced/polarized/full{
	color = "#222222";
	name = "reflective window";
	opacity = 1
	},
/turf/simulated/floor/trap/delayed/plating/classp{
	id = "tunnel_class_north"
	},
/area/space)
"Nk" = (
/obj/machinery/door/blast/puzzle{
	icon = 'icons/turf/wall_masks.dmi';
	icon_state = "bone";
	lockID = "anak";
	name = "old bone wall"
	},
/turf/simulated/floor/classp,
/area/space)
"Nt" = (
/obj/structure/table/hardwoodtable,
/turf/simulated/floor/crystal/classp,
/area/space)
"NS" = (
/turf/simulated/floor/trap/delayed/wmarble/classp{
	id = "west_hall_1"
	},
/area/space)
"Ol" = (
/obj/effect/decal/cleanable/generic,
/turf/simulated/floor/wood/classp,
/area/space)
"Oo" = (
/obj/effect/decal/cleanable/dirt,
/turf/simulated/floor/phoron/classp,
/area/space)
"OI" = (
/obj/structure/prop/prism/externalcont{
	degrees_from_north = 180;
	dialID = "anak"
	},
/turf/simulated/floor/classp,
/area/space)
"OJ" = (
/obj/structure/boulder,
/obj/effect/floor_decal/rust,
/turf/simulated/floor/classp,
/area/space)
"Pe" = (
/obj/effect/trap/launcher/fireball_aoe{
	dir = 1;
	id = "headmaster_office";
	pixel_y = -32
	},
/turf/simulated/floor/wood/classp,
/area/space)
"Py" = (
/obj/effect/decal/cleanable/dirt,
/turf/simulated/floor/silver/classp,
/area/space)
"PM" = (
/obj/effect/decal/cleanable/dirt,
/turf/simulated/floor/wood/classp,
/area/space)
"PU" = (
/obj/effect/trap/pit/deep{
	id = "tunnel_west"
	},
/turf/simulated/floor/classp,
/area/space)
"QV" = (
/obj/structure/bed{
	material = "wood"
	},
/obj/effect/decal/cleanable/dirt,
/obj/item/bedsheet/purple,
/turf/simulated/floor/wood/classp,
/area/space)
"Rv" = (
/obj/structure/table/marble,
/obj/structure/prop/prismcontrol{
	dialID = "bchar";
	name = "The Blind Wheel of B'chardamz"
	},
/turf/simulated/floor/classp,
/area/space)
"Sc" = (
/turf/simulated/floor/trap/delayed/crystal/classp{
	id = "display_room"
	},
/area/space)
"Sz" = (
/obj/structure/table/hardwoodtable,
/obj/item/flame/candle/black,
/turf/simulated/floor/bmarble/classp,
/area/space)
"Tw" = (
/obj/structure/statue/marble/female{
	density = 0;
	name = "shimmering female statue"
	},
/turf/simulated/floor/phoron/classp,
/area/space)
"TM" = (
/turf/simulated/mineral/cave,
/area/space)
"Ua" = (
/obj/effect/trap/pop_up/flame{
	id = "entry_corridor"
	},
/obj/effect/decal/cleanable/dirt,
/turf/simulated/floor/phoron/classp,
/area/space)
"Ug" = (
/obj/structure/window/reinforced/polarized/full{
	color = "#222222";
	name = "reflective window";
	opacity = 1
	},
/obj/structure/grille/cult,
/turf/simulated/floor/trap/delayed/plating/classp{
	id = "tunnel_east"
	},
/area/space)
"Uh" = (
/obj/structure/table/hardwoodtable,
/obj/structure/window/phoronbasic{
	dir = 8
	},
/obj/structure/window/phoronbasic{
	dir = 1
	},
/obj/item/material/shard/phoron,
/obj/item/material/shard/phoron,
/turf/simulated/floor/gold/classp,
/area/space)
"Us" = (
/obj/structure/table/hardwoodtable,
/obj/machinery/artifact,
/obj/structure/window/phoronbasic{
	dir = 4
	},
/obj/structure/window/phoronbasic{
	dir = 8
	},
/obj/structure/window/phoronbasic,
/obj/structure/window/phoronbasic{
	dir = 1
	},
/turf/simulated/floor/phoron/classp,
/area/space)
"UJ" = (
/obj/effect/floor_decal/rust,
/turf/simulated/floor/classp,
/area/space)
"UR" = (
/obj/effect/trap/pop_up/pillar,
/turf/simulated/floor/crystal/classp,
/area/space)
"Vb" = (
/turf/simulated/floor/trap/wood/classp{
	id = "headmaster_desk"
	},
/area/space)
"Vk" = (
/turf/simulated/floor/trap/wmarble/classp{
	id = "east_hall_2"
	},
/area/space)
"Vq" = (
/obj/structure/prop/lock{
	lockID = "dmirr";
	name = "The Gate of Dmirr"
	},
/turf/simulated/floor/silver/classp,
/area/space)
"VM" = (
/obj/effect/decal/cleanable/dirt,
/turf/simulated/floor/trap/delayed/crystal/classp{
	id = "display_room"
	},
/area/space)
"Wc" = (
/obj/structure/simple_door/hardwood,
/turf/simulated/floor/trap/wood/classp{
	id = "west_hall_2"
	},
/area/space)
"WM" = (
/obj/structure/prop/lock/projectile{
	lockID = "bchar"
	},
/turf/simulated/floor/classp,
/area/space)
"Xi" = (
/obj/structure/table/hardwoodtable,
/obj/structure/window/phoronbasic{
	dir = 4
	},
/obj/structure/window/phoronbasic{
	dir = 1
	},
/obj/item/material/shard/phoron,
/obj/item/material/shard/phoron,
/turf/simulated/floor/gold/classp,
/area/space)
"XB" = (
/obj/effect/trap/pit/punji{
	id = "west_hall_2"
	},
/turf/simulated/floor/wood/classp,
/area/space)
"XL" = (
/obj/structure/statue/bone{
	desc = "A towering menhir of bone, perhaps the colossal fang of some fallen beast.";
	name = "The Fang of Agrim'Maw"
	},
/obj/effect/decal/cleanable/greenglow,
/turf/simulated/floor/outdoors/grass/heavy/interior/classp,
/area/space)
"Yd" = (
/obj/effect/trap/pit/punji{
	id = "library"
	},
/obj/effect/decal/cleanable/dirt,
/turf/simulated/floor/wood/classp,
/area/space)
"Yg" = (
/obj/effect/trap/pit{
	id = "west_hall_1"
	},
/turf/simulated/floor/bmarble/classp,
/area/space)
"YP" = (
/obj/effect/trap/launcher/fireball_aoe{
	dir = 1;
	id = "vault";
	pixel_y = -32
	},
/obj/structure/table/marble,
/obj/item/clothing/head/helmet/space/void/wizard,
/obj/item/clothing/suit/space/void/wizard,
/turf/simulated/floor/silver/classp,
/area/space)
"YS" = (
/obj/structure/window/reinforced/polarized/full{
	color = "#222222";
	name = "reflective window";
	opacity = 1
	},
/obj/structure/grille/cult,
/turf/simulated/floor/trap/delayed/plating/classp{
	id = "tunnel_north"
	},
/area/space)
"Zc" = (
/obj/effect/trap/pop_up/flame{
	id = "entry_corridor"
	},
/turf/simulated/floor/crystal/classp,
/area/space)
"Zf" = (
/obj/effect/trap/launcher/fireball{
	dir = 8;
	id = "master_trigger";
	pixel_x = 32
	},
/obj/effect/trap/pop_up/flame{
	id = "entry_corridor"
	},
/turf/simulated/floor/phoron/classp,
/area/space)
"Zs" = (
/obj/effect/trap/launcher/fireball{
	dir = 4;
	id = "entry_corridor";
	pixel_x = -32
	},
/obj/effect/decal/cleanable/dirt,
/turf/simulated/floor/phoron/classp,
/area/space)
"Zu" = (
/obj/effect/trap/pop_up/flame{
	id = "entry_corridor"
	},
/obj/effect/trap/launcher/fireball{
	dir = 8;
	id = "master_trigger";
	pixel_x = 32
	},
/turf/simulated/floor/phoron/classp,
/area/space)
"Zw" = (
/obj/effect/trap/pit/deep{
	id = "tunnel_south"
	},
/turf/simulated/floor/classp,
/area/space)
"ZV" = (
/turf/simulated/floor/outdoors/grass/heavy/interior/classp,
/area/space)

(1,1,1) = {"
gr
gr
gr
gr
gr
gr
gr
gr
gr
gr
gr
gr
gr
gr
gr
gr
gr
gr
gr
gr
gr
gr
gr
gr
gr
gr
gr
gr
gr
gr
gr
gr
gr
gr
gr
gr
gr
gr
gr
gr
gr
gr
gr
gr
gr
gr
gr
gr
gr
gr
gr
gr
gr
gr
gr
"}
(2,1,1) = {"
gr
gr
gr
gr
gr
gr
gr
gr
gr
gr
gr
gr
gr
gr
gr
gr
gr
gr
gr
gr
gr
gr
gr
rU
rU
rU
rU
rU
rU
rU
rU
rU
rU
TM
rU
rU
gr
gr
gr
gr
gr
gr
gr
gr
gr
gr
gr
gr
rU
rU
gr
gr
gr
gr
gr
"}
(3,1,1) = {"
gr
gr
gr
gr
gr
gr
gr
gr
gr
gr
gr
gr
gr
gr
gr
gr
gr
gr
gr
rU
rU
rU
rU
rU
rU
rU
rU
rU
rU
rU
TM
TM
TM
rU
rU
TM
TM
TM
TM
gr
gr
gr
gr
gr
gr
gr
gr
rU
rU
rU
rU
rU
gr
gr
gr
"}
(4,1,1) = {"
gr
gr
gr
gr
gr
gr
gr
gr
gr
gr
gr
gr
gr
gr
gr
gr
gr
gr
rU
rU
rU
rU
rU
rU
rU
rU
TM
TM
rU
TM
TM
TM
rU
rU
TM
TM
TM
TM
TM
TM
TM
rU
rU
rU
gr
gr
rU
rU
rU
rU
rU
rU
gr
gr
gr
"}
(5,1,1) = {"
gr
gr
gr
gr
gr
gr
gr
gr
gr
gr
gr
gr
rU
rU
rU
gr
rU
rU
rU
rU
rU
rU
rU
rU
TM
TM
TM
TM
rU
rU
TM
rU
rU
TM
TM
TM
TM
TM
TM
TM
TM
TM
TM
rU
rU
rU
rU
rU
rU
rU
rU
rU
gr
gr
gr
"}
(6,1,1) = {"
gr
gr
gr
gr
gr
gr
gr
rU
rU
rU
rU
rU
rU
rU
rU
rU
rU
rU
rU
rU
rU
rU
TM
TM
TM
Bk
qo
TM
TM
rU
rU
rU
TM
TM
TM
TM
TM
Ij
TM
TM
TM
TM
TM
TM
rU
rU
rU
rU
rU
rU
rU
rU
gr
gr
gr
"}
(7,1,1) = {"
gr
gr
gr
gr
gr
gr
rU
rU
rU
rU
rU
rU
rU
rU
rU
rU
TM
TM
TM
TM
TM
TM
TM
BP
iX
Ks
qo
TM
TM
TM
TM
TM
TM
TM
TM
TM
Ij
Ij
Ij
TM
TM
Ij
TM
TM
TM
TM
TM
rU
rU
rU
rU
rU
gr
gr
gr
"}
(8,1,1) = {"
gr
gr
gr
gr
gr
rU
rU
rU
rU
rU
rU
rU
rU
rU
rU
TM
TM
TM
qo
qo
qo
qo
qo
iX
Ks
iX
qo
qo
qo
qo
qo
TM
TM
TM
Ij
Ij
Ij
Ij
Ij
Ij
TM
Ij
Ij
TM
TM
TM
TM
TM
TM
rU
rU
rU
rU
gr
gr
"}
(9,1,1) = {"
gr
gr
gr
rU
rU
rU
rU
rU
rU
rU
rU
rU
rU
rU
rU
TM
qo
qo
qo
bv
FY
hQ
qo
qo
iX
qo
qo
av
FY
zk
qo
TM
TM
Ij
Ij
Ij
Ij
Ij
Ij
Ij
Ij
Ij
Ij
Ij
TM
TM
TM
TM
TM
rU
rU
rU
rU
gr
gr
"}
(10,1,1) = {"
gr
gr
gr
rU
rU
rU
rU
rU
rU
rU
rU
rU
rU
rU
rU
TM
qo
OI
qo
At
ot
PM
ef
iX
Ks
iX
ef
ot
PM
ot
qo
TM
TM
Ij
Ij
Ij
Ij
Ij
Ij
Ij
Ij
Ij
Ij
TM
TM
TM
TM
TM
TM
TM
rU
rU
rU
gr
gr
"}
(11,1,1) = {"
gr
gr
rU
rU
rU
rU
rU
rU
rU
rU
rU
rU
rU
rU
rU
TM
qo
se
qo
qo
qo
qo
qo
Ks
iX
Ks
qo
qo
qo
qo
qo
TM
TM
TM
Ij
Ij
Ij
Ij
Ij
Ij
Ij
Ij
Ij
Ij
TM
TM
TM
TM
TM
TM
rU
rU
rU
gr
gr
"}
(12,1,1) = {"
gr
gr
rU
rU
rU
rU
rU
rU
rU
rU
rU
rU
rU
rU
TM
TM
qo
se
qo
zk
Ol
bv
qo
iX
Ks
zz
qo
bv
ot
tY
qo
TM
TM
TM
TM
Ij
Ij
Ij
Ij
Ij
TM
Ij
Ij
Ij
Ij
TM
TM
TM
TM
TM
TM
rU
rU
gr
gr
"}
(13,1,1) = {"
gr
gr
rU
rU
rU
rU
rU
rU
rU
rU
rU
rU
rU
rU
TM
TM
qo
UJ
qo
Fp
ot
ot
ef
Ks
iX
Kf
EY
ot
ot
jS
qo
TM
TM
TM
TM
TM
TM
Ij
Ij
TM
TM
TM
Ij
Ij
Ij
Ij
TM
TM
TM
TM
TM
TM
rU
gr
gr
"}
(14,1,1) = {"
gr
rU
rU
rU
rU
rU
rU
rU
rU
rU
rU
rU
rU
rU
rU
TM
qo
se
qo
qo
qo
qo
qo
iX
Kv
mr
qo
qo
qo
qo
qo
TM
TM
TM
TM
TM
TM
TM
TM
TM
TM
TM
TM
TM
Ij
Ij
Ij
TM
TM
TM
TM
TM
TM
gr
gr
"}
(15,1,1) = {"
gr
rU
rU
rU
rU
rU
rU
rU
rU
rU
rU
rU
rU
rU
rU
TM
qo
se
qo
jS
Jw
ot
qo
Kv
DA
Ks
qo
QV
Lh
Jw
qo
TM
TM
qo
qo
qo
qo
qo
qo
qo
qo
qo
TM
TM
TM
Ij
Ij
Ij
TM
TM
TM
TM
TM
gr
gr
"}
(16,1,1) = {"
gr
rU
rU
rU
rU
rU
rU
rU
rU
rU
rU
rU
rU
rU
jJ
TM
qo
se
qo
av
ot
XB
Wc
oZ
Ks
iX
ef
ot
PM
ot
qo
TM
TM
qo
ZV
fQ
JU
sW
JU
gS
rO
qo
TM
TM
Ij
Ij
Ij
Ij
TM
TM
TM
TM
TM
TM
gr
"}
(17,1,1) = {"
gr
gr
rU
rU
rU
rU
rU
TM
TM
TM
rU
TM
rU
rU
TM
TM
qo
se
qo
qo
qo
qo
qo
Ks
NS
Ks
qo
qo
qo
qo
qo
TM
TM
qo
fQ
ZV
ZV
ZV
ZV
fQ
rO
TM
Ij
Ij
Ij
Ij
Ij
Ij
Ij
Ij
TM
TM
TM
TM
gr
"}
(18,1,1) = {"
gr
gr
rU
rU
rU
TM
TM
TM
TM
TM
TM
TM
TM
rU
TM
TM
qo
UJ
qo
bv
ot
ot
qo
DI
Yg
DI
qo
ru
ot
jS
qo
TM
TM
qo
fQ
ZV
fQ
zC
Ij
ZV
ZV
TM
TM
Ij
TM
TM
TM
Ij
Ij
Ij
Ij
TM
TM
TM
gr
"}
(19,1,1) = {"
gr
gr
rU
rU
TM
qo
qo
qo
qo
qo
qo
TM
rU
rU
TM
TM
qo
se
qo
Lh
Jw
ot
ef
Ks
iX
Ks
ef
Ol
PM
Fu
qo
TM
TM
qo
fQ
ZV
Ij
XL
zC
ZV
fQ
TM
TM
TM
TM
Ij
Ij
Ij
Ij
Ij
Ij
TM
TM
TM
gr
"}
(20,1,1) = {"
gr
gr
rU
rU
TM
qo
Ij
kJ
mN
Ij
qo
TM
TM
TM
TM
TM
qo
se
qo
qo
qo
qo
qo
qo
mx
qo
qo
qo
qo
qo
qo
qo
qo
qo
fQ
fQ
zC
Ij
Ij
fQ
fQ
qo
se
se
TM
Ij
TM
TM
TM
Ij
Ij
TM
TM
TM
gr
"}
(21,1,1) = {"
gr
gr
rU
rU
TM
qo
Ij
iX
Ks
Ij
qo
TM
TM
TM
TM
TM
qo
se
se
qo
qo
zY
zY
zY
AN
zY
zY
zY
qo
qo
qo
qo
sj
fS
fQ
ZV
ZV
fQ
ZV
ZV
fQ
fS
UJ
et
se
Ij
Ij
TM
TM
Ij
Ij
TM
TM
TM
TM
"}
(22,1,1) = {"
gr
gr
rU
rU
TM
qo
Ij
Ks
iX
zC
qo
TM
TM
TM
TM
TM
qo
LP
lf
YS
zY
zY
AN
AN
AN
Dl
AN
zY
zY
lc
Zw
if
PU
qo
ZV
fQ
fQ
fQ
fQ
fQ
ZV
qo
se
se
UJ
TM
TM
TM
TM
TM
Ij
Ij
TM
TM
TM
"}
(23,1,1) = {"
gr
gr
rU
rU
TM
qo
Ks
DA
Ks
iX
qo
TM
TM
TM
TM
TM
qo
se
se
qo
GF
Dl
AN
AN
AN
Dl
Dl
Dl
zY
qo
qo
qo
nd
qo
qo
qo
qo
Ku
qo
qo
qo
qo
TM
TM
TM
TM
TM
TM
Mq
Mq
Dy
Dy
Mq
TM
TM
"}
(24,1,1) = {"
gr
gr
rU
rU
rU
qo
qo
PM
PM
qo
qo
Mq
Mq
Mq
Mq
Mq
Mq
Mq
qo
qo
GF
AN
zY
od
od
od
zY
AN
zY
qo
uk
qo
oq
qo
uk
qo
yw
AN
lh
qo
uk
qo
Kl
TM
TM
Mq
Mq
Mq
Mq
od
od
od
Mq
Mq
TM
"}
(25,1,1) = {"
gr
gr
rU
rU
rU
qo
AM
ot
ot
Ee
qo
Hh
Zc
Hh
Zc
jo
Zc
Zs
qo
zY
zY
AN
od
Oo
zY
Fg
od
AN
GF
qo
AN
AN
AN
AN
AN
Dl
AN
AN
Dl
AN
AN
AN
AN
AN
TM
Mq
od
od
od
Fg
zY
Fg
od
Mq
TM
"}
(26,1,1) = {"
gr
gr
rU
rU
rU
ef
ot
ot
ot
ot
nD
AN
Ua
Dl
Br
AN
cz
Dl
nD
AN
Dl
Dl
Py
GF
Fg
zY
od
AN
Dl
rE
AN
od
zY
od
zY
od
zY
Py
zY
od
zY
od
zY
od
AN
tc
Jv
bJ
zY
zY
Fg
zY
YP
Mq
TM
"}
(27,1,1) = {"
gr
gr
rU
rU
rU
ef
ot
ot
PM
PM
rE
Fg
Zc
Oo
dN
Oo
Zc
IE
rE
AN
AN
AN
od
zY
Fg
GF
Py
Dl
AN
rE
AN
Py
GF
od
zY
od
zY
Py
GF
Py
zY
od
zY
od
AN
tc
Jv
bJ
zY
zY
Fg
zY
kE
Mq
TM
"}
(28,1,1) = {"
gr
gr
rU
rU
TM
qo
Ee
PM
PM
aY
qo
AN
Zu
AN
Zu
xl
Zf
AN
qo
zY
zY
AN
od
Fg
zY
Oo
od
AN
zY
qo
Dl
Dl
Dl
AN
AN
AN
AN
AN
AN
AN
Dl
AN
AN
AN
AN
Mq
od
od
od
JL
JT
JL
od
Mq
TM
"}
(29,1,1) = {"
gr
gr
rU
rU
TM
qo
qo
ot
ot
qo
qo
Mq
Mq
Mq
Mq
Mq
Mq
Mq
qo
qo
zY
AN
zY
od
od
od
zY
AN
zY
qo
ik
qo
Tw
qo
fB
qo
lh
AN
lh
qo
ik
qo
uh
qo
TM
Mq
Mq
Mq
Mq
od
Vq
od
Mq
Mq
TM
"}
(30,1,1) = {"
gr
gr
rU
rU
TM
qo
Ks
iX
Ks
iX
qo
TM
TM
TM
TM
TM
qo
UJ
UJ
qo
zY
AN
AN
Dl
Dl
AN
AN
AN
zY
qo
qo
qo
Ug
qo
qo
qo
qo
Ku
qo
qo
qo
qo
qo
qo
qo
TM
TM
TM
Mq
Mq
Mq
Mq
Mq
TM
TM
"}
(31,1,1) = {"
gr
gr
rU
rU
TM
qo
zC
Ks
iX
Ij
qo
TM
TM
TM
TM
TM
qo
se
UJ
fS
zY
zY
AN
AN
Dl
Dl
AN
zY
zY
fS
UJ
qo
FF
qo
qo
Sz
DA
od
iX
Sz
qo
UJ
se
UJ
qo
TM
TM
TM
TM
TM
TM
TM
TM
TM
rU
"}
(32,1,1) = {"
gr
gr
rU
TM
TM
qo
zC
iX
Ks
Ij
qo
TM
TM
TM
TM
TM
qo
se
se
qo
qo
zY
zY
zY
AN
zY
zY
zY
qo
qo
qo
qo
LP
BS
Mx
JP
od
zY
Py
JP
my
xQ
WM
se
qo
TM
qo
qo
qo
qo
qo
TM
TM
TM
rU
"}
(33,1,1) = {"
gr
gr
rU
TM
TM
qo
Ij
kJ
mN
Ij
qo
TM
TM
Mq
Mq
Mq
qo
qo
qo
qo
qo
qo
qo
qo
tt
qo
qo
qo
qo
qo
qo
qo
qo
qo
qo
Sz
iX
od
DA
gC
qo
UJ
UJ
UJ
qo
TM
qo
kr
kr
BF
qo
TM
TM
rU
rU
"}
(34,1,1) = {"
gr
gr
rU
rU
TM
qo
qo
qo
qo
qo
qo
TM
TM
Mq
we
se
qo
Ci
od
Us
od
EZ
Mq
zY
iX
zY
Mq
kr
kr
kr
kr
kr
kr
qo
qo
qo
qo
xO
qo
qo
qo
qo
qo
qo
qo
qo
qo
tY
ot
kT
qo
TM
rU
rU
rU
"}
(35,1,1) = {"
gr
gr
rU
rU
rU
TM
TM
TM
TM
TM
TM
TM
TM
Mq
Rv
se
Nk
od
Sc
HM
Dl
od
ef
iX
Ks
Hw
ef
ot
GP
Ol
ot
PM
ot
qo
zY
Fg
zY
ot
Fg
zY
Fg
zY
Fg
zY
Fg
qo
qo
zk
hQ
Vb
qo
TM
rU
rU
gr
"}
(36,1,1) = {"
gr
gr
rU
rU
rU
TM
TM
TM
rU
rU
rU
TM
TM
Mq
eJ
se
qo
Us
AN
od
Dl
Us
Mq
KP
DA
Ks
Mq
kr
rq
Lh
zk
ot
kr
qo
Fg
nX
Lh
PM
nX
Lh
nX
zk
ot
ot
zY
qo
qo
nX
nX
Ol
qo
TM
TM
rU
gr
"}
(37,1,1) = {"
gr
rU
rU
rU
rU
rU
rU
rU
rU
TM
rU
rU
TM
Mq
Mq
Mq
Bw
od
UR
rt
VM
od
Mq
DA
Kv
Ar
Mq
kr
GP
Ak
nX
ot
kr
qo
zY
nX
jS
PM
nX
zk
nX
Lh
Ol
Dl
AN
AN
La
ot
ot
Pe
qo
TM
TM
rU
gr
"}
(38,1,1) = {"
gr
rU
rU
rU
rU
rU
rU
rU
rU
TM
TM
rU
TM
TM
TM
TM
qo
Xi
Dl
GF
AN
Ci
Mq
KP
dv
Ks
Mq
kr
ot
PM
ot
ot
kr
qo
zY
ot
PM
PM
ot
ot
ot
ot
ot
He
Dl
AN
qo
qo
qo
qo
qo
TM
TM
rU
gr
"}
(39,1,1) = {"
gr
rU
rU
rU
rU
rU
rU
rU
rU
rU
TM
TM
TM
TM
TM
TM
Bw
od
AN
Us
UR
od
Mq
iX
Kv
Ar
Mq
kr
PM
Ak
nX
GP
kr
qo
zY
ot
Ol
ot
ot
ot
ot
PM
ot
Nt
Dl
AN
OJ
TM
TM
TM
TM
TM
rU
rU
gr
"}
(40,1,1) = {"
gr
rU
rU
rU
rU
rU
rU
rU
rU
rU
TM
TM
TM
TM
rU
TM
qo
Us
Sc
od
Dl
HB
Mq
KP
DA
ct
Mq
kr
ot
zk
hQ
Fw
kr
qo
zY
nX
zk
ot
nX
jS
Ak
jS
ot
AN
AN
Ia
TM
TM
TM
TM
TM
rU
rU
rU
gr
"}
(41,1,1) = {"
gr
gr
rU
rU
rU
rU
rU
rU
rU
TM
TM
TM
TM
rU
rU
TM
Bw
od
Dl
HM
AN
od
ef
Vk
Ks
iX
ef
ot
PM
ot
PM
Yd
Ol
qo
Fg
nX
hQ
ot
Ak
jS
nX
Lh
ot
ot
zY
qo
TM
TM
TM
TM
TM
rU
rU
rU
gr
"}
(42,1,1) = {"
gr
gr
rU
rU
rU
rU
rU
rU
rU
rU
rU
TM
TM
rU
TM
TM
qo
Uh
od
Us
od
Ci
Mq
Ks
iX
Ks
Mq
kr
kr
eh
kr
kr
kr
qo
zY
Fg
zY
zY
Fg
zY
Fg
zY
Fg
zY
Fg
qo
TM
TM
TM
TM
rU
rU
rU
gr
gr
"}
(43,1,1) = {"
gr
gr
gr
gr
gr
rU
rU
rU
rU
rU
rU
rU
TM
rU
rU
TM
qo
qo
qo
qo
qo
qo
qo
md
te
md
qo
qo
qo
qo
qo
qo
qo
qo
qo
qo
qo
qo
qo
qo
qo
qo
qo
qo
qo
qo
TM
TM
TM
rU
rU
rU
rU
gr
gr
"}
(44,1,1) = {"
gr
gr
gr
gr
gr
gr
rU
rU
rU
rU
rU
rU
rU
rU
TM
TM
TM
TM
TM
TM
TM
TM
qo
qo
qo
qo
qo
TM
TM
TM
TM
TM
TM
TM
TM
TM
TM
TM
TM
TM
TM
TM
TM
TM
TM
TM
TM
rU
rU
rU
rU
rU
rU
gr
gr
"}
(45,1,1) = {"
gr
gr
gr
gr
gr
gr
gr
rU
rU
rU
rU
rU
rU
rU
rU
rU
rU
rU
rU
rU
TM
TM
TM
TM
TM
TM
TM
TM
TM
rU
rU
TM
TM
TM
TM
TM
TM
TM
TM
TM
TM
TM
rU
rU
rU
rU
rU
rU
rU
rU
rU
rU
gr
gr
gr
"}
(46,1,1) = {"
gr
gr
gr
gr
gr
gr
gr
gr
rU
rU
rU
rU
rU
rU
rU
rU
rU
rU
rU
rU
rU
rU
TM
TM
TM
TM
TM
rU
rU
rU
rU
TM
TM
TM
TM
TM
TM
TM
TM
TM
rU
rU
rU
rU
rU
rU
rU
rU
rU
rU
rU
gr
gr
gr
gr
"}
(47,1,1) = {"
gr
gr
gr
gr
gr
gr
gr
gr
gr
gr
gr
gr
rU
rU
rU
rU
rU
rU
rU
rU
rU
gr
gr
gr
gr
TM
rU
rU
rU
rU
TM
TM
TM
rU
rU
TM
TM
TM
rU
rU
rU
rU
rU
rU
rU
rU
rU
rU
rU
rU
rU
gr
gr
gr
gr
"}
(48,1,1) = {"
gr
gr
gr
gr
gr
gr
gr
gr
gr
gr
gr
gr
gr
gr
gr
rU
rU
rU
gr
gr
gr
gr
gr
gr
gr
gr
gr
gr
TM
TM
TM
TM
rU
rU
rU
rU
rU
rU
rU
rU
gr
gr
gr
gr
gr
rU
rU
gr
gr
rU
gr
gr
gr
gr
gr
"}
(49,1,1) = {"
gr
gr
gr
gr
gr
gr
gr
gr
gr
gr
gr
gr
gr
gr
gr
gr
gr
gr
gr
gr
gr
gr
gr
gr
gr
gr
gr
gr
gr
gr
gr
gr
gr
gr
gr
gr
gr
gr
gr
gr
gr
gr
gr
gr
gr
gr
gr
gr
gr
gr
gr
gr
gr
gr
gr
"}
