//MAP CONVERTED BY dmm2tgm.py THIS HEADER COMMENT PREVENTS RECONVERSION, DO NOT REMOVE
"a" = (
/turf/simulated/floor/outdoors/snow/classp,
/area/class_p/ruins)
"j" = (
/turf/simulated/floor/classp/outdoors,
/area/class_p/ruins)
"m" = (
/turf/simulated/wall/classp,
/area/class_p/ruins)
"F" = (
/obj/random/mob/robotic/hivebot{
	mob_faction = "frozen"
	},
/turf/simulated/floor/classp/outdoors,
/area/class_p/ruins)
"L" = (
/obj/structure/table/gamblingtable,
/obj/random/triumph/uncertain,
/turf/simulated/floor/carpet/purcarpet/classp,
/area/class_p/ruins)
"M" = (
/turf/simulated/floor/outdoors/snow/classp/no_tree,
/area/class_p/ruins)
"N" = (
/obj/structure/closet/crate/secure/loot,
/turf/simulated/floor/wood/classp,
/area/class_p/ruins)
"O" = (
/obj/structure/bed,
/turf/simulated/floor/carpet/purcarpet/classp,
/area/class_p/ruins)
"Q" = (
/obj/random/mob/robotic/hivebot{
	mob_faction = "frozen"
	},
/turf/simulated/floor/outdoors/snow/classp/no_tree,
/area/class_p/ruins)
"S" = (
/turf/simulated/floor/carpet/purcarpet/classp,
/area/class_p/ruins)
"W" = (
/turf/simulated/floor/wood/classp,
/area/class_p/ruins)

(1,1,1) = {"
a
a
a
a
a
a
a
a
a
a
a
a
"}
(2,1,1) = {"
a
a
a
a
Q
a
a
a
a
a
a
a
"}
(3,1,1) = {"
a
a
M
M
M
M
M
M
M
a
a
a
"}
(4,1,1) = {"
a
a
M
m
m
m
m
m
M
M
a
a
"}
(5,1,1) = {"
a
a
M
m
j
W
N
m
m
M
m
a
"}
(6,1,1) = {"
a
a
M
m
W
j
F
j
M
M
M
a
"}
(7,1,1) = {"
a
a
M
m
S
S
j
M
M
M
M
a
"}
(8,1,1) = {"
a
a
M
m
O
L
W
m
m
m
M
a
"}
(9,1,1) = {"
a
a
M
m
m
m
m
m
M
M
M
a
"}
(10,1,1) = {"
a
a
Q
M
M
M
M
M
M
a
Q
a
"}
(11,1,1) = {"
a
a
a
a
a
a
a
a
a
a
a
a
"}
(12,1,1) = {"
a
a
a
a
a
a
a
a
a
a
a
a
"}
