//MAP CONVERTED BY dmm2tgm.py THIS HEADER COMMENT PREVENTS RECONVERSION, DO NOT REMOVE
"a" = (
/turf/template_noop,
/area/template_noop)
"q" = (
/obj/random/roguemineloot,
/turf/simulated/mineral/floor/classd/indoors,
/area/class_d/explored)
"s" = (
/turf/simulated/mineral/classd/indoors,
/area/class_d/explored)
"u" = (
/obj/item/storage/bag/ore,
/turf/simulated/mineral/floor/classd/indoors,
/area/class_d/explored)
"K" = (
/obj/random/obstruction,
/turf/simulated/mineral/floor/classd/indoors,
/area/class_d/explored)
"M" = (
/obj/random/outcrop,
/turf/simulated/mineral/floor/classd/indoors,
/area/class_d/explored)
"N" = (
/obj/structure/closet/crate/miningcar,
/turf/simulated/mineral/floor/classd/indoors,
/area/class_d/explored)
"R" = (
/obj/item/flashlight/lantern,
/turf/simulated/mineral/floor/classd/indoors,
/area/class_d/explored)
"S" = (
/obj/random/obstruction,
/turf/simulated/mineral/classd/indoors,
/area/class_d/explored)
"W" = (
/turf/simulated/mineral/floor/classd/indoors,
/area/class_d/explored)

(1,1,1) = {"
a
a
W
W
W
W
W
W
W
W
W
W
W
W
W
W
W
a
a
a
"}
(2,1,1) = {"
a
W
W
s
s
s
s
S
s
s
s
s
s
s
s
M
W
a
a
a
"}
(3,1,1) = {"
a
W
s
s
s
s
s
s
s
s
s
s
s
s
s
s
W
W
a
a
"}
(4,1,1) = {"
a
W
s
s
s
M
W
q
M
s
s
s
s
s
W
W
W
W
W
W
"}
(5,1,1) = {"
W
W
s
s
W
W
W
W
W
M
s
s
s
W
W
W
W
s
M
W
"}
(6,1,1) = {"
W
s
s
W
q
W
s
W
W
W
s
s
W
W
W
s
s
s
s
W
"}
(7,1,1) = {"
W
s
s
M
W
s
s
M
W
s
s
s
W
W
s
s
s
s
s
W
"}
(8,1,1) = {"
W
W
s
s
s
s
s
s
K
s
W
W
K
s
s
s
M
s
s
W
"}
(9,1,1) = {"
a
W
s
s
s
s
M
W
W
W
W
W
s
s
s
q
W
W
s
W
"}
(10,1,1) = {"
a
W
W
W
W
W
W
W
W
u
W
s
s
s
s
M
W
M
s
W
"}
(11,1,1) = {"
a
W
W
W
W
W
W
R
N
s
W
W
s
s
s
W
W
W
s
W
"}
(12,1,1) = {"
a
W
M
s
s
s
W
W
s
s
M
W
W
W
W
W
W
s
s
W
"}
(13,1,1) = {"
a
W
s
s
s
s
W
M
s
s
s
s
W
W
W
W
s
s
s
W
"}
(14,1,1) = {"
W
W
s
s
s
s
W
W
W
s
s
s
s
M
q
M
s
s
s
W
"}
(15,1,1) = {"
W
W
s
s
s
s
W
W
W
W
s
s
s
s
s
s
s
s
W
W
"}
(16,1,1) = {"
W
W
s
s
s
s
s
M
W
K
W
W
W
M
s
s
s
s
M
W
"}
(17,1,1) = {"
a
W
M
s
s
s
s
s
s
W
q
W
W
W
W
s
s
s
W
W
"}
(18,1,1) = {"
a
a
W
W
M
s
s
s
s
s
s
s
s
W
W
s
s
s
W
a
"}
(19,1,1) = {"
a
a
a
W
W
W
W
W
W
s
s
s
M
W
W
s
s
W
W
a
"}
(20,1,1) = {"
a
a
a
a
a
a
W
W
W
W
W
W
W
W
W
W
W
W
a
a
"}
