//MAP CONVERTED BY dmm2tgm.py THIS HEADER COMMENT PREVENTS RECONVERSION, DO NOT REMOVE
"b" = (
/turf/simulated/wall/classd/indoors,
/area/class_d/explored)
"c" = (
/obj/structure/closet/crate/mimic/dangerous,
/obj/effect/debris/cleanable/dirt,
/obj/random/maintenance/security,
/obj/random/maintenance/security,
/obj/random/roguemineloot,
/obj/random/roguemineloot,
/obj/random/roguemineloot,
/turf/simulated/floor/tiled/classd/indoors,
/area/class_d/explored)
"d" = (
/obj/effect/debris/cleanable/dirt,
/turf/simulated/floor/tiled/classd/indoors,
/area/class_d/explored)
"e" = (
/obj/structure/closet/crate/mimic,
/obj/effect/debris/cleanable/dirt,
/obj/random/roguemineloot,
/obj/random/roguemineloot,
/obj/random/roguemineloot,
/turf/simulated/floor/tiled/classd/indoors,
/area/class_d/explored)
"f" = (
/obj/structure/simple_door/silver,
/obj/effect/debris/cleanable/dirt,
/turf/simulated/floor/tiled/classd/indoors,
/area/class_d/explored)
"h" = (
/obj/effect/debris/cleanable/dirt,
/obj/random/junk,
/turf/simulated/floor/tiled/classd/indoors,
/area/class_d/explored)

(1,1,1) = {"
b
b
b
b
b
"}
(2,1,1) = {"
b
c
d
h
b
"}
(3,1,1) = {"
b
d
d
d
f
"}
(4,1,1) = {"
b
d
e
d
b
"}
(5,1,1) = {"
b
b
b
b
b
"}
