"ak" = (/turf/template_noop,/area/debrisfield/explored)
"ar" = (/obj/structure/table/steel,/obj/item/pizzabox,/turf/simulated/floor/tiled/steel,/area/debrisfield/unidentified_corvette)
"aE" = (/obj/structure/table/standard,/obj/item/clothing/gloves/sterile,/obj/item/clothing/gloves/sterile,/obj/effect/floor_decal/corner/green/border,/turf/simulated/floor/tiled/white,/area/debrisfield/unidentified_corvette)
"aN" = (/obj/effect/floor_decal/corner/green/border{dir = 8; icon_state = "bordercolor"},/turf/simulated/floor/tiled/white,/area/debrisfield/unidentified_corvette)
"ca" = (/turf/simulated/floor/airless,/area/debrisfield/unidentified_corvette)
"ck" = (/obj/structure/bed,/obj/item/bedsheet,/obj/structure/bed,/turf/simulated/floor/tiled/steel,/area/debrisfield/unidentified_corvette)
"cA" = (/obj/machinery/gibber,/obj/effect/floor_decal/corner/green/border{dir = 1; icon_state = "bordercolor"},/turf/simulated/floor/tiled/white,/area/debrisfield/unidentified_corvette)
"cB" = (/obj/structure/table/standard,/obj/item/tank/anesthetic,/obj/effect/floor_decal/corner/green/border,/turf/simulated/floor/tiled/white,/area/debrisfield/unidentified_corvette)
"cC" = (/obj/effect/floor_decal/borderfloor/corner{dir = 4},/turf/simulated/floor/tiled/steel,/area/debrisfield/unidentified_corvette)
"dd" = (/obj/machinery/door/airlock/external,/obj/structure/fans/tiny,/turf/simulated/floor/tiled/steel,/area/debrisfield/unidentified_corvette)
"dy" = (/mob/living/simple_mob/humanoid/merc/ranged/grenadier/poi,/turf/simulated/floor/tiled/hydro,/area/debrisfield/unidentified_corvette)
"dA" = (/mob/living/simple_mob/mechanical/viscerator,/turf/simulated/floor/tiled/steel_grid,/area/debrisfield/unidentified_corvette)
"dG" = (/obj/machinery/door/airlock,/turf/simulated/floor/tiled/hydro,/area/debrisfield/unidentified_corvette)
"dT" = (/turf/simulated/floor/tiled/yellow,/area/debrisfield/unidentified_corvette)
"dW" = (/obj/structure/table/woodentable,/turf/simulated/floor/tiled/steel,/area/debrisfield/unidentified_corvette)
"eu" = (/obj/structure/table/steel,/obj/random/projectile,/turf/simulated/floor/tiled/yellow,/area/debrisfield/unidentified_corvette)
"ew" = (/obj/structure/dispenser/oxygen,/obj/effect/floor_decal/borderfloor{dir = 6},/turf/simulated/floor/tiled/steel,/area/debrisfield/unidentified_corvette)
"eT" = (/obj/machinery/atmospherics/pipe/tank/oxygen,/obj/machinery/light/small{dir = 4; pixel_y = 0},/turf/simulated/floor/tiled/yellow,/area/debrisfield/unidentified_corvette)
"eZ" = (/obj/effect/decal/cleanable/blood,/turf/simulated/floor/tiled/white,/area/debrisfield/unidentified_corvette)
"fC" = (/obj/structure/table/standard,/obj/item/storage/firstaid/surgery,/obj/effect/floor_decal/corner/green/border{dir = 10; icon_state = "bordercolor"},/turf/simulated/floor/tiled/white,/area/debrisfield/unidentified_corvette)
"gx" = (/obj/effect/floor_decal/borderfloor{dir = 4},/obj/effect/floor_decal/borderfloor{dir = 4},/turf/simulated/floor/tiled/steel,/area/debrisfield/unidentified_corvette)
"hs" = (/turf/simulated/shuttle/wall/dark{icon_state = "dark10"; name = "Unknown Shuttle"},/area/debrisfield/unidentified_corvette)
"hA" = (/obj/structure/table/standard,/obj/item/reagent_containers/spray/sterilizine,/obj/item/reagent_containers/spray/sterilizine,/obj/effect/floor_decal/corner/green/border,/turf/simulated/floor/tiled/white,/area/debrisfield/unidentified_corvette)
"ih" = (/mob/living/simple_mob/humanoid/merc/melee/sword/poi,/turf/simulated/floor/tiled/white,/area/debrisfield/unidentified_corvette)
"jy" = (/obj/structure/bed,/obj/item/bedsheet,/turf/simulated/floor/tiled/steel,/area/debrisfield/unidentified_corvette)
"kh" = (/obj/machinery/optable,/turf/simulated/floor/tiled/white,/area/debrisfield/unidentified_corvette)
"kT" = (/obj/effect/floor_decal/borderfloor{dir = 4},/mob/living/simple_mob/humanoid/merc/ranged/deagle,/turf/simulated/floor/tiled/steel,/area/debrisfield/unidentified_corvette)
"lf" = (/obj/effect/floor_decal/corner/green/border,/turf/simulated/floor/tiled/white,/area/debrisfield/unidentified_corvette)
"lh" = (/obj/machinery/door/airlock/external,/turf/simulated/floor/tiled/steel,/area/debrisfield/unidentified_corvette)
"lM" = (/obj/machinery/organ_printer/flesh,/obj/effect/floor_decal/corner/green/border{dir = 5; icon_state = "bordercolor"},/turf/simulated/floor/tiled/white,/area/debrisfield/unidentified_corvette)
"ni" = (/turf/template_noop,/area/debrisfield/unexplored)
"nv" = (/mob/living/simple_mob/humanoid/merc/melee/sword/poi,/turf/simulated/floor/tiled/yellow,/area/debrisfield/unidentified_corvette)
"nA" = (/obj/machinery/bodyscanner{dir = 8},/obj/effect/floor_decal/corner/green/border{dir = 1; icon_state = "bordercolor"},/turf/simulated/floor/tiled/white,/area/debrisfield/unidentified_corvette)
"pj" = (/obj/machinery/light{dir = 4; icon_state = "tube1"; pixel_x = 0},/obj/effect/floor_decal/corner/green/border{dir = 4; icon_state = "bordercolor"},/turf/simulated/floor/tiled/white,/area/debrisfield/unidentified_corvette)
"pX" = (/turf/simulated/shuttle/wall/dark{icon_state = "dark9"; name = "Unknown Shuttle"},/area/debrisfield/unidentified_corvette)
"qc" = (/obj/structure/table/steel,/obj/effect/floor_decal/borderfloor{dir = 8},/turf/simulated/floor/tiled/steel,/area/debrisfield/unidentified_corvette)
"qA" = (/obj/machinery/door/airlock/glass,/turf/simulated/floor/tiled/steel,/area/debrisfield/unidentified_corvette)
"sn" = (/obj/machinery/portable_atmospherics/canister/empty/oxygen,/turf/simulated/floor/tiled/yellow,/area/debrisfield/unidentified_corvette)
"sT" = (/obj/machinery/porta_turret/poi,/turf/simulated/floor/airless,/area/debrisfield/unidentified_corvette)
"tn" = (/obj/effect/floor_decal/corner/grey,/turf/simulated/floor/tiled/steel,/area/debrisfield/unidentified_corvette)
"vv" = (/obj/machinery/computer/area_atmos{dir = 4},/obj/effect/floor_decal/borderfloor{dir = 10},/turf/simulated/floor/tiled/steel,/area/debrisfield/unidentified_corvette)
"wd" = (/turf/simulated/floor/tiled/steel_grid,/area/debrisfield/unidentified_corvette)
"wn" = (/obj/structure/table/steel,/turf/simulated/floor/tiled/steel_grid,/area/debrisfield/unidentified_corvette)
"wx" = (/obj/effect/floor_decal/borderfloor/corner{dir = 4},/obj/effect/floor_decal/borderfloor/corner{dir = 4},/turf/simulated/floor/tiled/steel,/area/debrisfield/unidentified_corvette)
"yu" = (/obj/machinery/computer/communications{dir = 4},/obj/effect/floor_decal/borderfloor{dir = 9},/turf/simulated/floor/tiled/steel,/area/debrisfield/unidentified_corvette)
"yz" = (/turf/simulated/mineral/vacuum,/area/debrisfield/explored)
"yC" = (/obj/machinery/light{dir = 1},/obj/structure/table/rack,/obj/item/clothing/head/helmet/space,/obj/item/clothing/head/helmet/space,/obj/item/clothing/head/helmet/space,/obj/item/clothing/head/helmet/space,/obj/item/clothing/suit/space,/obj/item/clothing/suit/space,/obj/item/clothing/suit/space,/obj/item/clothing/suit/space,/obj/effect/floor_decal/borderfloor{dir = 9},/turf/simulated/floor/tiled/steel,/area/debrisfield/unidentified_corvette)
"yF" = (/obj/machinery/light{dir = 4; icon_state = "tube1"; pixel_x = 0},/obj/effect/floor_decal/borderfloor{dir = 6},/turf/simulated/floor/tiled/steel,/area/debrisfield/unidentified_corvette)
"zd" = (/obj/structure/table/steel,/obj/item/grenade/smokebomb,/turf/simulated/floor/tiled/steel_grid,/area/debrisfield/unidentified_corvette)
"zh" = (/obj/structure/toilet{dir = 1},/turf/simulated/floor/tiled/hydro,/area/debrisfield/unidentified_corvette)
"zD" = (/obj/structure/table/steel,/turf/simulated/floor/tiled/steel,/area/debrisfield/unidentified_corvette)
"zS" = (/obj/effect/floor_decal/borderfloor{dir = 6},/turf/simulated/floor/tiled/steel,/area/debrisfield/unidentified_corvette)
"Ah" = (/obj/machinery/door/airlock/external{density = 1; frequency = 1331; id_tag = "merc_shuttle_outer"; name = "Ship External Access"; req_access = list(150)},/turf/simulated/floor/tiled/steel,/area/debrisfield/unidentified_corvette)
"Ai" = (/obj/structure/shuttle/engine/propulsion{dir = 4; icon_state = "propulsion_l"},/turf/template_noop,/area/debrisfield/unidentified_corvette)
"Av" = (/mob/living/simple_mob/humanoid/merc/ranged/space/tommylas,/turf/simulated/floor/tiled/steel,/area/debrisfield/unidentified_corvette)
"AC" = (/obj/structure/table/steel,/obj/effect/floor_decal/borderfloor/full,/turf/simulated/floor/tiled/steel,/area/debrisfield/unidentified_corvette)
"AY" = (/obj/structure/bed,/obj/item/bedsheet,/obj/item/toy/plushie/spider,/turf/simulated/floor/tiled/steel,/area/debrisfield/unidentified_corvette)
"Bt" = (/obj/structure/table/steel,/obj/item/material/knife,/turf/simulated/floor/tiled/steel,/area/debrisfield/unidentified_corvette)
"By" = (/obj/structure/grille,/obj/structure/window/reinforced{dir = 4},/obj/structure/window/reinforced{dir = 8},/turf/simulated/floor/plating,/area/debrisfield/unidentified_corvette)
"CT" = (/turf/simulated/shuttle/wall/dark/hard_corner,/area/debrisfield/unidentified_corvette)
"DG" = (/obj/structure/grille,/obj/structure/window/reinforced,/obj/structure/window/reinforced{dir = 8},/obj/structure/window/reinforced{dir = 4},/turf/simulated/floor/plating,/area/debrisfield/unidentified_corvette)
"Ef" = (/obj/structure/dispenser/oxygen,/obj/effect/floor_decal/borderfloor{dir = 5},/turf/simulated/floor/tiled/steel,/area/debrisfield/unidentified_corvette)
"Ej" = (/obj/machinery/light,/turf/simulated/floor/tiled/steel,/area/debrisfield/unidentified_corvette)
"ED" = (/mob/living/simple_mob/humanoid/merc/ranged/laser/poi,/turf/simulated/floor/tiled/steel,/area/debrisfield/unidentified_corvette)
"FM" = (/obj/structure/bed/chair/office/dark{dir = 1},/obj/effect/floor_decal/borderfloor{dir = 5},/turf/simulated/floor/tiled/steel,/area/debrisfield/unidentified_corvette)
"FP" = (/turf/simulated/shuttle/wall/dark{icon_state = "dark5"; name = "Unknown Shuttle"},/area/debrisfield/unidentified_corvette)
"FR" = (/obj/structure/closet/secure_closet/freezer/fridge,/turf/simulated/floor/tiled/steel,/area/debrisfield/unidentified_corvette)
"Ga" = (/obj/effect/floor_decal/borderfloor{dir = 5},/turf/simulated/floor/tiled/steel,/area/debrisfield/unidentified_corvette)
"Gb" = (/turf/simulated/floor/tiled/white,/area/debrisfield/unidentified_corvette)
"GD" = (/obj/structure/grille,/obj/structure/window/reinforced{dir = 1},/obj/structure/window/reinforced{dir = 8},/obj/structure/window/reinforced{dir = 4},/turf/simulated/floor/plating,/area/debrisfield/unidentified_corvette)
"Hb" = (/obj/machinery/light{dir = 4; icon_state = "tube1"; pixel_x = 0},/obj/effect/floor_decal/borderfloor{dir = 4},/turf/simulated/floor/tiled/steel,/area/debrisfield/unidentified_corvette)
"Ho" = (/obj/effect/floor_decal/borderfloor/corner,/turf/simulated/floor/tiled/steel,/area/debrisfield/unidentified_corvette)
"Ij" = (/obj/effect/floor_decal/borderfloor{dir = 10},/turf/simulated/floor/tiled/steel,/area/debrisfield/unidentified_corvette)
"IN" = (/obj/structure/table/standard,/obj/item/storage/box/masks,/obj/effect/floor_decal/corner/green/border{dir = 6; icon_state = "bordercolor"},/turf/simulated/floor/tiled/white,/area/debrisfield/unidentified_corvette)
"IU" = (/obj/effect/floor_decal/borderfloor{dir = 1},/turf/simulated/floor/tiled/steel,/area/debrisfield/unidentified_corvette)
"Jz" = (/obj/machinery/door/airlock/security{locked = 1},/turf/simulated/floor/tiled/steel,/area/debrisfield/unidentified_corvette)
"Ka" = (/obj/machinery/body_scanconsole,/obj/effect/floor_decal/corner/green/border{dir = 5; icon_state = "bordercolor"},/turf/simulated/floor/tiled/white,/area/debrisfield/unidentified_corvette)
"Kt" = (/obj/effect/floor_decal/borderfloor{dir = 4},/turf/simulated/floor/tiled/steel,/area/debrisfield/unidentified_corvette)
"Lp" = (/obj/structure/table/steel,/obj/item/gun/projectile/automatic/wt550,/obj/item/gun/projectile/automatic/p90,/turf/simulated/floor/tiled/steel_grid,/area/debrisfield/unidentified_corvette)
"LH" = (/obj/item/stool,/turf/simulated/floor/tiled/steel,/area/debrisfield/unidentified_corvette)
"LZ" = (/obj/machinery/door/airlock/glass,/turf/simulated/floor/tiled/white,/area/debrisfield/unidentified_corvette)
"MH" = (/turf/simulated/shuttle/wall/dark{icon_state = "dark0"; name = "Unknown Shuttle"},/area/debrisfield/unidentified_corvette)
"MJ" = (/obj/structure/bed,/obj/item/bedsheet,/obj/machinery/light,/turf/simulated/floor/tiled/steel,/area/debrisfield/unidentified_corvette)
"NK" = (/obj/machinery/door/airlock/security{locked = 1},/obj/effect/floor_decal/borderfloor{dir = 1},/turf/simulated/floor/tiled/steel,/area/debrisfield/unidentified_corvette)
"Og" = (/mob/living/simple_mob/mechanical/viscerator,/mob/living/simple_mob/mechanical/viscerator,/turf/simulated/floor/tiled/steel_grid,/area/debrisfield/unidentified_corvette)
"Ox" = (/obj/machinery/door/airlock/security{locked = 1},/obj/effect/floor_decal/borderfloor,/turf/simulated/floor/tiled/steel,/area/debrisfield/unidentified_corvette)
"OR" = (/obj/effect/floor_decal/borderfloor/corner{dir = 8},/turf/simulated/floor/tiled/steel,/area/debrisfield/unidentified_corvette)
"Pz" = (/obj/machinery/light{dir = 1},/turf/simulated/floor/tiled/steel,/area/debrisfield/unidentified_corvette)
"PA" = (/obj/structure/table/steel,/obj/machinery/light/small{dir = 4; pixel_y = 0},/turf/simulated/floor/tiled/yellow,/area/debrisfield/unidentified_corvette)
"PB" = (/obj/effect/floor_decal/borderfloor/corner{dir = 1},/turf/simulated/floor/tiled/steel,/area/debrisfield/unidentified_corvette)
"PS" = (/obj/machinery/door/airlock,/turf/simulated/floor/tiled/steel,/area/debrisfield/unidentified_corvette)
"Qq" = (/obj/machinery/light,/obj/structure/table/rack,/obj/item/clothing/head/helmet/space,/obj/item/clothing/head/helmet/space,/obj/item/clothing/head/helmet/space,/obj/item/clothing/head/helmet/space,/obj/item/clothing/suit/space,/obj/item/clothing/suit/space,/obj/item/clothing/suit/space,/obj/item/clothing/suit/space,/obj/effect/floor_decal/borderfloor{dir = 10},/turf/simulated/floor/tiled/steel,/area/debrisfield/unidentified_corvette)
"QO" = (/obj/structure/table/woodentable,/obj/random/projectile,/turf/simulated/floor/tiled/steel,/area/debrisfield/unidentified_corvette)
"QQ" = (/obj/effect/floor_decal/borderfloor{dir = 8},/turf/simulated/floor/tiled/steel,/area/debrisfield/unidentified_corvette)
"QZ" = (/obj/effect/floor_decal/borderfloor,/turf/simulated/floor/tiled/steel,/area/debrisfield/unidentified_corvette)
"Rd" = (/turf/simulated/floor/tiled/steel,/area/debrisfield/unidentified_corvette)
"Rw" = (/mob/living/simple_mob/mechanical/viscerator,/mob/living/simple_mob/mechanical/viscerator,/mob/living/simple_mob/mechanical/viscerator,/turf/simulated/floor/tiled/steel_grid,/area/debrisfield/unidentified_corvette)
"Sn" = (/mob/living/simple_mob/humanoid/merc/ranged/garand,/turf/simulated/floor/tiled/yellow,/area/debrisfield/unidentified_corvette)
"Sr" = (/mob/living/simple_mob/humanoid/merc/ranged/smg/poi,/turf/simulated/floor/tiled/steel,/area/debrisfield/unidentified_corvette)
"Sw" = (/obj/machinery/light/small{dir = 4; pixel_y = 0},/turf/simulated/floor/tiled/hydro,/area/debrisfield/unidentified_corvette)
"Tc" = (/obj/machinery/light{dir = 8; icon_state = "tube1"},/obj/effect/floor_decal/borderfloor{dir = 8},/turf/simulated/floor/tiled/steel,/area/debrisfield/unidentified_corvette)
"Ue" = (/obj/effect/floor_decal/borderfloor{dir = 9},/mob/living/simple_mob/humanoid/merc/ranged/laser/poi,/turf/simulated/floor/tiled/steel,/area/debrisfield/unidentified_corvette)
"Uz" = (/obj/structure/shuttle/engine/heater{dir = 4; icon_state = "heater"},/turf/simulated/shuttle/wall/dark{icon_state = "dark0"; name = "Unknown Shuttle"},/area/debrisfield/unidentified_corvette)
"UN" = (/obj/structure/table/steel,/obj/item/gun/projectile/pistol,/obj/machinery/light/small{dir = 4; pixel_y = 0},/turf/simulated/floor/tiled/steel_grid,/area/debrisfield/unidentified_corvette)
"Vc" = (/obj/effect/floor_decal/borderfloor{dir = 4},/mob/living/simple_mob/humanoid/merc/melee/sword/poi,/turf/simulated/floor/tiled/steel,/area/debrisfield/unidentified_corvette)
"Vu" = (/obj/structure/table/steel,/obj/random/toolbox,/turf/simulated/floor/tiled/yellow,/area/debrisfield/unidentified_corvette)
"VI" = (/obj/structure/table/steel,/obj/random/energy,/turf/simulated/floor/tiled/steel_grid,/area/debrisfield/unidentified_corvette)
"VQ" = (/obj/effect/decal/cleanable/blood/drip,/turf/simulated/floor/tiled/white,/area/debrisfield/unidentified_corvette)
"Wq" = (/obj/structure/shuttle/engine/heater{dir = 4; icon_state = "heater"},/turf/simulated/shuttle/wall/dark/hard_corner,/area/debrisfield/unidentified_corvette)
"Wz" = (/obj/effect/floor_decal/corner/green/border{dir = 9; icon_state = "bordercolor"},/turf/simulated/floor/tiled/white,/area/debrisfield/unidentified_corvette)
"WP" = (/turf/simulated/mineral/vacuum,/area/debrisfield/unexplored)
"WY" = (/obj/structure/table/steel,/obj/item/paper_bin,/turf/simulated/floor/tiled/steel,/area/debrisfield/unidentified_corvette)
"Xa" = (/turf/simulated/shuttle/wall/dark{icon_state = "dark6"; name = "Unknown Shuttle"},/area/debrisfield/unidentified_corvette)
"Ya" = (/obj/machinery/light{dir = 4; icon_state = "tube1"; pixel_x = 0},/obj/effect/floor_decal/borderfloor{dir = 5},/turf/simulated/floor/tiled/steel,/area/debrisfield/unidentified_corvette)
"YA" = (/obj/structure/bed/chair/office/dark,/obj/effect/floor_decal/borderfloor{dir = 6},/turf/simulated/floor/tiled/steel,/area/debrisfield/unidentified_corvette)
"YF" = (/obj/structure/closet/toolcloset,/turf/simulated/floor/tiled/yellow,/area/debrisfield/unidentified_corvette)
"YN" = (/obj/machinery/light{dir = 1},/obj/effect/floor_decal/corner/green/border{dir = 1; icon_state = "bordercolor"},/turf/simulated/floor/tiled/white,/area/debrisfield/unidentified_corvette)
"ZM" = (/obj/structure/table/steel,/obj/machinery/light/small{dir = 4; pixel_y = 0},/turf/simulated/floor/tiled/steel_grid,/area/debrisfield/unidentified_corvette)

(1,1,1) = {"
ninininininininininininininininininininininininininininininininininini
nininininininininininininiakakyzyzakakakakakaknininininininininininini
nininininininininiakakakakakakyzyzakakakakakakakakakakakakyzninininini
nininininininiakakakakakakakyzyzakakakakakakakakakakakakakyzyznininini
nininininiyzyzyzakakakakakakakakakakakakakakakakakakakakakyzyznininini
ninininiakakyzyzyzakakakakakakakakakakakakakakakakakakakakakyznininini
ninininiakakakyzyzakakakakakakakakakakakakakakakakakakakakakakakninini
ninininiakakakakXaMHMHCTsTakakakakakakakakakakakaksTCTMHMHCTsTakninini
ninininiakakakakMHMHMHCTCTMHMHMHMHakakMHMHMHMHMHMHCTCTMHMHMHUzAininini
ninininiakakakakMHMHMHMHMHMHyCEfMHcacaMHWzcAYNnAKaMHMHMHMHMHUzAininini
ninininiakakakakFPMHMHwdLpMHQQkTMHddddMHaNkheZGbGbGblMMHMHpXakakninini
ninininiakakakakXaMHMHRwZMMHQQcCAhIUGaMHaNVQVQGbiheZpjMHpXakakakninini
ninininiakakaksTCTACMHwdzdMHQQHolhQZyFMHfCcBGblfaEhAINMHakakakakninini
ninininiakakXaCTCTFMMHJzMHMHQQKtCTMHMHMHMHMHLZMHMHMHMHMHhsakakakaknini
ninininiakakMHyuPzKtMHUeIUIUPBKtMHFRBtRdPzRdRdEDMHVuVuPACTsTakakaknini
ninininiakakGDqcRdKtMHTcRdRdRdHbMHRdRdLHLHLHRdRdMHeuRdRddTWqAiakaknini
ninininiakakByqcAvcCNKPBRdtnRdRdJzRdRdarzDzDRdRdPSRdRdRdSnUzAiakaknini
ninininiakakByqcRdHoOxORRdRdRdRdJzRdRdzDzDzDRdRdPSRdRdRddTUzAiakaknini
ninininiakakDGqcRdKtMHTcRdRdRdHbMHRdRdLHLHLHRdRdMHdTRdRdnvWqAiakaknini
ninininiakakMHvvEjKtMHIjQZQZORgxMHzDWYRdEjSrRdRdMHYFsneTCTsTakakaknini
ninininiakakFPCTCTYAMHJzMHMHQQKtCTMHMHMHMHMHqAMHMHMHMHMHpXakakakaknini
ninininiakakaksTCTACMHwdwnMHQQwxAhIUYaMHjyRdRdRdRddGdyMHakakakakaknini
ninininiakakakakFPMHMHdAUNMHQQHoAhQZzSMHckRdjyRdjyMHSwMHhsakakakaknini
nininiakakakakakXaMHMHOgVIMHQQVcMHddddMHjyRdjyRdjyMHzhMHMHhsakakaknini
nininiakakakakakCTMHMHMHMHMHQqewMHcacaMHjyQOMJdWAYMHMHMHMHUzAiakninini
nininiakakakakakCTCTMHCTCTMHMHMHMHakakMHMHMHMHMHCTCTMHMHMHUzAiakninini
nininiakakakakaksTCTMHCTsTakakakakakakakakakakaksTCTMHMHCTsTakakninini
nininiakyzakakakakakakakakakakakakakakakakakakakakakakakakyzyzyzninini
niniakyzyzakakakakakakakakakakakakakakakakakakakakakakakyzyzyzyzninini
niniyzyzyzakakakakakakakakakakakakakakakakakakyzyzakakakyzyzyzyzninini
nininiyzyzakakakakyzakakakakakakakakakakakakyzyzyzakakakakyzyznininini
ninininiakakakakyzyzakakakakakakakakakakakyzyzyzakakakakaknininininini
ninininininiakyzyzyzakakakakakakakakakakyzyzyzyzakakninininininininini
ninininininininiWPyzakakakakakakakakakakakniniWPninininininininininini
ninininininininininininininininininininininininininininininininininini
"}
