//MAP CONVERTED BY dmm2tgm.py THIS HEADER COMMENT PREVENTS RECONVERSION, DO NOT REMOVE
"aa" = (
/obj/machinery/atmospherics/pipe/simple/visible/yellow,
/turf/simulated/floor/plating,
/area/engineering/engine_room)
"ab" = (
/obj/machinery/fusion_fuel_injector/mapped{
	id_tag = "engine-i"
	},
/turf/simulated/floor/plating,
/area/engineering/engine_room)
"ad" = (
/obj/machinery/camera/network/engine{
	dir = 1
	},
/turf/simulated/floor/plating,
/area/engineering/engine_room)
"af" = (
/obj/machinery/computer/fusion_fuel_control{
	id_tag = "engine-i"
	},
/turf/template_noop,
/area/template_noop)
"ah" = (
/obj/machinery/atmospherics/component/unary/outlet_injector{
	dir = 8;
	frequency = 1438;
	id = "cooling_in";
	use_power = 1
	},
/turf/simulated/floor/greengrid/airless,
/area/engineering/engine_room)
"ai" = (
/obj/machinery/light{
	dir = 8;
	light_range = 12
	},
/obj/machinery/atmospherics/pipe/simple/visible/red,
/turf/simulated/floor/plating,
/area/engineering/engine_room)
"aj" = (
/obj/structure/cable/cyan{
	icon_state = "4-8"
	},
/obj/machinery/power/emitter/gyrotron/anchored{
	id_tag = "engine-g"
	},
/obj/structure/cable/cyan{
	icon_state = "0-4"
	},
/turf/simulated/floor/plating,
/area/engineering/engine_room)
"al" = (
/obj/machinery/atmospherics/pipe/simple/visible/red,
/obj/machinery/atmospherics/pipe/simple/visible/yellow{
	dir = 4
	},
/turf/simulated/floor/plating,
/area/engineering/engine_room)
"am" = (
/obj/machinery/atmospherics/component/binary/circulator{
	anchored = 1;
	dir = 8
	},
/turf/simulated/floor,
/area/engineering/engine_room)
"an" = (
/obj/machinery/atmospherics/pipe/manifold/visible/red{
	dir = 1
	},
/turf/simulated/floor/plating,
/area/engineering/engine_room)
"ap" = (
/obj/machinery/atmospherics/pipe/manifold/visible/red{
	dir = 4
	},
/turf/simulated/floor/plating,
/area/engineering/engine_room)
"ar" = (
/obj/machinery/atmospherics/pipe/simple/visible/red,
/turf/simulated/floor/plating,
/area/engineering/engine_room)
"as" = (
/obj/machinery/atmospherics/pipe/simple/visible/yellow{
	dir = 4
	},
/turf/simulated/floor/plating,
/area/engineering/engine_room)
"at" = (
/obj/machinery/atmospherics/pipe/simple/visible/yellow{
	dir = 6
	},
/turf/simulated/floor/reinforced/airless,
/area/engineering/engine_room)
"au" = (
/obj/machinery/computer/fusion_core_control{
	id_tag = "engine"
	},
/turf/template_noop,
/area/template_noop)
"av" = (
/obj/machinery/atmospherics/pipe/simple/visible/red{
	dir = 9
	},
/turf/simulated/floor/plating,
/area/engineering/engine_room)
"aw" = (
/obj/structure/cable/yellow{
	icon_state = "1-2"
	},
/turf/simulated/floor/plating,
/area/engineering/engine_room)
"ax" = (
/obj/machinery/atmospherics/pipe/manifold/visible/yellow{
	dir = 4
	},
/turf/simulated/floor/reinforced/airless,
/area/engineering/engine_room)
"ay" = (
/turf/simulated/floor/reinforced/airless,
/area/engineering/engine_room)
"aB" = (
/turf/template_noop,
/area/template_noop)
"aC" = (
/obj/machinery/air_alarm/east_mount,
/turf/simulated/floor/plating,
/area/engineering/engine_room)
"aD" = (
/obj/machinery/atmospherics/pipe/simple/visible/red{
	dir = 9
	},
/turf/simulated/floor/reinforced/airless,
/area/engineering/engine_room)
"aE" = (
/obj/machinery/atmospherics/pipe/simple/visible/red{
	dir = 8
	},
/obj/machinery/camera/network/engine,
/turf/simulated/floor/plating,
/area/engineering/engine_room)
"aF" = (
/obj/structure/cable/cyan{
	icon_state = "4-8"
	},
/obj/machinery/light,
/turf/simulated/floor/plating,
/area/engineering/engine_room)
"aH" = (
/obj/machinery/button/remote/blast_door{
	pixel_x = 6;
	pixel_y = 0;
	id = "EngineRadiatorViewport"
	},
/obj/item/book/manual/rust_engine,
/turf/template_noop,
/area/template_noop)
"aI" = (
/obj/structure/cable/cyan{
	icon_state = "1-2"
	},
/obj/machinery/atmospherics/pipe/simple/visible/yellow{
	dir = 4
	},
/turf/simulated/floor/plating,
/area/engineering/engine_room)
"aY" = (
/obj/machinery/atmospherics/pipe/simple/visible/cyan,
/obj/machinery/atmospherics/pipe/simple/visible/yellow{
	dir = 4
	},
/turf/simulated/floor/plating,
/area/engineering/engine_room)
"ck" = (
/obj/machinery/atmospherics/pipe/simple/visible/red{
	dir = 6
	},
/turf/simulated/floor/plating,
/area/engineering/engine_room)
"cx" = (
/obj/machinery/atmospherics/pipe/simple/visible/red{
	dir = 8
	},
/turf/simulated/floor/plating,
/area/engineering/engine_room)
"dB" = (
/turf/simulated/floor/plating,
/area/engineering/engine_room)
"dG" = (
/obj/structure/cable/cyan{
	icon_state = "0-4"
	},
/obj/machinery/light,
/turf/simulated/floor/plating,
/area/engineering/engine_room)
"dV" = (
/obj/structure/cable/yellow{
	icon_state = "1-4"
	},
/turf/simulated/floor/plating,
/area/engineering/engine_room)
"eD" = (
/obj/machinery/atmospherics/component/unary/vent_pump/high_volume{
	frequency = 1438;
	id_tag = "cooling_out";
	pump_direction = 0;
	on = 1
	},
/turf/simulated/floor/reinforced/airless,
/area/engineering/engine_room)
"fm" = (
/obj/structure/cable/yellow{
	icon_state = "1-2"
	},
/obj/machinery/atmospherics/pipe/simple/visible/green,
/turf/simulated/floor/plating,
/area/engineering/engine_room)
"fn" = (
/obj/machinery/atmospherics/pipe/simple/visible/green{
	dir = 5
	},
/turf/simulated/floor/plating,
/area/engineering/engine_room)
"fN" = (
/obj/machinery/atmospherics/pipe/simple/visible/cyan{
	dir = 4
	},
/turf/simulated/floor/plating,
/area/engineering/engine_room)
"gr" = (
/obj/machinery/air_alarm/south_mount,
/turf/simulated/floor/plating,
/area/engineering/engine_room)
"gu" = (
/obj/machinery/air_sensor{
	frequency = 1438;
	id_tag = "engine_sensor";
	output = 63
	},
/turf/simulated/floor/reinforced/airless,
/area/engineering/engine_room)
"hP" = (
/obj/structure/cable/cyan{
	icon_state = "0-2"
	},
/turf/simulated/floor/plating,
/area/engineering/engine_room)
"hZ" = (
/obj/machinery/fire_alarm/east_mount{
	pixel_y = 8
	},
/turf/simulated/floor/plating,
/area/engineering/engine_room)
"iE" = (
/obj/machinery/atmospherics/pipe/simple/visible/green{
	dir = 4
	},
/obj/machinery/atmospherics/pipe/simple/visible/red,
/turf/simulated/floor/plating,
/area/engineering/engine_room)
"jf" = (
/turf/simulated/wall/r_wall/prepainted/engineering,
/area/engineering/engine_room)
"km" = (
/obj/structure/cable/cyan{
	icon_state = "1-2"
	},
/turf/simulated/floor/plating,
/area/engineering/engine_room)
"kt" = (
/turf/simulated/floor/greengrid/airless,
/area/engineering/engine_room)
"kv" = (
/obj/machinery/atmospherics/pipe/simple/visible/red{
	dir = 8
	},
/obj/machinery/meter,
/turf/simulated/floor/plating,
/area/engineering/engine_room)
"kJ" = (
/obj/structure/cable/cyan{
	icon_state = "2-4"
	},
/obj/structure/cable/cyan{
	icon_state = "1-4"
	},
/turf/simulated/floor/plating,
/area/engineering/engine_room)
"kW" = (
/obj/structure/cable/yellow{
	icon_state = "1-2"
	},
/obj/structure/cable/yellow{
	icon_state = "2-8"
	},
/obj/machinery/atmospherics/pipe/simple/visible/green,
/turf/simulated/floor/plating,
/area/engineering/engine_room)
"lC" = (
/obj/machinery/atmospherics/pipe/simple/visible/green{
	dir = 4
	},
/obj/machinery/fire_alarm/north_mount,
/turf/simulated/floor/plating,
/area/engineering/engine_room)
"nf" = (
/obj/machinery/atmospherics/pipe/manifold/visible/yellow{
	dir = 8
	},
/obj/machinery/meter,
/turf/simulated/floor/plating,
/area/engineering/engine_room)
"nl" = (
/obj/structure/cable/yellow{
	icon_state = "1-2"
	},
/obj/machinery/atmospherics/pipe/simple/visible/green{
	dir = 9
	},
/turf/simulated/floor/plating,
/area/engineering/engine_room)
"op" = (
/obj/machinery/atmospherics/pipe/simple/visible/red,
/obj/machinery/meter,
/turf/simulated/floor/plating,
/area/engineering/engine_room)
"os" = (
/obj/machinery/atmospherics/component/binary/circulator{
	anchored = 1;
	dir = 4
	},
/turf/simulated/floor,
/area/engineering/engine_room)
"oN" = (
/obj/machinery/atmospherics/pipe/manifold/visible/green{
	dir = 1
	},
/turf/simulated/floor/plating,
/area/engineering/engine_room)
"pp" = (
/obj/machinery/atmospherics/pipe/simple/visible/green{
	dir = 4
	},
/turf/simulated/floor/plating,
/area/engineering/engine_room)
"qB" = (
/obj/machinery/atmospherics/component/binary/pump{
	dir = 4
	},
/turf/simulated/floor/plating,
/area/engineering/engine_room)
"rM" = (
/obj/fiftyspawner/tritium,
/obj/fiftyspawner/tritium,
/obj/structure/window/reinforced{
	dir = 4
	},
/obj/structure/table/reinforced,
/turf/simulated/floor/bluegrid,
/area/engineering/engine_room)
"rX" = (
/obj/structure/cable/yellow{
	icon_state = "2-4"
	},
/turf/simulated/floor/plating,
/area/engineering/engine_room)
"ss" = (
/obj/machinery/atmospherics/pipe/simple/visible/green,
/obj/machinery/atmospherics/pipe/simple/visible/yellow{
	dir = 4
	},
/turf/simulated/floor/plating,
/area/engineering/engine_room)
"sH" = (
/obj/machinery/atmospherics/pipe/manifold/visible/cyan{
	dir = 4
	},
/obj/machinery/meter,
/turf/simulated/floor/plating,
/area/engineering/engine_room)
"te" = (
/obj/structure/cable/cyan{
	icon_state = "4-8"
	},
/obj/spawner/window/borosillicate/full,
/turf/simulated/floor/plating,
/area/engineering/engine_room)
"ue" = (
/obj/machinery/atmospherics/pipe/simple/visible/green,
/obj/machinery/atmospherics/pipe/simple/visible/red{
	dir = 8
	},
/turf/simulated/floor/plating,
/area/engineering/engine_room)
"uR" = (
/obj/structure/cable/yellow{
	icon_state = "4-8"
	},
/obj/machinery/fusion_fuel_injector/mapped{
	dir = 1;
	id_tag = "engine-i"
	},
/turf/simulated/floor/plating,
/area/engineering/engine_room)
"vj" = (
/obj/machinery/light{
	dir = 4
	},
/turf/simulated/floor/plating,
/area/engineering/engine_room)
"vV" = (
/obj/machinery/light{
	dir = 8;
	light_range = 12
	},
/turf/simulated/floor/plating,
/area/engineering/engine_room)
"wb" = (
/obj/machinery/atmospherics/pipe/simple/visible/cyan{
	dir = 4
	},
/obj/machinery/atmospherics/pipe/simple/visible/green,
/turf/simulated/floor/plating,
/area/engineering/engine_room)
"wJ" = (
/obj/structure/cable/yellow{
	icon_state = "4-8"
	},
/turf/simulated/floor/plating,
/area/engineering/engine_room)
"wL" = (
/obj/machinery/atmospherics/pipe/manifold/visible/green{
	dir = 8
	},
/turf/simulated/floor/plating,
/area/engineering/engine_room)
"wR" = (
/obj/structure/cable/cyan{
	icon_state = "4-8"
	},
/obj/machinery/light{
	dir = 1
	},
/turf/simulated/floor/plating,
/area/engineering/engine_room)
"xg" = (
/obj/structure/cable/yellow{
	icon_state = "4-8"
	},
/obj/machinery/atmospherics/pipe/simple/visible/red,
/turf/simulated/floor/plating,
/area/engineering/engine_room)
"xH" = (
/obj/machinery/atmospherics/component/unary/outlet_injector{
	dir = 8;
	frequency = 1438;
	id = "cooling_in";
	use_power = 1
	},
/turf/simulated/floor/reinforced/airless,
/area/engineering/engine_room)
"xM" = (
/turf/template_noop,
/area/space)
"yw" = (
/obj/structure/cable/yellow{
	icon_state = "1-8"
	},
/turf/simulated/floor/plating,
/area/engineering/engine_room)
"Ab" = (
/obj/machinery/atmospherics/pipe/simple/visible/cyan{
	dir = 4
	},
/obj/machinery/atmospherics/pipe/simple/visible/red,
/turf/simulated/floor/plating,
/area/engineering/engine_room)
"CC" = (
/obj/machinery/atmospherics/pipe/simple/visible/red,
/obj/spawner/window/borosillicate/full,
/turf/simulated/floor/plating,
/area/engineering/engine_room)
"CN" = (
/obj/structure/cable/yellow{
	icon_state = "1-2"
	},
/obj/machinery/atmospherics/pipe/manifold/visible/green{
	dir = 4
	},
/turf/simulated/floor/plating,
/area/engineering/engine_room)
"Dw" = (
/obj/structure/cable/cyan{
	icon_state = "4-8"
	},
/obj/machinery/atmospherics/pipe/simple/visible/red,
/turf/simulated/floor/plating,
/area/engineering/engine_room)
"DB" = (
/obj/machinery/atmospherics/pipe/simple/visible/red{
	dir = 5
	},
/turf/simulated/floor/reinforced/airless,
/area/engineering/engine_room)
"EG" = (
/obj/machinery/camera/network/engine{
	dir = 8
	},
/turf/simulated/floor/plating,
/area/engineering/engine_room)
"EH" = (
/obj/machinery/computer/gyrotron_control{
	id_tag = "engine-g"
	},
/turf/template_noop,
/area/template_noop)
"FL" = (
/obj/machinery/atmospherics/pipe/simple/visible/yellow{
	dir = 9
	},
/turf/simulated/floor/plating,
/area/engineering/engine_room)
"FN" = (
/obj/machinery/atmospherics/pipe/simple/visible/cyan{
	dir = 10
	},
/turf/simulated/floor/plating,
/area/engineering/engine_room)
"Gf" = (
/obj/machinery/atmospherics/pipe/simple/visible/green{
	dir = 10
	},
/turf/simulated/floor/plating,
/area/engineering/engine_room)
"Gq" = (
/obj/spawner/window/borosillicate/full,
/turf/simulated/floor/plating,
/area/engineering/engine_room)
"GE" = (
/obj/machinery/atmospherics/pipe/simple/visible/red,
/obj/machinery/air_alarm/west_mount,
/turf/simulated/floor/plating,
/area/engineering/engine_room)
"GL" = (
/obj/machinery/atmospherics/pipe/simple/visible/cyan{
	dir = 9
	},
/turf/simulated/floor/plating,
/area/engineering/engine_room)
"GQ" = (
/obj/fiftyspawner/deuterium,
/obj/fiftyspawner/deuterium,
/obj/fiftyspawner/deuterium,
/obj/fiftyspawner/deuterium,
/obj/fiftyspawner/deuterium,
/obj/structure/window/reinforced{
	dir = 8
	},
/obj/structure/table/reinforced,
/turf/simulated/floor/bluegrid,
/area/engineering/engine_room)
"HO" = (
/obj/machinery/atmospherics/pipe/manifold/visible/red{
	dir = 1
	},
/turf/simulated/floor/reinforced/airless,
/area/engineering/engine_room)
"HR" = (
/obj/machinery/atmospherics/portables_connector{
	dir = 8
	},
/obj/effect/floor_decal/industrial/outline/red,
/turf/simulated/floor/plating,
/area/engineering/engine_room)
"Ie" = (
/obj/machinery/door/blast/regular{
	density = 0;
	icon_state = "pdoor0";
	id = "EngineRadiatorViewport";
	name = "Engine Radiator Viewport Shutter";
	opacity = 0
	},
/turf/simulated/floor/plating,
/area/engineering/engine_room)
"Ip" = (
/obj/structure/cable/cyan{
	icon_state = "0-4"
	},
/obj/machinery/light{
	dir = 1
	},
/turf/simulated/floor/plating,
/area/engineering/engine_room)
"Jy" = (
/obj/machinery/atmospherics/portables_connector{
	dir = 8
	},
/obj/effect/floor_decal/industrial/outline/blue,
/turf/simulated/floor/plating,
/area/engineering/engine_room)
"JP" = (
/obj/structure/cable/cyan{
	icon_state = "1-2"
	},
/obj/machinery/atmospherics/pipe/simple/visible/cyan,
/turf/simulated/floor/plating,
/area/engineering/engine_room)
"Kb" = (
/obj/structure/cable/cyan{
	icon_state = "1-8"
	},
/turf/simulated/floor/plating,
/area/engineering/engine_room)
"Ki" = (
/obj/machinery/atmospherics/pipe/simple/visible/green{
	dir = 6
	},
/turf/simulated/floor/plating,
/area/engineering/engine_room)
"Kt" = (
/obj/machinery/computer/general_air_control/supermatter_core{
	dir = 1;
	frequency = 1438;
	input_tag = "cooling_in";
	name = "Engine Cooling Control";
	output_tag = "cooling_out";
	pressure_setting = 100;
	sensors = list("engine_sensor"="Engine Core")
	},
/turf/template_noop,
/area/template_noop)
"Ll" = (
/obj/machinery/atmospherics/pipe/simple/visible/yellow{
	dir = 4
	},
/obj/spawner/window/borosillicate/full,
/turf/simulated/floor/plating,
/area/engineering/engine_room)
"Ln" = (
/obj/structure/cable/yellow{
	icon_state = "1-2"
	},
/obj/machinery/atmospherics/pipe/simple/visible/cyan{
	dir = 4
	},
/obj/machinery/atmospherics/pipe/simple/visible/green,
/turf/simulated/floor/plating,
/area/engineering/engine_room)
"LQ" = (
/obj/machinery/atmospherics/pipe/simple/visible/yellow{
	dir = 5
	},
/turf/simulated/floor/reinforced/airless,
/area/engineering/engine_room)
"LT" = (
/obj/effect/floor_decal/industrial/warning,
/turf/simulated/floor/plating,
/area/engineering/engine_room)
"Mh" = (
/obj/machinery/atmospherics/pipe/simple/visible/yellow{
	dir = 10
	},
/turf/simulated/floor/plating,
/area/engineering/engine_room)
"MW" = (
/obj/structure/cable/cyan{
	icon_state = "4-8"
	},
/turf/simulated/floor/reinforced/airless,
/area/engineering/engine_room)
"Nc" = (
/obj/machinery/atmospherics/pipe/simple/visible/green,
/turf/simulated/floor/plating,
/area/engineering/engine_room)
"NM" = (
/obj/structure/cable/cyan{
	icon_state = "4-8"
	},
/obj/machinery/power/emitter/gyrotron/anchored{
	dir = 1;
	id_tag = "engine-g"
	},
/obj/structure/cable/cyan{
	icon_state = "0-4"
	},
/turf/simulated/floor/plating,
/area/engineering/engine_room)
"PT" = (
/obj/structure/cable/yellow{
	icon_state = "1-2"
	},
/obj/machinery/atmospherics/pipe/simple/visible/green,
/obj/machinery/atmospherics/pipe/simple/visible/yellow{
	dir = 4
	},
/turf/simulated/floor/plating,
/area/engineering/engine_room)
"Qk" = (
/obj/machinery/fusion_fuel_compressor,
/obj/machinery/light,
/turf/simulated/floor/bluegrid,
/area/engineering/engine_room)
"Qv" = (
/obj/machinery/atmospherics/component/unary/vent_pump/high_volume{
	frequency = 1438;
	id_tag = "cooling_out";
	pump_direction = 0;
	on = 1
	},
/turf/simulated/floor/greengrid/airless,
/area/engineering/engine_room)
"Ru" = (
/obj/machinery/fire_alarm/west_mount,
/turf/simulated/floor/plating,
/area/engineering/engine_room)
"RC" = (
/obj/structure/cable/cyan{
	icon_state = "4-8"
	},
/turf/simulated/floor/plating,
/area/engineering/engine_room)
"Sg" = (
/obj/structure/cable/cyan{
	icon_state = "1-2"
	},
/obj/structure/cable/cyan{
	icon_state = "1-8"
	},
/turf/simulated/floor/plating,
/area/engineering/engine_room)
"SQ" = (
/obj/structure/cable/cyan,
/turf/simulated/floor/plating,
/area/engineering/engine_room)
"Tf" = (
/obj/structure/cable/yellow{
	icon_state = "2-8"
	},
/obj/machinery/atmospherics/pipe/simple/visible/green,
/obj/machinery/meter,
/turf/simulated/floor/plating,
/area/engineering/engine_room)
"Ua" = (
/obj/structure/cable/yellow{
	icon_state = "0-4"
	},
/obj/machinery/power/generator{
	anchored = 1
	},
/turf/simulated/floor,
/area/engineering/engine_room)
"UA" = (
/obj/machinery/atmospherics/component/binary/pump/high_power,
/turf/simulated/floor/plating,
/area/engineering/engine_room)
"Vg" = (
/obj/machinery/atmospherics/pipe/simple/visible/cyan,
/turf/simulated/floor/plating,
/area/engineering/engine_room)
"Vh" = (
/obj/machinery/atmospherics/pipe/simple/visible/red,
/obj/machinery/light{
	dir = 8;
	light_range = 12
	},
/turf/simulated/floor/plating,
/area/engineering/engine_room)
"WF" = (
/obj/machinery/power/fusion_core{
	id_tag = "engine";
	anchored = 1
	},
/obj/structure/cable/cyan{
	icon_state = "0-4"
	},
/turf/simulated/floor/greengrid/airless,
/area/engineering/engine_room)
"XM" = (
/obj/structure/cable/cyan{
	icon_state = "4-8"
	},
/obj/structure/cable/yellow{
	icon_state = "1-2"
	},
/turf/simulated/floor/plating,
/area/engineering/engine_room)
"Ye" = (
/obj/machinery/atmospherics/pipe/simple/visible/red{
	dir = 5
	},
/turf/simulated/floor/plating,
/area/engineering/engine_room)
"Yy" = (
/obj/machinery/atmospherics/pipe/simple/visible/cyan{
	dir = 4
	},
/obj/machinery/atmospherics/pipe/simple/visible/yellow,
/turf/simulated/floor/plating,
/area/engineering/engine_room)
"YK" = (
/obj/machinery/atmospherics/component/binary/pump{
	dir = 8
	},
/turf/simulated/floor/plating,
/area/engineering/engine_room)
"Zi" = (
/turf/simulated/wall/r_wall/prepainted,
/area/engineering/engine_room)
"ZF" = (
/obj/structure/cable/cyan{
	icon_state = "2-8"
	},
/turf/simulated/floor/plating,
/area/engineering/engine_room)

(1,1,1) = {"
xM
xM
xM
xM
xM
xM
jf
jf
jf
jf
jf
jf
jf
jf
jf
jf
jf
jf
jf
xM
xM
xM
"}
(2,1,1) = {"
xM
xM
xM
xM
xM
xM
jf
ck
Ye
Ru
Ki
fn
vV
ck
Ye
dB
Ki
fn
jf
xM
xM
xM
"}
(3,1,1) = {"
xM
xM
xM
xM
xM
xM
jf
aE
os
Ua
am
pp
dB
cx
os
Ua
am
pp
jf
xM
xM
xM
"}
(4,1,1) = {"
aB
aB
Ie
Ie
Ie
jf
jf
cx
as
wJ
fN
pp
dB
cx
as
wJ
fN
pp
jf
jf
jf
jf
"}
(5,1,1) = {"
aB
aB
pp
ck
Ab
GE
ai
ap
al
xg
Ab
iE
op
ap
al
xg
Ab
iE
Vh
GE
Ye
Ru
"}
(6,1,1) = {"
aB
aB
oN
ue
wb
Nc
Nc
Nc
ss
Tf
Ln
CN
fm
fm
PT
kW
Ln
nl
dV
dB
cx
dB
"}
(7,1,1) = {"
aB
aB
lC
cx
fN
dB
dB
dB
Mh
aa
Yy
aa
nf
aa
FL
dB
fN
dB
wJ
dB
cx
dB
"}
(8,1,1) = {"
aH
aB
pp
cx
FN
UA
Vg
Vg
Vg
Vg
sH
Vg
aY
Vg
Vg
Vg
GL
dB
wJ
dB
cx
dB
"}
(9,1,1) = {"
af
aB
pp
cx
dB
dB
dB
dB
hP
km
km
km
aI
km
JP
JP
SQ
dB
wJ
dB
cx
dB
"}
(10,1,1) = {"
au
aB
pp
cx
dB
dB
dB
dG
Zi
Gq
Gq
Gq
Ll
Gq
Gq
Gq
Zi
Ip
wJ
dB
cx
dB
"}
(11,1,1) = {"
EH
aB
pp
an
Ye
dB
dB
RC
Gq
ay
kt
at
ax
LQ
kt
ay
Gq
RC
wJ
dB
cx
dB
"}
(12,1,1) = {"
Kt
aB
pp
YK
qB
dB
ab
aj
Gq
kt
ay
ah
ay
xH
ay
kt
Gq
NM
uR
dB
cx
dB
"}
(13,1,1) = {"
aB
aB
pp
HR
HR
dB
dB
RC
Gq
ay
ay
ay
ay
ay
Qv
DB
Gq
RC
wJ
dB
kv
dB
"}
(14,1,1) = {"
aB
aB
Gf
wL
fn
dB
dB
RC
Gq
ay
ay
ay
WF
gu
ay
HO
CC
Dw
xg
ar
av
ad
"}
(15,1,1) = {"
aB
aB
dB
YK
qB
dB
dB
RC
Gq
ay
kt
ay
MW
ay
eD
aD
Gq
RC
wJ
dB
dB
gr
"}
(16,1,1) = {"
aB
aB
dB
Jy
Jy
dB
ab
aj
Gq
kt
ay
ay
MW
kt
ay
kt
Gq
NM
uR
dB
LT
GQ
"}
(17,1,1) = {"
aB
aB
dB
dB
dB
dB
dB
RC
Gq
ay
kt
ay
MW
ay
kt
ay
Gq
RC
wJ
dB
LT
Qk
"}
(18,1,1) = {"
aB
aB
dB
dB
dB
dB
dB
aF
Zi
Gq
Gq
Gq
te
Gq
Gq
Gq
Zi
wR
wJ
dB
LT
rM
"}
(19,1,1) = {"
aB
aB
dB
dB
dB
dB
dB
RC
dB
dB
dB
dB
RC
dB
dB
dB
dB
RC
wJ
dB
dB
dB
"}
(20,1,1) = {"
aB
aB
dB
dB
dB
dB
dB
ZF
km
km
km
kJ
Sg
km
km
km
km
Kb
wJ
dB
dB
dB
"}
(21,1,1) = {"
aB
aB
dB
vj
hZ
dB
dB
EG
aC
dB
rX
XM
aw
aw
aw
aw
aw
aw
yw
dB
dB
dB
"}
