//MAP CONVERTED BY dmm2tgm.py THIS HEADER COMMENT PREVENTS RECONVERSION, DO NOT REMOVE
"aa" = (
/obj/machinery/atmospherics/pipe/simple/visible/yellow,
/turf/simulated/floor/plating,
/area/engineering/engine_room)
"ab" = (
/obj/machinery/fusion_fuel_injector/mapped{
	id_tag = "engine-i"
	},
/turf/simulated/floor/plating,
/area/engineering/engine_room)
"ah" = (
/obj/machinery/atmospherics/pipe/simple/visible/red,
/obj/machinery/meter,
/turf/simulated/floor/plating,
/area/engineering/engine_room)
"aj" = (
/obj/structure/cable/cyan{
	icon_state = "4-8"
	},
/obj/machinery/power/emitter/gyrotron/anchored{
	id_tag = "engine-g"
	},
/obj/structure/cable/cyan{
	icon_state = "0-4"
	},
/turf/simulated/floor/plating,
/area/engineering/engine_room)
"ak" = (
/obj/structure/cable/yellow{
	icon_state = "0-4"
	},
/obj/machinery/power/generator{
	anchored = 1
	},
/turf/simulated/floor,
/area/engineering/engine_room)
"al" = (
/obj/machinery/atmospherics/pipe/simple/visible/red,
/obj/machinery/atmospherics/pipe/simple/visible/yellow{
	dir = 4
	},
/turf/simulated/floor/plating,
/area/engineering/engine_room)
"ao" = (
/obj/machinery/light{
	dir = 8;
	light_range = 12
	},
/obj/machinery/atmospherics/pipe/simple/visible/red,
/turf/simulated/floor/plating,
/area/engineering/engine_room)
"ap" = (
/obj/machinery/atmospherics/pipe/manifold/visible/red{
	dir = 4
	},
/turf/simulated/floor/plating,
/area/engineering/engine_room)
"ar" = (
/obj/machinery/atmospherics/pipe/simple/visible/red,
/turf/simulated/floor/plating,
/area/engineering/engine_room)
"as" = (
/obj/machinery/atmospherics/pipe/simple/visible/yellow{
	dir = 4
	},
/turf/simulated/floor/plating,
/area/engineering/engine_room)
"at" = (
/obj/machinery/atmospherics/pipe/simple/visible/yellow{
	dir = 6
	},
/turf/simulated/floor/reinforced/airless,
/area/engineering/engine_room)
"av" = (
/obj/machinery/atmospherics/pipe/simple/visible/red{
	dir = 9
	},
/turf/simulated/floor/plating,
/area/engineering/engine_room)
"aw" = (
/obj/structure/cable/yellow{
	icon_state = "1-2"
	},
/turf/simulated/floor/plating,
/area/engineering/engine_room)
"ax" = (
/obj/machinery/atmospherics/pipe/manifold/visible/yellow{
	dir = 4
	},
/turf/simulated/floor/reinforced/airless,
/area/engineering/engine_room)
"ay" = (
/obj/machinery/atmospherics/pipe/simple/heat_exchanging{
	dir = 10
	},
/turf/template_noop,
/area/space)
"aB" = (
/obj/structure/cable/cyan{
	icon_state = "4-8"
	},
/obj/machinery/power/emitter/gyrotron/anchored{
	dir = 1;
	id_tag = "engine-g"
	},
/obj/structure/cable/cyan{
	icon_state = "0-4"
	},
/turf/simulated/floor/plating,
/area/engineering/engine_room)
"aF" = (
/obj/structure/cable/cyan{
	icon_state = "4-8"
	},
/obj/machinery/light,
/turf/simulated/floor/plating,
/area/engineering/engine_room)
"aI" = (
/obj/machinery/air_alarm/east_mount,
/turf/simulated/floor/plating,
/area/engineering/engine_room)
"aJ" = (
/turf/simulated/floor/greengrid/airless,
/area/engineering/engine_room)
"ck" = (
/obj/machinery/atmospherics/pipe/simple/visible/red{
	dir = 6
	},
/turf/simulated/floor/plating,
/area/engineering/engine_room)
"cx" = (
/obj/machinery/atmospherics/pipe/simple/visible/red{
	dir = 8
	},
/turf/simulated/floor/plating,
/area/engineering/engine_room)
"dB" = (
/turf/simulated/floor/plating,
/area/engineering/engine_room)
"dG" = (
/obj/structure/cable/cyan{
	icon_state = "0-4"
	},
/obj/machinery/light,
/turf/simulated/floor/plating,
/area/engineering/engine_room)
"dV" = (
/obj/structure/cable/yellow{
	icon_state = "1-4"
	},
/turf/simulated/floor/plating,
/area/engineering/engine_room)
"ev" = (
/obj/structure/cable/yellow{
	icon_state = "1-2"
	},
/obj/machinery/atmospherics/pipe/simple/visible/green,
/turf/simulated/floor/plating,
/area/engineering/engine_room)
"eD" = (
/obj/machinery/atmospherics/component/unary/vent_pump/high_volume{
	frequency = 1438;
	id_tag = "cooling_out";
	pump_direction = 0;
	on = 1
	},
/turf/simulated/floor/reinforced/airless,
/area/engineering/engine_room)
"fd" = (
/obj/machinery/computer/gyrotron_control{
	id_tag = "engine-g"
	},
/turf/template_noop,
/area/template_noop)
"fm" = (
/obj/machinery/atmospherics/component/unary/outlet_injector{
	dir = 8;
	frequency = 1438;
	id = "cooling_in";
	use_power = 1
	},
/turf/simulated/floor/reinforced/airless,
/area/engineering/engine_room)
"fn" = (
/obj/machinery/atmospherics/component/binary/pump{
	dir = 4
	},
/turf/simulated/floor/plating,
/area/engineering/engine_room)
"fN" = (
/obj/machinery/atmospherics/pipe/simple/visible/cyan{
	dir = 4
	},
/turf/simulated/floor/plating,
/area/engineering/engine_room)
"gr" = (
/obj/machinery/camera/network/engine{
	dir = 1
	},
/turf/simulated/floor/plating,
/area/engineering/engine_room)
"hP" = (
/obj/structure/cable/cyan{
	icon_state = "0-2"
	},
/turf/simulated/floor/plating,
/area/engineering/engine_room)
"hZ" = (
/obj/machinery/fire_alarm/east_mount{
	pixel_y = 8
	},
/turf/simulated/floor/plating,
/area/engineering/engine_room)
"ij" = (
/obj/machinery/air_alarm/south_mount,
/turf/simulated/floor/plating,
/area/engineering/engine_room)
"iy" = (
/obj/structure/cable/yellow{
	icon_state = "1-2"
	},
/obj/structure/cable/yellow{
	icon_state = "2-8"
	},
/obj/machinery/atmospherics/pipe/simple/visible/green,
/turf/simulated/floor/plating,
/area/engineering/engine_room)
"jf" = (
/turf/simulated/wall/r_wall/prepainted/engineering,
/area/engineering/engine_room)
"kB" = (
/obj/machinery/atmospherics/pipe/simple/visible/green,
/obj/machinery/atmospherics/pipe/simple/visible/red{
	dir = 8
	},
/turf/simulated/floor/plating,
/area/engineering/engine_room)
"kF" = (
/obj/machinery/atmospherics/pipe/simple/visible/cyan,
/obj/machinery/atmospherics/pipe/simple/visible/yellow{
	dir = 4
	},
/turf/simulated/floor/plating,
/area/engineering/engine_room)
"kP" = (
/turf/simulated/floor/reinforced/airless,
/area/engineering/engine_room)
"kR" = (
/obj/machinery/atmospherics/pipe/simple/visible/red{
	dir = 5
	},
/turf/simulated/floor/reinforced/airless,
/area/engineering/engine_room)
"kW" = (
/obj/structure/cable/yellow{
	icon_state = "1-2"
	},
/obj/machinery/atmospherics/pipe/simple/visible/cyan{
	dir = 4
	},
/obj/machinery/atmospherics/pipe/simple/visible/green,
/turf/simulated/floor/plating,
/area/engineering/engine_room)
"lC" = (
/obj/machinery/atmospherics/pipe/simple/visible/green{
	dir = 4
	},
/obj/machinery/fire_alarm/north_mount,
/turf/simulated/floor/plating,
/area/engineering/engine_room)
"mu" = (
/obj/machinery/fusion_fuel_compressor,
/obj/machinery/light,
/turf/simulated/floor/bluegrid,
/area/engineering/engine_room)
"mF" = (
/obj/machinery/atmospherics/pipe/simple/heat_exchanging{
	dir = 9
	},
/turf/template_noop,
/area/space)
"mX" = (
/obj/machinery/power/fusion_core{
	id_tag = "engine";
	anchored = 1
	},
/obj/structure/cable/cyan{
	icon_state = "0-4"
	},
/turf/simulated/floor/greengrid/airless,
/area/engineering/engine_room)
"nf" = (
/obj/structure/cable/cyan{
	icon_state = "0-4"
	},
/obj/machinery/light{
	dir = 1
	},
/turf/simulated/floor/plating,
/area/engineering/engine_room)
"nl" = (
/obj/structure/cable/yellow{
	icon_state = "1-2"
	},
/obj/machinery/atmospherics/pipe/simple/visible/green{
	dir = 9
	},
/turf/simulated/floor/plating,
/area/engineering/engine_room)
"nq" = (
/obj/structure/cable/cyan{
	icon_state = "4-8"
	},
/obj/machinery/atmospherics/pipe/simple/visible/red,
/turf/simulated/floor/plating,
/area/engineering/engine_room)
"op" = (
/obj/machinery/atmospherics/pipe/manifold/visible/yellow{
	dir = 8
	},
/obj/machinery/meter,
/turf/simulated/floor/plating,
/area/engineering/engine_room)
"os" = (
/obj/machinery/atmospherics/pipe/simple/visible/red{
	dir = 5
	},
/turf/simulated/floor/plating,
/area/engineering/engine_room)
"oN" = (
/obj/machinery/atmospherics/pipe/manifold/visible/green{
	dir = 1
	},
/turf/simulated/floor/plating,
/area/engineering/engine_room)
"oV" = (
/obj/machinery/atmospherics/pipe/simple/visible/red{
	dir = 9
	},
/turf/simulated/floor/reinforced/airless,
/area/engineering/engine_room)
"pp" = (
/obj/machinery/atmospherics/pipe/simple/visible/green{
	dir = 4
	},
/turf/simulated/floor/plating,
/area/engineering/engine_room)
"qB" = (
/obj/machinery/atmospherics/pipe/simple/visible/green{
	dir = 5
	},
/turf/simulated/floor/plating,
/area/engineering/engine_room)
"rl" = (
/obj/machinery/computer/fusion_fuel_control{
	id_tag = "engine-i"
	},
/turf/template_noop,
/area/template_noop)
"rM" = (
/obj/structure/cable/yellow{
	icon_state = "4-8"
	},
/turf/simulated/floor/plating,
/area/engineering/engine_room)
"rX" = (
/obj/structure/cable/yellow{
	icon_state = "2-4"
	},
/turf/simulated/floor/plating,
/area/engineering/engine_room)
"ss" = (
/obj/machinery/atmospherics/component/binary/circulator{
	anchored = 1;
	dir = 4
	},
/turf/simulated/floor,
/area/engineering/engine_room)
"sH" = (
/obj/machinery/atmospherics/pipe/manifold/visible/cyan{
	dir = 4
	},
/obj/machinery/meter,
/turf/simulated/floor/plating,
/area/engineering/engine_room)
"te" = (
/obj/structure/cable/cyan{
	icon_state = "4-8"
	},
/obj/spawner/window/borosillicate/full,
/turf/simulated/floor/plating,
/area/engineering/engine_room)
"tl" = (
/obj/spawner/window/borosillicate/full,
/turf/simulated/floor/plating,
/area/engineering/engine_room)
"tn" = (
/obj/machinery/atmospherics/component/binary/circulator{
	anchored = 1;
	dir = 8
	},
/turf/simulated/floor,
/area/engineering/engine_room)
"uR" = (
/obj/structure/cable/yellow{
	icon_state = "4-8"
	},
/obj/machinery/fusion_fuel_injector/mapped{
	dir = 1;
	id_tag = "engine-i"
	},
/turf/simulated/floor/plating,
/area/engineering/engine_room)
"vj" = (
/obj/machinery/light{
	dir = 4
	},
/turf/simulated/floor/plating,
/area/engineering/engine_room)
"vm" = (
/obj/machinery/button/remote/blast_door{
	pixel_x = 6;
	pixel_y = 0;
	id = "EngineRadiatorViewport"
	},
/obj/item/book/manual/rust_engine,
/turf/template_noop,
/area/template_noop)
"vS" = (
/obj/machinery/atmospherics/pipe/simple/visible/green{
	dir = 4
	},
/obj/machinery/atmospherics/pipe/simple/visible/red,
/turf/simulated/floor/plating,
/area/engineering/engine_room)
"vV" = (
/obj/machinery/light{
	dir = 8;
	light_range = 12
	},
/turf/simulated/floor/plating,
/area/engineering/engine_room)
"wb" = (
/obj/machinery/atmospherics/pipe/simple/visible/cyan{
	dir = 4
	},
/obj/machinery/atmospherics/pipe/simple/visible/green,
/turf/simulated/floor/plating,
/area/engineering/engine_room)
"wL" = (
/obj/machinery/atmospherics/pipe/manifold/visible/green{
	dir = 8
	},
/turf/simulated/floor/plating,
/area/engineering/engine_room)
"wR" = (
/obj/structure/cable/cyan{
	icon_state = "4-8"
	},
/obj/machinery/light{
	dir = 1
	},
/turf/simulated/floor/plating,
/area/engineering/engine_room)
"xe" = (
/obj/machinery/atmospherics/pipe/manifold/visible/red{
	dir = 1
	},
/turf/simulated/floor/plating,
/area/engineering/engine_room)
"xH" = (
/obj/machinery/atmospherics/pipe/simple/heat_exchanging{
	dir = 4
	},
/turf/template_noop,
/area/space)
"xM" = (
/turf/template_noop,
/area/space)
"yw" = (
/obj/structure/cable/yellow{
	icon_state = "1-8"
	},
/turf/simulated/floor/plating,
/area/engineering/engine_room)
"Ab" = (
/obj/machinery/atmospherics/pipe/simple/visible/cyan{
	dir = 4
	},
/obj/machinery/atmospherics/pipe/simple/visible/red,
/turf/simulated/floor/plating,
/area/engineering/engine_room)
"CC" = (
/obj/machinery/atmospherics/pipe/simple/visible/red,
/obj/spawner/window/borosillicate/full,
/turf/simulated/floor/plating,
/area/engineering/engine_room)
"CN" = (
/obj/structure/cable/yellow{
	icon_state = "1-2"
	},
/obj/machinery/atmospherics/pipe/manifold/visible/green{
	dir = 4
	},
/turf/simulated/floor/plating,
/area/engineering/engine_room)
"Dw" = (
/obj/machinery/atmospherics/pipe/simple/visible/yellow{
	dir = 4
	},
/obj/spawner/window/borosillicate/full,
/turf/simulated/floor/plating,
/area/engineering/engine_room)
"DF" = (
/obj/structure/cable/cyan{
	icon_state = "1-2"
	},
/obj/machinery/atmospherics/pipe/simple/visible/yellow{
	dir = 4
	},
/turf/simulated/floor/plating,
/area/engineering/engine_room)
"Fk" = (
/obj/fiftyspawner/deuterium,
/obj/fiftyspawner/deuterium,
/obj/fiftyspawner/deuterium,
/obj/fiftyspawner/deuterium,
/obj/fiftyspawner/deuterium,
/obj/structure/window/reinforced{
	dir = 8
	},
/obj/structure/table/reinforced,
/turf/simulated/floor/bluegrid,
/area/engineering/engine_room)
"FL" = (
/obj/machinery/atmospherics/pipe/simple/visible/yellow{
	dir = 9
	},
/turf/simulated/floor/plating,
/area/engineering/engine_room)
"FN" = (
/obj/machinery/atmospherics/pipe/simple/visible/red{
	dir = 8
	},
/obj/machinery/meter,
/turf/simulated/floor/plating,
/area/engineering/engine_room)
"Gf" = (
/obj/machinery/atmospherics/pipe/simple/visible/green{
	dir = 10
	},
/turf/simulated/floor/plating,
/area/engineering/engine_room)
"GE" = (
/obj/machinery/atmospherics/pipe/simple/visible/red,
/obj/machinery/air_alarm/west_mount,
/turf/simulated/floor/plating,
/area/engineering/engine_room)
"GL" = (
/obj/machinery/atmospherics/pipe/simple/visible/cyan{
	dir = 9
	},
/turf/simulated/floor/plating,
/area/engineering/engine_room)
"GQ" = (
/obj/machinery/atmospherics/component/unary/outlet_injector{
	dir = 8;
	frequency = 1438;
	id = "cooling_in";
	use_power = 1
	},
/turf/simulated/floor/greengrid/airless,
/area/engineering/engine_room)
"HO" = (
/obj/machinery/atmospherics/pipe/manifold/visible/red{
	dir = 1
	},
/turf/simulated/floor/reinforced/airless,
/area/engineering/engine_room)
"HR" = (
/obj/machinery/atmospherics/portables_connector{
	dir = 8
	},
/obj/effect/floor_decal/industrial/outline/red,
/turf/simulated/floor/plating,
/area/engineering/engine_room)
"Ie" = (
/obj/machinery/door/blast/regular{
	density = 0;
	icon_state = "pdoor0";
	id = "EngineRadiatorViewport";
	name = "Engine Radiator Viewport Shutter";
	opacity = 0
	},
/turf/simulated/floor/plating,
/area/engineering/engine_room)
"JN" = (
/obj/structure/cable/cyan{
	icon_state = "1-2"
	},
/turf/simulated/floor/plating,
/area/engineering/engine_room)
"JP" = (
/obj/structure/cable/cyan{
	icon_state = "1-2"
	},
/obj/machinery/atmospherics/pipe/simple/visible/cyan,
/turf/simulated/floor/plating,
/area/engineering/engine_room)
"Kb" = (
/obj/structure/cable/cyan{
	icon_state = "1-8"
	},
/turf/simulated/floor/plating,
/area/engineering/engine_room)
"Ki" = (
/obj/machinery/atmospherics/pipe/simple/visible/green{
	dir = 6
	},
/turf/simulated/floor/plating,
/area/engineering/engine_room)
"Kt" = (
/obj/machinery/computer/fusion_core_control{
	id_tag = "engine"
	},
/turf/template_noop,
/area/template_noop)
"Ll" = (
/obj/machinery/computer/general_air_control/supermatter_core{
	dir = 1;
	frequency = 1438;
	input_tag = "cooling_in";
	name = "Engine Cooling Control";
	output_tag = "cooling_out";
	pressure_setting = 100;
	sensors = list("engine_sensor"="Engine Core")
	},
/turf/template_noop,
/area/template_noop)
"LQ" = (
/obj/machinery/air_sensor{
	frequency = 1438;
	id_tag = "engine_sensor";
	output = 63
	},
/turf/simulated/floor/reinforced/airless,
/area/engineering/engine_room)
"LT" = (
/obj/effect/floor_decal/industrial/warning,
/turf/simulated/floor/plating,
/area/engineering/engine_room)
"Mh" = (
/obj/machinery/atmospherics/pipe/simple/visible/yellow{
	dir = 10
	},
/turf/simulated/floor/plating,
/area/engineering/engine_room)
"MW" = (
/obj/structure/cable/cyan{
	icon_state = "4-8"
	},
/turf/simulated/floor/reinforced/airless,
/area/engineering/engine_room)
"Nc" = (
/obj/machinery/atmospherics/pipe/simple/visible/green,
/turf/simulated/floor/plating,
/area/engineering/engine_room)
"NE" = (
/obj/machinery/atmospherics/pipe/simple/visible/green,
/obj/machinery/atmospherics/pipe/simple/visible/yellow{
	dir = 4
	},
/turf/simulated/floor/plating,
/area/engineering/engine_room)
"OJ" = (
/turf/template_noop,
/area/template_noop)
"Pb" = (
/obj/machinery/atmospherics/pipe/simple/visible/cyan,
/turf/simulated/floor/plating,
/area/engineering/engine_room)
"PT" = (
/obj/structure/cable/yellow{
	icon_state = "1-2"
	},
/obj/machinery/atmospherics/pipe/simple/visible/green,
/obj/machinery/atmospherics/pipe/simple/visible/yellow{
	dir = 4
	},
/turf/simulated/floor/plating,
/area/engineering/engine_room)
"PY" = (
/obj/machinery/atmospherics/portables_connector{
	dir = 8
	},
/obj/effect/floor_decal/industrial/outline/blue,
/turf/simulated/floor/plating,
/area/engineering/engine_room)
"Qo" = (
/obj/machinery/atmospherics/pipe/simple/visible/cyan{
	dir = 10
	},
/turf/simulated/floor/plating,
/area/engineering/engine_room)
"Qv" = (
/obj/machinery/atmospherics/component/unary/vent_pump/high_volume{
	frequency = 1438;
	id_tag = "cooling_out";
	pump_direction = 0;
	on = 1
	},
/turf/simulated/floor/greengrid/airless,
/area/engineering/engine_room)
"Rm" = (
/obj/structure/cable/cyan{
	icon_state = "1-2"
	},
/obj/structure/cable/cyan{
	icon_state = "1-8"
	},
/turf/simulated/floor/plating,
/area/engineering/engine_room)
"Ru" = (
/obj/machinery/fire_alarm/west_mount,
/turf/simulated/floor/plating,
/area/engineering/engine_room)
"RC" = (
/obj/structure/cable/cyan{
	icon_state = "4-8"
	},
/turf/simulated/floor/plating,
/area/engineering/engine_room)
"Sg" = (
/obj/structure/cable/cyan{
	icon_state = "2-4"
	},
/obj/structure/cable/cyan{
	icon_state = "1-4"
	},
/turf/simulated/floor/plating,
/area/engineering/engine_room)
"SH" = (
/obj/machinery/atmospherics/pipe/simple/visible/yellow{
	dir = 5
	},
/turf/simulated/floor/reinforced/airless,
/area/engineering/engine_room)
"SQ" = (
/obj/structure/cable/cyan,
/turf/simulated/floor/plating,
/area/engineering/engine_room)
"Tf" = (
/obj/structure/cable/yellow{
	icon_state = "2-8"
	},
/obj/machinery/atmospherics/pipe/simple/visible/green,
/obj/machinery/meter,
/turf/simulated/floor/plating,
/area/engineering/engine_room)
"Ua" = (
/obj/structure/cable/yellow{
	icon_state = "4-8"
	},
/obj/machinery/atmospherics/pipe/simple/visible/red,
/turf/simulated/floor/plating,
/area/engineering/engine_room)
"UA" = (
/turf/simulated/wall/r_wall/prepainted,
/area/engineering/engine_room)
"Vg" = (
/obj/machinery/atmospherics/component/binary/pump/high_power,
/turf/simulated/floor/plating,
/area/engineering/engine_room)
"Vh" = (
/obj/machinery/atmospherics/pipe/simple/visible/red,
/obj/machinery/light{
	dir = 8;
	light_range = 12
	},
/turf/simulated/floor/plating,
/area/engineering/engine_room)
"WF" = (
/obj/machinery/atmospherics/pipe/simple/visible/red{
	dir = 8
	},
/obj/machinery/camera/network/engine,
/turf/simulated/floor/plating,
/area/engineering/engine_room)
"XM" = (
/obj/structure/cable/cyan{
	icon_state = "4-8"
	},
/obj/structure/cable/yellow{
	icon_state = "1-2"
	},
/turf/simulated/floor/plating,
/area/engineering/engine_room)
"Yd" = (
/obj/fiftyspawner/tritium,
/obj/fiftyspawner/tritium,
/obj/structure/window/reinforced{
	dir = 4
	},
/obj/structure/table/reinforced,
/turf/simulated/floor/bluegrid,
/area/engineering/engine_room)
"Ye" = (
/obj/machinery/camera/network/engine{
	dir = 8
	},
/turf/simulated/floor/plating,
/area/engineering/engine_room)
"Yy" = (
/obj/machinery/atmospherics/pipe/simple/visible/cyan{
	dir = 4
	},
/obj/machinery/atmospherics/pipe/simple/visible/yellow,
/turf/simulated/floor/plating,
/area/engineering/engine_room)
"YK" = (
/obj/machinery/atmospherics/component/binary/pump{
	dir = 8
	},
/turf/simulated/floor/plating,
/area/engineering/engine_room)
"ZF" = (
/obj/structure/cable/cyan{
	icon_state = "2-8"
	},
/turf/simulated/floor/plating,
/area/engineering/engine_room)

(1,1,1) = {"
xM
xM
xM
xM
xM
xM
jf
jf
jf
jf
jf
jf
jf
jf
jf
jf
jf
jf
jf
xH
xH
xM
"}
(2,1,1) = {"
xM
xM
xM
xM
xM
xM
jf
ck
os
Ru
Ki
qB
vV
ck
os
dB
Ki
qB
jf
xH
xH
xM
"}
(3,1,1) = {"
xM
xM
xM
xM
xM
xM
jf
WF
ss
ak
tn
pp
dB
cx
ss
ak
tn
pp
jf
ay
mF
xM
"}
(4,1,1) = {"
OJ
OJ
Ie
Ie
Ie
jf
jf
cx
as
rM
fN
pp
dB
cx
as
rM
fN
pp
jf
jf
jf
jf
"}
(5,1,1) = {"
OJ
OJ
pp
ck
Ab
GE
ao
ap
al
Ua
Ab
vS
ah
ap
al
Ua
Ab
vS
Vh
GE
os
Ru
"}
(6,1,1) = {"
OJ
OJ
oN
kB
wb
Nc
Nc
Nc
NE
Tf
kW
CN
ev
ev
PT
iy
kW
nl
dV
dB
cx
dB
"}
(7,1,1) = {"
OJ
OJ
lC
cx
fN
dB
dB
dB
Mh
aa
Yy
aa
op
aa
FL
dB
fN
dB
rM
dB
cx
dB
"}
(8,1,1) = {"
vm
OJ
pp
cx
Qo
Vg
Pb
Pb
Pb
Pb
sH
Pb
kF
Pb
Pb
Pb
GL
dB
rM
dB
cx
dB
"}
(9,1,1) = {"
rl
OJ
pp
cx
dB
dB
dB
dB
hP
JN
JN
JN
DF
JN
JP
JP
SQ
dB
rM
dB
cx
dB
"}
(10,1,1) = {"
Kt
OJ
pp
cx
dB
dB
dB
dG
UA
tl
tl
tl
Dw
tl
tl
tl
UA
nf
rM
dB
cx
dB
"}
(11,1,1) = {"
fd
OJ
pp
xe
os
dB
dB
RC
tl
kP
aJ
at
ax
SH
aJ
kP
tl
RC
rM
dB
cx
dB
"}
(12,1,1) = {"
Ll
OJ
pp
YK
fn
dB
ab
aj
tl
aJ
kP
GQ
kP
fm
kP
aJ
tl
aB
uR
dB
cx
dB
"}
(13,1,1) = {"
OJ
OJ
pp
HR
HR
dB
dB
RC
tl
kP
kP
kP
kP
kP
Qv
kR
tl
RC
rM
dB
FN
dB
"}
(14,1,1) = {"
OJ
OJ
Gf
wL
qB
dB
dB
RC
tl
kP
kP
kP
mX
LQ
kP
HO
CC
nq
Ua
ar
av
gr
"}
(15,1,1) = {"
OJ
OJ
dB
YK
fn
dB
dB
RC
tl
kP
aJ
kP
MW
kP
eD
oV
tl
RC
rM
dB
dB
ij
"}
(16,1,1) = {"
OJ
OJ
dB
PY
PY
dB
ab
aj
tl
aJ
kP
kP
MW
aJ
kP
aJ
tl
aB
uR
dB
LT
Fk
"}
(17,1,1) = {"
OJ
OJ
dB
dB
dB
dB
dB
RC
tl
kP
aJ
kP
MW
kP
aJ
kP
tl
RC
rM
dB
LT
mu
"}
(18,1,1) = {"
OJ
OJ
dB
dB
dB
dB
dB
aF
UA
tl
tl
tl
te
tl
tl
tl
UA
wR
rM
dB
LT
Yd
"}
(19,1,1) = {"
OJ
OJ
dB
dB
dB
dB
dB
RC
dB
dB
dB
dB
RC
dB
dB
dB
dB
RC
rM
dB
dB
dB
"}
(20,1,1) = {"
OJ
OJ
dB
dB
dB
dB
dB
ZF
JN
JN
JN
Sg
Rm
JN
JN
JN
JN
Kb
rM
dB
dB
dB
"}
(21,1,1) = {"
OJ
OJ
dB
vj
hZ
dB
dB
Ye
aI
dB
rX
XM
aw
aw
aw
aw
aw
aw
yw
dB
dB
dB
"}
