//MAP CONVERTED BY dmm2tgm.py THIS HEADER COMMENT PREVENTS RECONVERSION, DO NOT REMOVE
"a" = (
/turf/template_noop,
/area/template_noop)
"c" = (
/turf/simulated/floor/greengrid/lavaland,
/area/lavaland/bosses)
"e" = (
/mob/living/simple_mob/mechanical/cyber_horror/priest/surt,
/turf/simulated/floor/bluegrid/lavaland,
/area/lavaland/bosses)
"h" = (
/obj/effect/decal/remains/xeno,
/turf/simulated/floor/outdoors/lavaland,
/area/template_noop)
"j" = (
/obj/effect/decal/remains/mummy2,
/turf/simulated/floor/outdoors/lavaland,
/area/template_noop)
"l" = (
/obj/effect/floor_decal/corner_techfloor_grid,
/turf/simulated/floor/greengrid/lavaland,
/area/lavaland/bosses)
"m" = (
/obj/effect/debris/cleanable/blood/gibs,
/turf/simulated/floor/greengrid/lavaland,
/area/lavaland/bosses)
"r" = (
/turf/simulated/floor/bluegrid/lavaland,
/area/lavaland/bosses)
"s" = (
/obj/structure/girder/displaced,
/turf/simulated/floor/greengrid/lavaland,
/area/lavaland/bosses)
"u" = (
/obj/effect/decal/remains/ribcage,
/turf/simulated/floor/outdoors/lavaland,
/area/template_noop)
"v" = (
/mob/living/simple_mob/mechanical/cyber_horror/surt,
/turf/simulated/floor/greengrid/lavaland,
/area/lavaland/bosses)
"z" = (
/obj/structure/girder,
/turf/simulated/floor/bluegrid/lavaland,
/area/lavaland/bosses)
"A" = (
/obj/effect/decal/remains/mummy1,
/turf/simulated/floor/outdoors/lavaland,
/area/template_noop)
"C" = (
/turf/simulated/wall/titanium,
/area/lavaland/bosses)
"D" = (
/mob/living/simple_mob/mechanical/cyber_horror/grey/surt,
/turf/simulated/floor/bluegrid/lavaland,
/area/lavaland/bosses)
"F" = (
/obj/effect/decal/remains/human,
/turf/simulated/floor/greengrid/lavaland,
/area/lavaland/bosses)
"G" = (
/turf/simulated/floor/outdoors/lavaland,
/area/template_noop)
"H" = (
/obj/effect/decal/remains/deer,
/turf/simulated/floor/outdoors/lavaland,
/area/template_noop)
"I" = (
/obj/effect/decal/remains/tajaran,
/turf/simulated/floor/outdoors/lavaland,
/area/template_noop)
"M" = (
/turf/simulated/floor/outdoors/lavaland,
/area/lavaland/bosses)
"O" = (
/obj/effect/floor_decal/corner_techfloor_grid/diagonal,
/turf/simulated/floor/greengrid/lavaland,
/area/lavaland/bosses)
"R" = (
/obj/random/multiple/treasure,
/obj/structure/closet/crate,
/obj/random/multiple/treasure,
/turf/simulated/floor/greengrid/lavaland,
/area/lavaland/bosses)
"S" = (
/obj/effect/debris/cleanable/blood/gibs,
/turf/simulated/floor/bluegrid/lavaland,
/area/lavaland/bosses)
"U" = (
/turf/simulated/wall/solidrock,
/area/template_noop)
"V" = (
/mob/living/simple_mob/mechanical/cyber_horror/grey/surt,
/turf/simulated/floor/greengrid/lavaland,
/area/lavaland/bosses)

(1,1,1) = {"
a
a
a
a
a
a
a
a
a
a
a
a
a
a
a
a
a
a
a
a
a
a
a
a
a
a
a
a
a
a
"}
(2,1,1) = {"
a
a
a
a
a
a
a
a
a
a
a
a
a
a
a
a
a
a
a
a
a
a
a
a
a
a
a
a
a
a
"}
(3,1,1) = {"
a
a
a
a
a
a
a
a
a
a
a
a
a
a
a
a
a
G
h
a
a
a
a
a
a
a
a
a
a
a
"}
(4,1,1) = {"
a
a
a
a
a
a
a
G
G
a
a
a
a
a
a
a
a
G
G
G
G
a
a
a
a
a
G
G
a
a
"}
(5,1,1) = {"
a
a
a
a
a
a
G
G
G
a
a
a
a
a
a
a
a
a
G
G
a
a
a
a
a
G
G
G
a
a
"}
(6,1,1) = {"
a
a
a
a
a
G
G
H
G
a
a
a
a
a
a
a
a
a
a
G
G
G
G
G
G
G
G
a
a
a
"}
(7,1,1) = {"
a
a
a
a
a
G
G
G
G
a
a
a
a
a
a
a
a
a
a
G
G
G
A
G
G
G
G
a
a
a
"}
(8,1,1) = {"
a
a
a
a
a
a
a
G
G
G
a
a
a
a
a
a
a
a
a
a
G
G
G
G
G
G
G
a
a
a
"}
(9,1,1) = {"
a
a
a
a
a
a
a
G
a
G
G
G
U
U
a
a
a
a
a
G
G
G
G
G
a
a
G
a
a
a
"}
(10,1,1) = {"
a
a
a
a
a
a
a
a
a
G
M
M
c
c
c
c
r
c
M
M
M
G
G
a
a
a
a
a
a
a
"}
(11,1,1) = {"
a
a
a
a
a
a
a
a
a
G
M
M
M
r
c
l
c
c
M
M
M
G
a
a
a
a
a
a
a
a
"}
(12,1,1) = {"
a
a
a
a
a
a
a
a
a
a
M
M
r
v
c
r
C
C
D
M
M
U
a
a
a
a
a
a
a
a
"}
(13,1,1) = {"
a
a
a
a
a
a
a
a
a
a
M
C
c
m
c
c
c
c
c
C
M
a
a
a
a
a
a
a
a
a
"}
(14,1,1) = {"
a
a
a
a
a
a
a
a
a
a
c
z
c
c
e
c
c
r
c
C
r
a
a
a
a
a
a
a
a
a
"}
(15,1,1) = {"
a
a
a
a
a
a
a
a
a
a
c
C
r
c
c
R
c
c
O
C
c
a
a
a
a
a
a
a
a
a
"}
(16,1,1) = {"
a
a
a
a
a
a
a
a
a
j
c
C
c
F
c
r
c
r
c
C
c
a
a
a
a
a
a
a
a
a
"}
(17,1,1) = {"
a
a
a
a
a
a
a
a
a
G
r
C
r
c
r
c
c
c
c
r
M
a
a
a
a
a
a
a
a
a
"}
(18,1,1) = {"
a
a
a
a
a
a
a
a
a
G
M
V
C
v
c
s
c
C
C
M
M
G
a
a
a
a
a
a
a
a
"}
(19,1,1) = {"
a
a
a
a
a
a
a
a
a
G
M
M
r
c
c
r
c
c
S
M
M
G
a
a
a
a
a
a
a
a
"}
(20,1,1) = {"
a
a
a
a
a
a
a
a
a
G
M
M
M
c
c
c
c
r
M
M
M
G
G
a
a
a
a
a
a
a
"}
(21,1,1) = {"
a
a
a
a
a
a
G
G
G
G
G
G
G
a
a
a
a
a
U
G
G
G
G
G
a
a
a
a
a
a
"}
(22,1,1) = {"
a
a
a
a
a
G
G
G
G
a
a
a
a
a
a
a
a
a
a
a
G
G
u
G
G
G
G
G
a
a
"}
(23,1,1) = {"
a
a
a
a
a
G
G
G
G
a
a
a
a
a
a
a
a
a
a
a
G
G
G
G
G
G
G
G
a
a
"}
(24,1,1) = {"
a
a
a
a
a
G
G
G
a
a
a
a
a
a
a
a
a
a
a
G
G
G
a
a
G
G
G
G
a
a
"}
(25,1,1) = {"
a
a
a
a
a
a
G
G
a
a
a
a
a
a
a
a
a
a
a
G
G
G
a
a
a
G
G
G
a
a
"}
(26,1,1) = {"
a
a
a
a
a
a
a
a
a
a
a
a
a
a
a
a
a
a
a
G
G
a
a
a
a
a
G
G
G
a
"}
(27,1,1) = {"
a
a
a
a
a
a
a
a
a
a
a
a
a
a
a
a
a
a
G
G
G
a
a
a
a
a
a
G
G
a
"}
(28,1,1) = {"
a
a
a
a
a
a
a
a
a
a
a
a
a
a
a
a
a
a
I
G
a
a
a
a
a
a
a
a
a
a
"}
(29,1,1) = {"
a
a
a
a
a
a
a
a
a
a
a
a
a
a
a
a
a
a
a
a
a
a
a
a
a
a
a
a
a
a
"}
(30,1,1) = {"
a
a
a
a
a
a
a
a
a
a
a
a
a
a
a
a
a
a
a
a
a
a
a
a
a
a
a
a
a
a
"}
