//MAP CONVERTED BY dmm2tgm.py THIS HEADER COMMENT PREVENTS RECONVERSION, DO NOT REMOVE
"a" = (
/turf/template_noop,
/area/template_noop)
"b" = (
/obj/structure/sink{
	dir = 4;
	pixel_x = 12
	},
/obj/structure/mirror{
	pixel_x = 25
	},
/obj/effect/floor_decal/corner/white/border{
	dir = 6
	},
/turf/simulated/floor/tiled/lythios43c,
/area/submap/lythios/west_caves/buried_structure)
"d" = (
/obj/structure/cable{
	icon_state = "2-6"
	},
/turf/simulated/floor/lythios43c/indoors,
/area/submap/lythios/west_caves/buried_structure)
"g" = (
/obj/machinery/door/airlock/external,
/obj/effect/overlay/snow/airlock,
/obj/structure/catwalk,
/turf/simulated/floor/lythios43c/indoors,
/area/submap/lythios/west_caves/buried_structure)
"j" = (
/obj/structure/table/hardwoodtable,
/obj/machinery/microwave,
/turf/simulated/floor/tiled/lythios43c,
/area/submap/lythios/west_caves/buried_structure)
"k" = (
/obj/item/storage/briefcase/inflatable{
	pixel_x = -2;
	pixel_y = -2
	},
/obj/structure/table/rack,
/turf/simulated/floor/lythios43c/indoors,
/area/submap/lythios/west_caves/buried_structure)
"l" = (
/obj/machinery/power/port_gen/pacman,
/obj/structure/cable{
	icon_state = "0-10"
	},
/turf/simulated/floor/lythios43c/indoors,
/area/submap/lythios/west_caves/buried_structure)
"o" = (
/obj/machinery/door/airlock/maintenance_hatch,
/turf/simulated/floor/lythios43c/indoors,
/area/submap/lythios/west_caves/buried_structure)
"q" = (
/obj/machinery/shower{
	pixel_y = 18
	},
/obj/structure/curtain/open/shower,
/obj/structure/window/reinforced/tinted/frosted{
	dir = 8
	},
/obj/structure/window/reinforced/tinted/frosted{
	dir = 4
	},
/obj/effect/floor_decal/corner/white/bordercee,
/obj/effect/floor_decal/steeldecal/steel_decals10{
	dir = 5
	},
/obj/effect/floor_decal/steeldecal/steel_decals10{
	dir = 6
	},
/turf/simulated/floor/tiled/monotile/lythios43c,
/area/submap/lythios/west_caves/buried_structure)
"r" = (
/obj/structure/table/rack,
/turf/simulated/floor/lythios43c/indoors,
/area/submap/lythios/west_caves/buried_structure)
"s" = (
/turf/simulated/floor/lythios43c/indoors,
/area/submap/lythios/west_caves/buried_structure)
"t" = (
/turf/simulated/mineral/floor/icerock/lythios43c/indoors/ignore_cavegen,
/area/rift/surfacebase/outside/west_caves)
"v" = (
/obj/random/crystal/ice,
/turf/simulated/mineral/floor/icerock/lythios43c/indoors/ignore_cavegen,
/area/rift/surfacebase/outside/west_caves)
"w" = (
/obj/effect/floor_decal/corner/white/border{
	dir = 5
	},
/turf/simulated/floor/tiled/lythios43c,
/area/submap/lythios/west_caves/buried_structure)
"x" = (
/turf/simulated/floor/carpet/arcadecarpet/lythios43c,
/area/submap/lythios/west_caves/buried_structure)
"y" = (
/obj/machinery/door/airlock{
	name = "Bathroom"
	},
/turf/simulated/floor/tiled/lythios43c,
/area/submap/lythios/west_caves/buried_structure)
"z" = (
/obj/structure/cable{
	icon_state = "5-8"
	},
/turf/simulated/floor/lythios43c/indoors,
/area/submap/lythios/west_caves/buried_structure)
"B" = (
/obj/random/crystal/normal_ice,
/turf/simulated/mineral/floor/icerock/lythios43c/indoors/ignore_cavegen,
/area/rift/surfacebase/outside/west_caves)
"D" = (
/obj/structure/sink/kitchen{
	pixel_y = 28
	},
/turf/simulated/floor/tiled/lythios43c,
/area/submap/lythios/west_caves/buried_structure)
"E" = (
/turf/simulated/floor/tiled/lythios43c,
/area/submap/lythios/west_caves/buried_structure)
"G" = (
/obj/effect/floor_decal/corner/white/border{
	dir = 10
	},
/turf/simulated/floor/tiled/lythios43c,
/area/submap/lythios/west_caves/buried_structure)
"H" = (
/obj/structure/table/hardwoodtable,
/turf/simulated/floor/tiled/lythios43c,
/area/submap/lythios/west_caves/buried_structure)
"I" = (
/obj/structure/toilet{
	pixel_y = 9
	},
/obj/effect/floor_decal/corner/white/bordercee,
/turf/simulated/floor/tiled/monotile/lythios43c,
/area/submap/lythios/west_caves/buried_structure)
"M" = (
/turf/simulated/wall/lythios43c,
/area/submap/lythios/west_caves/buried_structure)
"N" = (
/obj/structure/cable{
	icon_state = "4-9"
	},
/obj/structure/cable{
	icon_state = "1-8"
	},
/turf/simulated/floor/lythios43c/indoors,
/area/submap/lythios/west_caves/buried_structure)
"O" = (
/obj/machinery/door/airlock/external/glass,
/obj/structure/catwalk,
/turf/simulated/floor/lythios43c/indoors,
/area/submap/lythios/west_caves/buried_structure)
"P" = (
/obj/structure/table/hardwoodtable,
/obj/item/material/knife/butch,
/turf/simulated/floor/tiled/lythios43c,
/area/submap/lythios/west_caves/buried_structure)
"Q" = (
/obj/machinery/door/airlock,
/turf/simulated/floor/tiled/lythios43c,
/area/submap/lythios/west_caves/buried_structure)
"U" = (
/obj/effect/floor_decal/corner/white/border{
	dir = 9
	},
/turf/simulated/floor/tiled/lythios43c,
/area/submap/lythios/west_caves/buried_structure)
"V" = (
/obj/structure/catwalk,
/turf/simulated/floor/lythios43c/indoors,
/area/submap/lythios/west_caves/buried_structure)
"W" = (
/obj/structure/cable{
	icon_state = "1-4"
	},
/turf/simulated/floor/lythios43c/indoors,
/area/submap/lythios/west_caves/buried_structure)
"X" = (
/obj/machinery/power/apc/alarms_hidden/north_bump,
/obj/structure/cable{
	icon_state = "0-2"
	},
/turf/simulated/floor/lythios43c/indoors,
/area/submap/lythios/west_caves/buried_structure)
"Y" = (
/obj/spawner/window/reinforced/full,
/turf/simulated/floor/lythios43c/indoors,
/area/submap/lythios/west_caves/buried_structure)
"Z" = (
/obj/structure/closet/secure_closet/freezer/meat,
/turf/simulated/floor/tiled/lythios43c,
/area/submap/lythios/west_caves/buried_structure)

(1,1,1) = {"
a
a
a
a
a
a
a
a
a
a
a
a
a
a
a
a
a
a
a
a
"}
(2,1,1) = {"
a
a
M
M
M
M
M
M
M
M
M
M
M
t
v
t
a
a
a
a
"}
(3,1,1) = {"
a
a
M
H
E
E
E
M
x
x
x
x
M
t
t
t
a
a
a
a
"}
(4,1,1) = {"
a
a
M
H
E
E
E
Q
x
x
x
x
M
B
t
t
t
v
a
a
"}
(5,1,1) = {"
a
a
M
P
E
E
E
M
x
x
x
x
M
t
t
t
t
t
a
a
"}
(6,1,1) = {"
a
a
M
j
E
E
E
M
x
x
x
x
M
t
v
t
t
t
a
a
"}
(7,1,1) = {"
a
a
M
Z
E
E
E
M
M
M
M
y
M
t
t
t
B
t
B
a
"}
(8,1,1) = {"
a
a
M
D
E
E
E
E
M
q
U
G
M
t
t
t
t
t
t
a
"}
(9,1,1) = {"
a
a
M
E
E
E
E
E
M
I
w
b
M
t
t
t
t
t
t
a
"}
(10,1,1) = {"
a
a
M
E
E
E
E
E
M
M
M
M
M
t
t
t
v
t
B
a
"}
(11,1,1) = {"
a
a
M
E
E
E
E
E
O
V
V
V
g
t
B
t
t
t
t
a
"}
(12,1,1) = {"
a
a
M
E
E
E
E
E
O
V
V
V
g
t
t
t
t
B
a
a
"}
(13,1,1) = {"
a
a
M
M
M
M
E
E
M
M
M
M
M
t
t
t
t
t
a
a
"}
(14,1,1) = {"
a
a
M
d
W
M
Q
M
M
s
s
s
M
s
t
t
t
t
a
a
"}
(15,1,1) = {"
a
a
M
X
N
M
s
s
s
s
s
s
Y
s
t
t
B
t
a
a
"}
(16,1,1) = {"
a
a
M
s
z
o
s
s
s
s
s
s
M
s
v
t
t
a
a
a
"}
(17,1,1) = {"
a
a
M
l
r
M
s
r
k
r
r
s
M
t
t
t
a
a
a
a
"}
(18,1,1) = {"
a
a
M
M
M
M
M
M
M
M
M
M
M
B
a
a
a
a
a
a
"}
(19,1,1) = {"
a
a
a
a
a
a
a
a
a
a
a
a
a
a
a
a
a
a
a
a
"}
(20,1,1) = {"
a
a
a
a
a
a
a
a
a
a
a
a
a
a
a
a
a
a
a
a
"}
