//MAP CONVERTED BY dmm2tgm.py THIS HEADER COMMENT PREVENTS RECONVERSION, DO NOT REMOVE
"a" = (
/obj/structure/largecrate,
/obj/item/stack/material/steel{
	amount = 30
	},
/obj/random/triumph,
/turf/simulated/mineral/floor/lythios43c/indoors,
/area/submap/lythios/west_caves/survival_cave1)
"b" = (
/obj/structure/largecrate,
/obj/random/mre,
/obj/random/mre,
/turf/simulated/mineral/floor/lythios43c/indoors,
/area/submap/lythios/west_caves/survival_cave1)
"e" = (
/obj/structure/inflatable/door,
/turf/simulated/mineral/floor/lythios43c/indoors,
/area/submap/lythios/west_caves/survival_cave1)
"g" = (
/turf/template_noop,
/area/template_noop)
"n" = (
/turf/simulated/mineral/lythios43c,
/area/submap/lythios/west_caves/survival_cave1)
"x" = (
/turf/simulated/mineral/floor/lythios43c/indoors,
/area/submap/lythios/west_caves/survival_cave1)
"y" = (
/obj/structure/barricade,
/turf/simulated/floor/outdoors/safeice/lythios43c/indoors,
/area/submap/lythios/west_caves/survival_cave1)
"z" = (
/obj/structure/table/rack,
/obj/item/storage/toolbox/emergency,
/obj/item/pickaxe,
/turf/simulated/mineral/floor/lythios43c/indoors,
/area/submap/lythios/west_caves/survival_cave1)
"C" = (
/obj/structure/table/bench/steel,
/turf/simulated/mineral/floor/lythios43c/indoors,
/area/submap/lythios/west_caves/survival_cave1)
"F" = (
/turf/simulated/floor/outdoors/safeice/lythios43c/indoors,
/area/submap/lythios/west_caves/survival_cave1)
"I" = (
/obj/machinery/crystal/lava,
/turf/simulated/mineral/floor/lythios43c/indoors,
/area/submap/lythios/west_caves/survival_cave1)
"L" = (
/obj/structure/bonfire{
	grill = 1
	},
/turf/simulated/mineral/floor/lythios43c/indoors,
/area/submap/lythios/west_caves/survival_cave1)
"N" = (
/obj/structure/inflatable,
/turf/simulated/mineral/floor/lythios43c/indoors,
/area/submap/lythios/west_caves/survival_cave1)
"O" = (
/obj/structure/largecrate,
/obj/fiftyspawner/log,
/turf/simulated/mineral/floor/lythios43c/indoors,
/area/submap/lythios/west_caves/survival_cave1)

(1,1,1) = {"
g
g
g
n
n
n
g
g
g
g
"}
(2,1,1) = {"
g
n
n
n
n
n
n
n
g
g
"}
(3,1,1) = {"
n
n
n
x
x
I
n
n
n
g
"}
(4,1,1) = {"
n
n
b
x
x
x
x
n
n
g
"}
(5,1,1) = {"
n
n
a
C
L
C
x
n
n
n
"}
(6,1,1) = {"
n
n
z
x
x
x
x
I
n
n
"}
(7,1,1) = {"
g
n
O
x
x
x
N
N
n
g
"}
(8,1,1) = {"
g
n
n
n
n
x
e
x
N
y
"}
(9,1,1) = {"
g
g
n
n
n
n
N
e
N
y
"}
(10,1,1) = {"
g
g
g
g
n
n
y
F
y
g
"}
