//MAP CONVERTED BY dmm2tgm.py THIS HEADER COMMENT PREVENTS RECONVERSION, DO NOT REMOVE
"aN" = (
/obj/effect/floor_decal/spline/fancy/wood{
	dir = 1
	},
/turf/simulated/floor/wood/lythios43c,
/area/submap/lythios/west_caves/buried_structure)
"bx" = (
/obj/machinery/door/airlock/external/glass,
/obj/structure/catwalk,
/turf/simulated/floor/lythios43c/indoors,
/area/submap/lythios/west_caves/buried_structure)
"cw" = (
/obj/structure/table/rack,
/obj/item/storage/toolbox/electrical,
/turf/simulated/floor/tiled/lythios43c,
/area/submap/lythios/west_caves/buried_structure)
"cS" = (
/obj/machinery/door/airlock/external,
/obj/effect/overlay/snow/airlock,
/obj/structure/catwalk,
/turf/simulated/floor/lythios43c/indoors,
/area/submap/lythios/west_caves/buried_structure)
"fr" = (
/obj/structure/bed/double/padded,
/obj/item/bedsheet/browndouble,
/turf/simulated/floor/carpet/arcadecarpet/lythios43c,
/area/submap/lythios/west_caves/buried_structure)
"fO" = (
/obj/machinery/light{
	dir = 1
	},
/turf/simulated/floor/carpet/arcadecarpet/lythios43c,
/area/submap/lythios/west_caves/buried_structure)
"gV" = (
/mob/living/simple_mob/animal/giant_spider/frost,
/turf/simulated/floor/lythios43c/indoors,
/area/submap/lythios/west_caves/buried_structure)
"jf" = (
/obj/structure/table/rack,
/obj/machinery/light/small{
	dir = 4
	},
/obj/effect/floor_decal/rust,
/turf/simulated/floor/lythios43c/indoors,
/area/submap/lythios/west_caves/buried_structure)
"kM" = (
/obj/structure/cable{
	icon_state = "2-6"
	},
/obj/effect/decal/remains/tajaran,
/obj/item/clothing/head/tajaran/scarf,
/turf/simulated/floor/lythios43c/indoors,
/area/submap/lythios/west_caves/buried_structure)
"li" = (
/mob/living/simple_mob/animal/giant_spider/frost,
/turf/simulated/floor/carpet/bcarpet/lythios43c,
/area/submap/lythios/west_caves/buried_structure)
"lj" = (
/obj/machinery/door/airlock,
/turf/simulated/floor/tiled/lythios43c,
/area/submap/lythios/west_caves/buried_structure)
"lY" = (
/obj/effect/floor_decal/spline/fancy/wood,
/mob/living/simple_mob/animal/giant_spider/frost,
/turf/simulated/floor/wood/lythios43c,
/area/submap/lythios/west_caves/buried_structure)
"my" = (
/obj/machinery/power/port_gen/pacman,
/obj/structure/cable{
	icon_state = "0-10"
	},
/turf/simulated/floor/lythios43c/indoors,
/area/submap/lythios/west_caves/buried_structure)
"nK" = (
/obj/machinery/power/apc/alarms_hidden/north_bump{
	start_charge = 0
	},
/obj/structure/cable{
	icon_state = "0-2"
	},
/obj/effect/floor_decal/rust,
/turf/simulated/floor/lythios43c/indoors,
/area/submap/lythios/west_caves/buried_structure)
"nN" = (
/obj/effect/spider/stickyweb,
/turf/simulated/floor/carpet/bcarpet/lythios43c,
/area/submap/lythios/west_caves/buried_structure)
"nY" = (
/obj/machinery/pipedispenser,
/turf/simulated/floor/tiled/lythios43c,
/area/submap/lythios/west_caves/buried_structure)
"py" = (
/obj/structure/table/hardwoodtable,
/turf/simulated/floor/tiled/lythios43c,
/area/submap/lythios/west_caves/buried_structure)
"qb" = (
/obj/machinery/light{
	dir = 1
	},
/turf/simulated/mineral/floor/icerock/lythios43c/indoors/ignore_cavegen,
/area/rift/surfacebase/outside/west_caves)
"ro" = (
/turf/simulated/wall/lythios43c,
/area/submap/lythios/west_caves/buried_structure)
"rw" = (
/obj/structure/fireplace{
	pixel_y = 14
	},
/turf/simulated/floor/carpet/bcarpet/lythios43c,
/area/submap/lythios/west_caves/buried_structure)
"rH" = (
/obj/structure/table/rack/steel,
/obj/fiftyspawner/log,
/obj/fiftyspawner/log,
/obj/effect/debris/cleanable/cobweb,
/turf/simulated/floor/carpet/bcarpet/lythios43c,
/area/submap/lythios/west_caves/buried_structure)
"rT" = (
/obj/machinery/portable_atmospherics/canister/oxygen,
/obj/effect/spider/stickyweb/dark,
/turf/simulated/floor/tiled/lythios43c,
/area/submap/lythios/west_caves/buried_structure)
"te" = (
/obj/structure/cable{
	icon_state = "5-8"
	},
/turf/simulated/floor/lythios43c/indoors,
/area/submap/lythios/west_caves/buried_structure)
"ti" = (
/obj/structure/undies_wardrobe,
/turf/simulated/floor/carpet/arcadecarpet/lythios43c,
/area/submap/lythios/west_caves/buried_structure)
"to" = (
/obj/random/crystal/ice,
/turf/simulated/mineral/floor/icerock/lythios43c/indoors/ignore_cavegen,
/area/rift/surfacebase/outside/west_caves)
"tM" = (
/obj/machinery/door/airlock/external,
/obj/effect/overlay/snow/airlock,
/obj/structure/catwalk,
/obj/effect/spider/stickyweb,
/turf/simulated/floor/lythios43c/indoors,
/area/submap/lythios/west_caves/buried_structure)
"tW" = (
/turf/simulated/mineral/floor/icerock/lythios43c/indoors/ignore_cavegen,
/area/rift/surfacebase/outside/west_caves)
"vx" = (
/turf/simulated/floor/carpet/arcadecarpet/lythios43c,
/area/submap/lythios/west_caves/buried_structure)
"wO" = (
/obj/structure/bed/chair/sofa/black/right{
	dir = 4
	},
/turf/simulated/floor/carpet/bcarpet/lythios43c,
/area/submap/lythios/west_caves/buried_structure)
"wZ" = (
/obj/structure/closet/secure_closet/freezer/meat,
/turf/simulated/floor/tiled/lythios43c,
/area/submap/lythios/west_caves/buried_structure)
"xM" = (
/obj/structure/catwalk,
/obj/effect/spider/stickyweb,
/turf/simulated/floor/lythios43c/indoors,
/area/submap/lythios/west_caves/buried_structure)
"yj" = (
/obj/random/crystal/normal_ice,
/turf/simulated/mineral/floor/icerock/lythios43c/indoors/ignore_cavegen,
/area/rift/surfacebase/outside/west_caves)
"yI" = (
/obj/machinery/door/airlock/maintenance_hatch{
	icon_state = "door_locked"
	},
/turf/simulated/floor/lythios43c/indoors,
/area/submap/lythios/west_caves/buried_structure)
"zq" = (
/turf/simulated/floor/lythios43c/indoors,
/area/submap/lythios/west_caves/buried_structure)
"zs" = (
/obj/effect/floor_decal/rust,
/turf/simulated/floor/lythios43c/indoors,
/area/submap/lythios/west_caves/buried_structure)
"zt" = (
/obj/machinery/shower{
	pixel_y = 18
	},
/obj/structure/curtain/open/shower,
/obj/structure/window/reinforced/tinted/frosted{
	dir = 8
	},
/obj/structure/window/reinforced/tinted/frosted{
	dir = 4
	},
/obj/effect/floor_decal/corner/white/bordercee,
/obj/effect/floor_decal/steeldecal/steel_decals10{
	dir = 5
	},
/obj/effect/floor_decal/steeldecal/steel_decals10{
	dir = 6
	},
/obj/random/soap,
/turf/simulated/floor/tiled/monotile/lythios43c,
/area/submap/lythios/west_caves/buried_structure)
"Al" = (
/obj/structure/toilet{
	pixel_y = 9
	},
/obj/effect/floor_decal/corner/white/bordercee,
/turf/simulated/floor/tiled/monotile/lythios43c,
/area/submap/lythios/west_caves/buried_structure)
"Aq" = (
/obj/structure/cable{
	icon_state = "1-4"
	},
/obj/item/paper/crumpled{
	info = "cold... so cold... I can hardly keep my hand strait. This is... my last will and... testim.... [i] the writing becomes mere scribbles at this point before trailing off the paper [/i]"
	},
/obj/item/pen{
	pixel_x = -12
	},
/turf/simulated/floor/lythios43c/indoors,
/area/submap/lythios/west_caves/buried_structure)
"By" = (
/obj/structure/sink/kitchen{
	pixel_y = 28
	},
/obj/structure/window/wooden{
	dir = 4
	},
/turf/simulated/floor/tiled/lythios43c,
/area/submap/lythios/west_caves/buried_structure)
"Df" = (
/obj/machinery/door/airlock{
	name = "Bathroom"
	},
/turf/simulated/floor/tiled/lythios43c,
/area/submap/lythios/west_caves/buried_structure)
"Dq" = (
/obj/structure/table/rack,
/obj/item/storage/toolbox/mechanical,
/turf/simulated/floor/tiled/lythios43c,
/area/submap/lythios/west_caves/buried_structure)
"Eq" = (
/obj/structure/bed/chair/comfy/black{
	dir = 8
	},
/turf/simulated/floor/carpet/bcarpet/lythios43c,
/area/submap/lythios/west_caves/buried_structure)
"EK" = (
/obj/effect/floor_decal/corner/white/border{
	dir = 5
	},
/obj/machinery/light{
	dir = 4
	},
/turf/simulated/floor/tiled/lythios43c,
/area/submap/lythios/west_caves/buried_structure)
"EM" = (
/obj/structure/table/wooden_reinforced,
/obj/item/clothing/mask/smokable/pipe/cobpipe,
/turf/simulated/floor/carpet/bcarpet/lythios43c,
/area/submap/lythios/west_caves/buried_structure)
"GB" = (
/obj/structure/table/wooden_reinforced,
/obj/item/flashlight/lamp,
/turf/simulated/floor/carpet/arcadecarpet/lythios43c,
/area/submap/lythios/west_caves/buried_structure)
"GK" = (
/obj/effect/floor_decal/spline/fancy/wood,
/turf/simulated/floor/wood/lythios43c,
/area/submap/lythios/west_caves/buried_structure)
"HE" = (
/obj/spawner/window/reinforced/full,
/obj/structure/curtain/black{
	anchored = 1
	},
/turf/simulated/floor/lythios43c/indoors,
/area/submap/lythios/west_caves/buried_structure)
"HU" = (
/turf/template_noop,
/area/template_noop)
"Ib" = (
/obj/structure/catwalk,
/obj/machinery/light/small{
	dir = 8
	},
/turf/simulated/floor/lythios43c/indoors,
/area/submap/lythios/west_caves/buried_structure)
"Jz" = (
/obj/effect/spider/stickyweb/dark,
/turf/simulated/floor/tiled/lythios43c,
/area/submap/lythios/west_caves/buried_structure)
"KO" = (
/obj/structure/table/rack,
/obj/fiftyspawner/rods,
/obj/fiftyspawner/steel,
/obj/fiftyspawner/glass,
/turf/simulated/floor/tiled/lythios43c,
/area/submap/lythios/west_caves/buried_structure)
"LO" = (
/obj/structure/cable{
	icon_state = "4-9"
	},
/obj/structure/cable{
	icon_state = "1-8"
	},
/turf/simulated/floor/lythios43c/indoors,
/area/submap/lythios/west_caves/buried_structure)
"Mx" = (
/obj/effect/floor_decal/corner/white/border{
	dir = 9
	},
/turf/simulated/floor/tiled/lythios43c,
/area/submap/lythios/west_caves/buried_structure)
"Nz" = (
/obj/structure/catwalk,
/turf/simulated/floor/lythios43c/indoors,
/area/submap/lythios/west_caves/buried_structure)
"NL" = (
/obj/effect/floor_decal/spline/fancy/wood{
	dir = 5
	},
/turf/simulated/floor/wood/lythios43c,
/area/submap/lythios/west_caves/buried_structure)
"OF" = (
/obj/structure/bed/chair/sofa/black/left{
	dir = 4
	},
/turf/simulated/floor/carpet/bcarpet/lythios43c,
/area/submap/lythios/west_caves/buried_structure)
"Pl" = (
/obj/structure/sink{
	dir = 4;
	pixel_x = 12
	},
/obj/structure/mirror{
	pixel_x = 25
	},
/obj/effect/floor_decal/corner/white/border{
	dir = 6
	},
/turf/simulated/floor/tiled/lythios43c,
/area/submap/lythios/west_caves/buried_structure)
"Qb" = (
/obj/effect/spider/stickyweb/dark,
/turf/simulated/floor/lythios43c/indoors,
/area/submap/lythios/west_caves/buried_structure)
"Qo" = (
/obj/structure/grille/broken,
/obj/effect/spider/stickyweb/dark,
/obj/item/material/shard,
/obj/item/material/shard,
/turf/simulated/floor/lythios43c/indoors,
/area/submap/lythios/west_caves/buried_structure)
"RD" = (
/obj/structure/closet/secure_closet/personal,
/obj/item/clothing/suit/tajaran/furs,
/turf/simulated/floor/carpet/arcadecarpet/lythios43c,
/area/submap/lythios/west_caves/buried_structure)
"RR" = (
/obj/structure/table/hardwoodtable,
/obj/machinery/microwave,
/obj/machinery/light{
	dir = 1
	},
/turf/simulated/floor/tiled/lythios43c,
/area/submap/lythios/west_caves/buried_structure)
"Sw" = (
/obj/spawner/window/reinforced/full,
/turf/simulated/floor/lythios43c/indoors,
/area/submap/lythios/west_caves/buried_structure)
"ST" = (
/turf/simulated/floor/tiled/lythios43c,
/area/submap/lythios/west_caves/buried_structure)
"Tt" = (
/obj/machinery/light{
	dir = 8
	},
/obj/effect/floor_decal/rust,
/turf/simulated/floor/lythios43c/indoors,
/area/submap/lythios/west_caves/buried_structure)
"TT" = (
/obj/machinery/portable_atmospherics/canister/air,
/turf/simulated/floor/tiled/lythios43c,
/area/submap/lythios/west_caves/buried_structure)
"UV" = (
/obj/machinery/door/airlock{
	icon_state = "door_open"
	},
/obj/effect/spider/stickyweb/dark,
/turf/simulated/floor/lythios43c/indoors,
/area/submap/lythios/west_caves/buried_structure)
"Vh" = (
/turf/simulated/floor/carpet/bcarpet/lythios43c,
/area/submap/lythios/west_caves/buried_structure)
"VL" = (
/obj/structure/largecrate,
/obj/item/circuitboard/airalarm,
/obj/item/circuitboard/airalarm,
/obj/item/circuitboard/airalarm,
/obj/item/circuitboard/airalarm,
/obj/item/circuitboard/airalarm,
/obj/item/circuitboard/airalarm,
/obj/item/stack/cable_coil/random,
/obj/item/stack/cable_coil/random,
/turf/simulated/floor/tiled/lythios43c,
/area/submap/lythios/west_caves/buried_structure)
"VZ" = (
/obj/effect/floor_decal/spline/fancy/wood{
	dir = 10
	},
/obj/machinery/light{
	dir = 8;
	light_range = 12
	},
/obj/effect/spider/stickyweb,
/turf/simulated/floor/wood/lythios43c,
/area/submap/lythios/west_caves/buried_structure)
"We" = (
/obj/item/storage/briefcase/inflatable{
	pixel_x = -2;
	pixel_y = -2
	},
/obj/structure/table/rack,
/turf/simulated/floor/tiled/lythios43c,
/area/submap/lythios/west_caves/buried_structure)
"WO" = (
/obj/effect/floor_decal/spline/fancy/wood,
/obj/effect/spider/stickyweb,
/turf/simulated/floor/wood/lythios43c,
/area/submap/lythios/west_caves/buried_structure)
"WQ" = (
/obj/effect/floor_decal/spline/fancy/wood{
	dir = 6
	},
/obj/machinery/light{
	dir = 4
	},
/turf/simulated/floor/wood/lythios43c,
/area/submap/lythios/west_caves/buried_structure)
"WU" = (
/obj/effect/floor_decal/spline/fancy/wood{
	dir = 9
	},
/obj/effect/spider/stickyweb,
/turf/simulated/floor/wood/lythios43c,
/area/submap/lythios/west_caves/buried_structure)
"Xo" = (
/obj/structure/table/hardwoodtable,
/obj/item/material/knife/butch,
/turf/simulated/floor/tiled/lythios43c,
/area/submap/lythios/west_caves/buried_structure)
"XY" = (
/obj/effect/floor_decal/corner/white/border{
	dir = 10
	},
/turf/simulated/floor/tiled/lythios43c,
/area/submap/lythios/west_caves/buried_structure)
"YK" = (
/obj/structure/window/wooden{
	dir = 4
	},
/turf/simulated/floor/tiled/lythios43c,
/area/submap/lythios/west_caves/buried_structure)

(1,1,1) = {"
HU
HU
HU
HU
HU
HU
HU
HU
HU
HU
HU
HU
HU
HU
HU
HU
HU
HU
HU
HU
"}
(2,1,1) = {"
HU
HU
ro
ro
ro
ro
ro
ro
ro
ro
ro
ro
ro
tW
to
tW
HU
HU
HU
HU
"}
(3,1,1) = {"
HU
HU
ro
py
ST
ST
WU
VZ
ro
RD
vx
ti
ro
tW
tW
tW
HU
HU
HU
HU
"}
(4,1,1) = {"
HU
HU
ro
py
ST
ST
aN
WO
lj
vx
vx
vx
HE
yj
tW
tW
tW
to
HU
HU
"}
(5,1,1) = {"
HU
HU
ro
Xo
ST
ST
aN
GK
ro
fO
vx
vx
HE
tW
tW
tW
tW
tW
HU
HU
"}
(6,1,1) = {"
HU
HU
ro
RR
ST
ST
aN
GK
ro
fr
GB
vx
ro
tW
to
tW
tW
tW
HU
HU
"}
(7,1,1) = {"
HU
HU
ro
wZ
ST
ST
aN
lY
ro
ro
ro
Df
ro
tW
tW
tW
yj
tW
yj
HU
"}
(8,1,1) = {"
HU
HU
ro
By
YK
YK
aN
GK
ro
zt
Mx
XY
ro
tW
tW
tW
tW
tW
tW
HU
"}
(9,1,1) = {"
HU
HU
ro
rH
OF
wO
aN
GK
ro
Al
EK
Pl
ro
tW
tW
tW
tW
tW
tW
HU
"}
(10,1,1) = {"
HU
HU
ro
Vh
Vh
li
aN
GK
ro
ro
ro
ro
ro
qb
tW
tW
to
tW
yj
HU
"}
(11,1,1) = {"
HU
HU
ro
rw
Vh
Vh
aN
GK
bx
Nz
Ib
xM
tM
tW
yj
tW
tW
tW
tW
HU
"}
(12,1,1) = {"
HU
HU
ro
nN
Eq
EM
aN
GK
bx
Nz
Nz
xM
cS
tW
tW
tW
tW
yj
HU
HU
"}
(13,1,1) = {"
HU
HU
ro
ro
ro
ro
NL
WQ
ro
ro
ro
ro
ro
qb
tW
tW
tW
tW
HU
HU
"}
(14,1,1) = {"
HU
HU
ro
kM
Aq
ro
UV
ro
ro
nY
TT
rT
ro
tW
tW
tW
tW
tW
HU
HU
"}
(15,1,1) = {"
HU
HU
ro
nK
LO
ro
zq
zq
Tt
zq
zq
Qb
Qo
zs
tW
tW
yj
tW
HU
HU
"}
(16,1,1) = {"
HU
HU
ro
zq
te
yI
zq
gV
zq
zs
zq
Qb
Sw
zq
to
tW
tW
HU
HU
HU
"}
(17,1,1) = {"
HU
HU
ro
my
jf
ro
VL
Dq
We
cw
KO
Jz
ro
tW
tW
tW
HU
HU
HU
HU
"}
(18,1,1) = {"
HU
HU
ro
ro
ro
ro
ro
ro
ro
ro
ro
ro
ro
yj
HU
HU
HU
HU
HU
HU
"}
(19,1,1) = {"
HU
HU
HU
HU
HU
HU
HU
HU
HU
HU
HU
HU
HU
HU
HU
HU
HU
HU
HU
HU
"}
(20,1,1) = {"
HU
HU
HU
HU
HU
HU
HU
HU
HU
HU
HU
HU
HU
HU
HU
HU
HU
HU
HU
HU
"}
