//MAP CONVERTED BY dmm2tgm.py THIS HEADER COMMENT PREVENTS RECONVERSION, DO NOT REMOVE
"a" = (
/turf/simulated/mineral/icerock/ignore_cavegen/lythios43c,
/area/rift/surfacebase/outside/west_caves)
"c" = (
/obj/random/outcrop,
/turf/simulated/mineral/floor/ignore_cavegen/lythios43c,
/area/rift/surfacebase/outside/west_caves)
"f" = (
/obj/machinery/crystal/ice,
/turf/simulated/mineral/floor/icerock/lythios43c/indoors/ignore_cavegen,
/area/rift/surfacebase/outside/west_caves)
"q" = (
/turf/simulated/mineral/floor/ignore_cavegen/lythios43c,
/area/rift/surfacebase/outside/west_caves)
"L" = (
/turf/template_noop,
/area/template_noop)
"M" = (
/turf/simulated/mineral/ignore_cavegen/lythios43c,
/area/rift/surfacebase/outside/west_caves)
"W" = (
/turf/simulated/mineral/floor/icerock/lythios43c/indoors/ignore_cavegen,
/area/rift/surfacebase/outside/west_caves)

(1,1,1) = {"
L
L
L
L
L
L
L
W
a
a
a
a
a
a
L
L
L
W
W
W
"}
(2,1,1) = {"
L
L
L
L
L
L
W
W
a
a
a
a
a
a
a
a
W
W
W
W
"}
(3,1,1) = {"
L
L
L
L
W
W
W
a
a
a
a
W
W
a
a
W
W
W
W
W
"}
(4,1,1) = {"
L
L
L
W
W
a
a
a
a
a
W
W
W
W
W
W
W
W
W
L
"}
(5,1,1) = {"
L
L
a
a
a
a
a
a
W
W
W
W
W
W
W
W
W
a
a
L
"}
(6,1,1) = {"
L
a
a
a
a
a
W
W
f
W
W
W
W
W
W
W
W
a
a
a
"}
(7,1,1) = {"
L
a
a
a
a
W
W
W
W
W
q
c
W
W
W
f
W
a
a
a
"}
(8,1,1) = {"
a
a
a
a
W
W
W
W
W
q
q
q
q
W
W
W
W
W
a
a
"}
(9,1,1) = {"
a
a
W
W
W
W
W
W
q
q
M
q
q
c
W
W
W
W
a
a
"}
(10,1,1) = {"
a
a
W
f
W
W
W
q
q
M
M
M
q
q
q
W
W
a
a
L
"}
(11,1,1) = {"
a
a
W
W
W
W
c
q
M
M
M
q
q
c
W
W
W
a
a
L
"}
(12,1,1) = {"
a
a
W
W
W
W
q
q
M
M
q
q
q
W
W
W
a
a
a
L
"}
(13,1,1) = {"
a
a
a
W
f
W
q
q
q
q
q
W
W
W
W
W
a
a
L
L
"}
(14,1,1) = {"
a
a
a
W
W
W
W
c
q
W
W
W
W
W
f
W
a
a
L
L
"}
(15,1,1) = {"
a
a
a
W
W
W
W
W
W
W
W
W
W
W
W
a
a
L
L
L
"}
(16,1,1) = {"
a
a
W
W
W
W
f
W
W
W
W
W
W
W
a
a
a
L
L
L
"}
(17,1,1) = {"
L
W
W
W
W
W
W
W
W
a
a
W
W
W
W
W
L
L
L
L
"}
(18,1,1) = {"
L
L
W
W
a
a
a
a
a
a
a
a
W
W
W
L
L
L
L
L
"}
(19,1,1) = {"
L
L
L
a
a
a
a
a
a
a
a
a
L
L
L
L
L
L
L
L
"}
(20,1,1) = {"
L
L
L
L
L
L
a
a
a
a
a
L
L
L
L
L
L
L
L
L
"}
