//MAP CONVERTED BY dmm2tgm.py THIS HEADER COMMENT PREVENTS RECONVERSION, DO NOT REMOVE
"a" = (
/turf/template_noop,
/area/template_noop)
"j" = (
/obj/structure/table/hardwoodtable,
/turf/simulated/floor/tiled/lythios43c,
/area/space)
"k" = (
/obj/item/storage/briefcase/inflatable{
	pixel_x = -2;
	pixel_y = -2
	},
/obj/structure/table/rack,
/turf/simulated/floor/lythios43c/indoors,
/area/space)
"r" = (
/obj/structure/table/rack,
/turf/simulated/floor/lythios43c/indoors,
/area/space)
"s" = (
/turf/simulated/floor/lythios43c/indoors,
/area/space)
"t" = (
/turf/simulated/mineral/floor/icerock/lythios43c/indoors/ignore_cavegen,
/area/rift/surfacebase/outside/west_caves)
"v" = (
/obj/random/crystal/ice,
/turf/simulated/mineral/floor/icerock/lythios43c/indoors/ignore_cavegen,
/area/rift/surfacebase/outside/west_caves)
"x" = (
/turf/simulated/floor/carpet/arcadecarpet/lythios43c,
/area/space)
"B" = (
/obj/random/crystal/normal_ice,
/turf/simulated/mineral/floor/icerock/lythios43c/indoors/ignore_cavegen,
/area/rift/surfacebase/outside/west_caves)
"D" = (
/turf/simulated/floor/tiled/lythios43c,
/area/space)
"E" = (
/obj/machinery/door/airlock,
/turf/simulated/floor/tiled/lythios43c,
/area/space)
"G" = (
/obj/machinery/door/airlock/external/glass,
/turf/simulated/floor/lythios43c/indoors,
/area/space)
"I" = (
/obj/machinery/door/airlock/external,
/obj/effect/overlay/snow/airlock,
/turf/simulated/floor/lythios43c/indoors,
/area/space)
"M" = (
/obj/structure/girder,
/turf/simulated/floor/lythios43c/indoors,
/area/space)
"O" = (
/turf/simulated/wall/lythios43c,
/area/space)
"V" = (
/obj/structure/girder/displaced,
/turf/simulated/floor/lythios43c/indoors,
/area/space)
"X" = (
/obj/machinery/power/apc,
/turf/simulated/floor/lythios43c/indoors,
/area/space)

(1,1,1) = {"
a
a
a
a
a
a
a
a
a
a
a
a
a
a
a
a
a
a
a
a
"}
(2,1,1) = {"
a
a
O
O
O
O
O
O
O
O
O
O
O
t
v
t
a
a
a
a
"}
(3,1,1) = {"
a
a
O
j
D
D
D
O
x
x
x
x
O
t
t
t
a
a
a
a
"}
(4,1,1) = {"
a
a
O
j
D
D
D
E
x
x
x
x
O
B
t
t
t
v
a
a
"}
(5,1,1) = {"
a
a
O
j
D
D
D
O
x
x
x
x
O
t
t
t
t
t
a
a
"}
(6,1,1) = {"
a
a
O
j
D
D
D
O
x
x
x
x
O
t
v
t
t
t
a
a
"}
(7,1,1) = {"
a
a
O
D
D
D
D
O
O
O
O
O
O
t
t
t
B
t
B
a
"}
(8,1,1) = {"
a
a
O
D
D
D
D
D
M
s
s
s
O
t
t
t
t
t
t
a
"}
(9,1,1) = {"
a
a
O
D
D
D
D
D
G
s
s
s
I
t
t
t
t
t
t
a
"}
(10,1,1) = {"
a
a
O
D
D
D
D
D
G
s
s
s
I
t
t
t
v
t
B
a
"}
(11,1,1) = {"
a
a
O
D
D
D
D
D
O
s
s
D
O
t
B
t
t
t
t
a
"}
(12,1,1) = {"
a
a
O
O
O
O
E
M
O
V
V
M
O
t
t
t
t
B
a
a
"}
(13,1,1) = {"
a
a
O
s
s
O
D
D
D
s
s
s
O
t
t
t
t
t
a
a
"}
(14,1,1) = {"
a
a
O
s
s
O
s
s
s
s
s
s
O
t
t
t
t
t
a
a
"}
(15,1,1) = {"
a
a
O
X
s
s
s
s
s
s
s
s
O
v
t
t
B
t
a
a
"}
(16,1,1) = {"
a
a
O
s
s
O
s
s
s
s
s
s
O
t
t
t
t
a
a
a
"}
(17,1,1) = {"
a
a
O
s
s
O
s
r
k
r
r
s
O
t
t
t
a
a
a
a
"}
(18,1,1) = {"
a
a
O
O
O
O
O
O
O
O
O
O
O
B
a
a
a
a
a
a
"}
(19,1,1) = {"
a
a
a
a
a
a
a
a
a
a
a
a
a
a
a
a
a
a
a
a
"}
(20,1,1) = {"
a
a
a
a
a
a
a
a
a
a
a
a
a
a
a
a
a
a
a
a
"}
