//MAP CONVERTED BY dmm2tgm.py THIS HEADER COMMENT PREVENTS RECONVERSION, DO NOT REMOVE
"a" = (
/turf/simulated/floor/outdoors/safeice/lythios43c/indoors,
/area/submap/lythios/west_caves/small_crystal)
"m" = (
/obj/machinery/crystal/ice,
/turf/simulated/floor/outdoors/safeice/lythios43c/indoors,
/area/submap/lythios/west_caves/small_crystal)
"w" = (
/turf/template_noop,
/area/template_noop)
"C" = (
/obj/machinery/crystal/lava,
/turf/simulated/floor/outdoors/safeice/lythios43c/indoors,
/area/submap/lythios/west_caves/small_crystal)
"Q" = (
/obj/machinery/crystal,
/turf/simulated/floor/outdoors/safeice/lythios43c/indoors,
/area/submap/lythios/west_caves/small_crystal)

(1,1,1) = {"
w
w
a
a
w
w
"}
(2,1,1) = {"
w
a
m
a
Q
w
"}
(3,1,1) = {"
Q
a
a
a
a
a
"}
(4,1,1) = {"
a
a
C
a
a
w
"}
(5,1,1) = {"
w
Q
a
a
m
w
"}
(6,1,1) = {"
w
w
w
a
w
w
"}
