//MAP CONVERTED BY dmm2tgm.py THIS HEADER COMMENT PREVENTS RECONVERSION, DO NOT REMOVE
"a" = (
/turf/simulated/floor/outdoors/safeice/lythios43c/indoors,
/area/submap/lythios/west_caves/cavern4)
"b" = (
/turf/simulated/mineral/icerock/lythios43c/indoors,
/area/submap/lythios/west_caves/cavern4)
"d" = (
/obj/machinery/crystal/ice,
/turf/simulated/floor/outdoors/safeice/lythios43c/indoors,
/area/submap/lythios/west_caves/cavern4)
"u" = (
/turf/template_noop,
/area/submap/lythios/west_caves/cavern4)
"H" = (
/obj/random/outcrop,
/turf/simulated/mineral/floor/lythios43c/indoors,
/area/submap/lythios/west_caves/cavern4)
"L" = (
/turf/simulated/mineral/lythios43c,
/area/submap/lythios/west_caves/cavern4)
"U" = (
/turf/simulated/mineral/floor/lythios43c/indoors,
/area/submap/lythios/west_caves/cavern4)
"V" = (
/turf/template_noop,
/area/template_noop)

(1,1,1) = {"
V
V
V
V
V
V
V
V
V
V
V
V
b
b
b
b
b
b
V
V
V
V
V
V
V
V
V
V
V
V
"}
(2,1,1) = {"
V
V
V
V
V
V
V
b
b
b
b
b
b
b
b
b
b
b
b
b
b
b
b
V
V
V
V
V
V
V
"}
(3,1,1) = {"
V
V
V
u
u
a
a
a
b
b
a
a
a
a
a
a
a
a
a
a
b
b
a
a
a
a
b
b
b
V
"}
(4,1,1) = {"
V
V
V
u
a
a
a
a
a
a
a
a
a
a
a
a
a
a
a
a
a
a
a
a
a
a
b
b
b
b
"}
(5,1,1) = {"
V
V
b
a
a
a
a
a
a
a
a
a
a
a
a
a
a
a
a
d
a
a
a
a
a
a
a
a
b
b
"}
(6,1,1) = {"
V
b
b
a
a
a
a
a
a
a
a
a
a
a
a
a
a
a
a
a
a
a
a
a
a
a
a
a
a
b
"}
(7,1,1) = {"
V
b
b
a
a
a
a
a
a
a
a
a
a
a
a
a
a
a
a
a
a
a
a
a
a
a
a
a
a
b
"}
(8,1,1) = {"
b
b
d
a
a
a
a
a
a
a
a
a
d
a
a
a
a
a
a
a
a
a
a
a
a
a
a
a
a
a
"}
(9,1,1) = {"
b
b
a
a
a
a
a
a
a
a
a
a
a
a
a
a
H
U
U
U
U
a
a
a
a
a
a
a
a
a
"}
(10,1,1) = {"
b
b
a
a
a
a
a
a
a
a
a
a
a
a
a
L
L
L
H
U
U
U
a
a
a
a
a
a
d
b
"}
(11,1,1) = {"
V
b
b
a
a
a
a
a
a
a
a
a
a
a
L
L
L
L
L
L
U
U
U
a
a
a
a
a
b
b
"}
(12,1,1) = {"
V
V
b
b
a
a
a
a
a
a
a
a
a
L
L
L
L
L
L
L
L
L
H
a
a
a
a
b
b
V
"}
(13,1,1) = {"
V
V
V
b
b
a
a
a
a
a
a
a
U
L
L
L
L
L
L
L
L
L
a
a
a
a
a
b
b
V
"}
(14,1,1) = {"
V
V
V
b
b
a
a
a
a
a
a
a
U
L
L
L
L
L
L
L
L
L
a
a
a
a
a
b
b
V
"}
(15,1,1) = {"
V
V
V
b
b
a
a
a
a
a
a
a
U
U
L
L
L
L
L
L
L
L
a
a
a
a
b
b
V
V
"}
(16,1,1) = {"
V
V
V
a
a
a
a
a
a
a
a
a
a
H
L
L
L
L
L
L
L
a
a
a
a
b
b
V
V
V
"}
(17,1,1) = {"
V
V
a
a
a
a
a
a
d
a
a
a
a
a
a
L
L
L
L
L
L
a
a
a
a
b
V
V
V
V
"}
(18,1,1) = {"
V
V
a
a
a
a
a
a
a
a
a
a
a
a
a
a
L
L
L
L
a
a
a
a
a
b
b
V
V
V
"}
(19,1,1) = {"
V
V
V
a
a
a
a
a
a
a
a
a
a
a
a
a
a
a
a
a
a
a
a
a
a
a
b
b
V
V
"}
(20,1,1) = {"
V
V
V
b
b
a
a
a
a
a
a
a
a
a
a
a
a
a
a
a
a
a
a
a
a
a
d
b
b
V
"}
(21,1,1) = {"
V
V
V
V
b
b
a
a
a
a
a
a
a
a
a
a
a
a
a
a
a
a
a
a
a
a
a
a
b
V
"}
(22,1,1) = {"
V
V
V
V
b
b
a
a
a
a
a
a
a
a
a
a
a
a
a
a
a
a
a
a
a
a
a
a
b
V
"}
(23,1,1) = {"
V
V
V
V
V
a
a
a
a
a
a
a
a
a
a
a
a
a
a
a
a
a
a
a
a
a
a
a
b
V
"}
(24,1,1) = {"
V
V
V
V
a
a
a
a
a
a
a
a
a
a
a
a
a
a
a
a
a
a
a
a
a
a
a
a
b
b
"}
(25,1,1) = {"
V
V
V
V
b
b
a
a
a
d
a
a
a
a
a
a
a
a
a
a
a
a
a
a
a
a
a
a
a
b
"}
(26,1,1) = {"
V
V
V
b
b
b
a
a
a
a
a
a
a
a
a
a
a
d
a
a
a
a
a
b
a
a
a
a
a
b
"}
(27,1,1) = {"
V
V
V
b
b
b
b
a
a
a
a
a
a
a
a
a
a
a
a
b
b
b
b
b
a
a
a
a
a
a
"}
(28,1,1) = {"
V
V
V
V
b
b
b
a
a
a
a
a
a
a
b
b
b
b
b
b
b
b
b
b
b
b
d
a
a
a
"}
(29,1,1) = {"
V
V
V
V
V
b
b
b
a
a
a
a
b
b
b
b
b
b
b
b
b
b
V
b
b
b
b
b
a
a
"}
(30,1,1) = {"
V
V
V
V
V
V
V
b
b
a
a
a
b
b
V
b
b
b
V
V
V
V
V
V
V
b
b
b
V
V
"}
