//MAP CONVERTED BY dmm2tgm.py THIS HEADER COMMENT PREVENTS RECONVERSION, DO NOT REMOVE
"a" = (
/turf/template_noop,
/area/triumph_away/poi_d/explored)
"b" = (
/turf/simulated/wall,
/area/triumph_away/poi_d/explored)
"c" = (
/obj/machinery/door/airlock/glass_engineering,
/obj/effect/decal/cleanable/dirt,
/turf/simulated/floor/tiled/airless,
/area/triumph_away/poi_d/explored)
"d" = (
/obj/effect/decal/cleanable/dirt,
/turf/simulated/floor/tiled/airless,
/area/triumph_away/poi_d/explored)
"e" = (
/obj/structure/sign/warning/radioactive,
/turf/simulated/wall,
/area/triumph_away/poi_d/explored)
"f" = (
/obj/structure/sign/warning/radioactive,
/obj/effect/map_effect/interval/sound_emitter/geiger/high,
/turf/simulated/wall,
/area/triumph_away/poi_d/explored)
"g" = (
/obj/item/geiger,
/obj/effect/decal/cleanable/dirt,
/turf/simulated/floor/tiled/airless,
/area/triumph_away/poi_d/explored)
"h" = (
/obj/effect/map_effect/radiation_emitter/strong,
/obj/item/poi/brokenoldreactor,
/obj/effect/decal/cleanable/dirt,
/turf/simulated/floor/tiled/airless,
/area/triumph_away/poi_d/explored)
"i" = (
/obj/effect/map_effect/interval/sound_emitter/geiger/ext,
/obj/effect/decal/cleanable/dirt,
/turf/simulated/floor/tiled/airless,
/area/triumph_away/poi_d/explored)
"n" = (
/obj/random/tool/power,
/obj/effect/decal/cleanable/dirt,
/turf/simulated/floor/tiled/airless,
/area/triumph_away/poi_d/explored)
"r" = (
/obj/triumph_away_spawner/D/drone_spawner,
/obj/effect/decal/cleanable/dirt,
/turf/simulated/floor/tiled/airless,
/area/triumph_away/poi_d/explored)

(1,1,1) = {"
a
a
a
a
a
a
a
a
a
"}
(2,1,1) = {"
a
b
b
b
b
b
b
b
a
"}
(3,1,1) = {"
a
e
d
d
d
d
r
b
a
"}
(4,1,1) = {"
a
c
d
d
d
h
d
b
a
"}
(5,1,1) = {"
a
f
g
d
r
i
n
b
a
"}
(6,1,1) = {"
a
c
d
d
d
h
d
b
a
"}
(7,1,1) = {"
a
e
d
r
d
d
r
b
a
"}
(8,1,1) = {"
a
b
b
b
b
b
b
b
a
"}
(9,1,1) = {"
a
a
a
a
a
a
a
a
a
"}
