"a" = (/obj/triumph_away_spawner/D/alien_hard,/turf/simulated/mineral/floor/vacuum,/area/triumph_away/poi_d/unexplored)
"b" = (/turf/simulated/mineral/floor/ignore_cavegen,/area/triumph_away/poi_d/unexplored)
"c" = (/turf/unsimulated/mineral,/area/triumph_away/poi_d/explored)
"d" = (/obj/triumph_away_spawner/D/alien_medium,/turf/simulated/mineral/floor/ignore_cavegen,/area/triumph_away/poi_d/explored)
"f" = (/obj/triumph_away_spawner/D/hound_spawner,/turf/simulated/mineral/floor/vacuum,/area/triumph_away/poi_d/unexplored)
"g" = (/obj/triumph_away_spawner/D/carp_large,/turf/simulated/mineral/floor/vacuum,/area/triumph_away/poi_d/unexplored)
"k" = (/obj/away_mission_init/poi_d,/turf/simulated/mineral/floor/ignore_cavegen,/area/triumph_away/poi_d/explored)
"m" = (/obj/triumph_away_spawner/D/carp_large,/turf/simulated/mineral/floor/ignore_cavegen,/area/triumph_away/poi_d/unexplored)
"o" = (/obj/triumph_away_spawner/D/carp_medium,/turf/simulated/mineral/floor/vacuum,/area/triumph_away/poi_d/unexplored)
"u" = (/obj/triumph_away_spawner/D/carp_medium,/turf/simulated/mineral/floor/ignore_cavegen,/area/triumph_away/poi_d/unexplored)
"v" = (/obj/triumph_away_spawner/D/carp_small,/turf/simulated/mineral/floor/ignore_cavegen,/area/triumph_away/poi_d/unexplored)
"y" = (/obj/effect/overmap/visitable/sector/class_d,/turf/simulated/mineral/vacuum,/area/triumph_away/poi_d/unexplored)
"A" = (/obj/triumph_away_spawner/D/alien_easy,/turf/simulated/mineral/floor/vacuum,/area/triumph_away/poi_d/unexplored)
"D" = (/obj/triumph_away_spawner/D/hound_spawner,/turf/simulated/mineral/floor/ignore_cavegen,/area/triumph_away/poi_d/unexplored)
"E" = (/turf/simulated/mineral/floor/vacuum,/area/triumph_away/poi_d/explored)
"H" = (/turf/simulated/mineral/vacuum,/area/triumph_away/poi_d/explored)
"J" = (/obj/effect/shuttle_landmark/automatic,/turf/simulated/mineral/floor/ignore_cavegen,/area/triumph_away/poi_d/explored)
"K" = (/turf/simulated/mineral,/area/triumph_away/poi_d/unexplored)
"M" = (/obj/triumph_away_spawner/D/alien_easy,/turf/simulated/mineral/floor/ignore_cavegen,/area/triumph_away/poi_d/unexplored)
"N" = (/obj/triumph_away_spawner/D/drone_spawner,/turf/simulated/mineral/floor/vacuum,/area/triumph_away/poi_d/unexplored)
"O" = (/obj/triumph_away_spawner/D/drone_spawner,/turf/simulated/mineral/floor/ignore_cavegen,/area/triumph_away/poi_d/unexplored)
"R" = (/turf/simulated/mineral/floor/vacuum,/area/triumph_away/poi_d/unexplored)
"U" = (/turf/simulated/mineral/floor/ignore_cavegen,/area/triumph_away/poi_d/explored)
"Z" = (/turf/simulated/mineral/vacuum,/area/triumph_away/poi_d/unexplored)

(1,1,1) = {"
cccccccccccccccccccccccccccccccccccccccccccccccccccccccccccccccccccccccccccccccccccccccccccccccccccccccccccccccccccccccccccccccccccccccccccc
cccccccccccccccccccccccccccccccccccccccccccccccccccccccccccccccccccccccccccccccccccccccccccccccccccccccccccccccccccccccccccccccccccccccccccc
ccZZZZZZZZZZZZZZZZZZZZZZZZZZZZZZZZZZZZZZZZZZZZZZZZZZZZZZZZZZZZZZZZZZZZZZZZZZZZZZZZZZZZZZZZZZZZZZZZZZZZZZZZZZZZZZZZZZZZZZZZZZZZZZZZZZZZZZZZcc
ccZZZZZZZZZZZZZZZZZZZZZZZZZZZZZZZZZZZZZZZZZZZZZZZZZZZZZZZZZZZZZZZZZZZZZZZZZZZZZZZZZZZZZZZZZZZZZZZZZZZZZZZZZZZZZZZZZZZZZZZZZZZZZZZZZZZZZZZZcc
ccZZZZZZZZZZRRRZRRRRRRRRRRRZZZZZZZZZZZZZZZZZZZZZZZZZZZZZZZZZZZZZZZZZZZZZZZZZZZZZZZZZZZZZZZZZZZZZZZZZZZZZZZZZZZZZZZZZZZZZZZZZZZZZZZZZZZZZZZcc
ccZZZZZZZZZRRRRRRRRRRRRRRRRRRRZZZZZZZZZZZZZZZZZZZZZZZZZZZZZZZZZZZZZZZZZZZZZZZZZZZZZZZZZZZZZZZZZZZZZZZZZZZZZZZZZZZZZZZZZZZZZZZZZZZZZZZZZZZZcc
ccZZZZZZZZRRRRRRRRRRRRRRRRRRRRRRRZZZZZZZZZZZZZZZZZZZZZZZZZZZZZZZZZZZZZZZZZZZZZZZZZZZZZZZZZZZZZZZZZZZZZZZZZZZZZZZZRRZZZZZRRRZZZZZZZZZZZZZZZcc
ccZZZZZZZRRRRRRRZZZZZZZZZZZZRRRRRRRRZZZZZZZZZZZZZZZZZZZZZZZZZZZZZZZZZZZZZZZZZZZZZZZZZZZZRRRRRRRRRZZZZRRRRZRRZZZRRRRRZZRRRRRRRRRZZZZZZZZZZZcc
ccZZZZZZRRRRRRRZZZZZZZZZZZZZZZZRRRRRRZZZZZZZZZZZZZZZZZZZZZZZZZZZZZZZZZZZZZZZZRRRRRRRRRRRRRRRRRRRRRRRRRRRRRRRRRRRRRRRRRRRRRRRRRRRZZZZZZZZZZcc
ccZZZZZZRRRRRRZZZZZZZZZZZZZZZZZZZZZRRRZZZZZZZZZZZZZZZZZZZZZZZZZZZZZZZZZZZZZZRRRRRRRRRRRRRRRRRRRRRRRRRRRRRRRRRRRRRRRRRRRRRRRRRRRRRRZZZZZZZZcc
ccZZZZZZZRRRRZZZZZZZZZZZZZZZZZZZZZZRRRRZZZZZZZZZZZZZZZZZZZZZZZZZZZZZZZZZZZZRRRRRRRRRRRRRRRRRRRRRRRRRRRRRRRRRRRRRRRRRRRRRRRRRRRRRRRRZZZZZZZcc
ccZZZZZZRRRRRZZZZZZZZZZZZZZZZZZZZZZZRRaZZZZZZZZZZZZZZZZZZZZZZZZZZZZZZZZZZZRRRRRRRRRRRRRRRRRRRZZZZZZZRRRRRRRRRRRRRRRRRRRRRRZRRRRRRRRZZZZZZZcc
ccZZZZZRRRRRZZZZZZZZZZZZZZZZZZZZZZZZRRRRRRRRRRRRRRRRRRRRRZZZZZZZZZZZZZZZRRRRRRRRRRRRRRRRRRRRRRRZZZZRRRRRgRRRRRRRRRRRRRRRZZZRRRRRRRRRZZZZZZcc
ccZZZZZZRRZZZZZZZZZZZZZZZZZZZZZZRZRRRRRRRRRRRRRRRRRRRRRRRRRZZZZbbbbbbbbbbbbbbbbbRRRRRRRRRRRRRRRRZZZRRRRRRRRRRRRRRRRRRRRRZZZZRRRRRRRRZZZZZZcc
ccZZZZZRRRRZZZZZZZZZZZZZZZZZZZRRRRRRRRRRRRRRZRRZRRRRRRRRRRRRRZZbbbbbbbbbbbbbbbbbRRRRZZZZZZZRRRRbbRRRRRRRRRRRRRRRRRRRRRRRRZZZZRRRRRRRZZZZZZcc
ccZZZZZRRRRZZZZZZZZZZZZZZZZRRRRRRRRZZZZZZZZZZZZZZZZRRRRRRRRRRRZbbbbbbbbbbbbbbbbbRRRZZZZZZZZZZRRbbRRRRRZZZZZZZZZZZZRRRRRRRZZZZZRRRRRRZZZZZZcc
ccZZZZZbbRRZZZZZZZZZZZZZZRRRRRRRRZZZZZZZZZZZZZZZZZZZZZZZZRRRRRRbbbbbbbMbbbbbbbbbRRZZZZZZZZZZZRRbbRRRRZZZZZZZZZZZZZZRRRRRRRZZZZRRRRRRZZZZZZcc
ccZZZZZbbRZZZZZZZZZZZZZZRRRRRRZZZZZZZZZZZZZZZZZZZZZZZZZZZZZRRRRbbbbbbbbbbbbbbbbbRZZZZZZZZZZZZRRbbRRRRZZZZZZZZZZZZZZZRRRRRRZZZZRRRRRRZZZZZZcc
ccZZZZZbbRZZZZZZZZZZZZZRRRRRZZZZZZZZZZZZZZZZZZZZZZZZZZZZZZZZZRRbbbbbbbbbbbbbbbbbZZZZZZZZZZZZZRRbbRRRZZZZZZZZZZZZZZZZRRRRRRRRRRRRRRRRZZZZZZcc
ccZZZZZbbRZZZZZZZZZZZRRRRRZZZZZZZZZZZZZZZZZZZZZZZZZZZZZZZZZZZZZZZZZZZRRRRRRRRRRRZZZZZZZZZZZZZRRbbRRZZZZZZZZZZZZZZZZZRRRRRRRRRRRRRRRRZZZZZZcc
ccZZZZZbbaZZZZZZZZZZZRRZZZZZZZZZZZZZZZZZZZZZZZZZZZZZZZZZZZZZZZZZZZZZZRRRRRRRbbbbZZZZZZZZZZZZZRRbbRRZZZZZZZZZZZZZZZZZZRRRRRRRRRRRRRRRZZZZZZcc
ccZZZZZbbRZZZZZZZZZZZRRRZZZZZZZZZZZZZZZZZZZZZZZZZZZZZZZZZZZZZZZZZZZZZZRRRRRRbbbbZZZZZZZZZZZZZRRbbRRZZZZZZZZZZZZZZZZZZZZRRRRRRRRRRRRRZZZZZZcc
ccZZZZZbbRZZZZZZZZZZZRoRZZZZZZZZZZZZZZZZZZZZZZZZZZZZZZZZZZZZZZZZZZZZZZZRRRRRbbbbZZZZZZZZZZZZZRRbbRRZZZZZZZZZZZZZZZZZZZZZZRRRRRRRRRRRZZZZZZcc
ccZZZZZbbRZZZZZZZZZZZRRRRZZZZZZZZZZZZZZZZZZZZZZZZZZZZZZZZZZZZZZZZZZZZZZZZRRRbbbbZZZZZZZZZZZZZRRbbRRZZZZZZZZZZZZZZZZZZZZZZZRRRRRRRRRRZZZZZZcc
ccZZZZZbbRZZZZZZZZZZZRRRZZZZZZZZZZZZZZZZZZZZZZZZZZZZZZZZZZZZZZZZZZZZZZZZZZRRbbbbZZZZZZZZZZZZZRRbbRRZZZZZZZZZZZZZZZZZZZZZZZZZRRRRRRRRZZZZZZcc
ccZZZZZbbRZZZZZZZZZZZRRRRZZZZZZZZZZZZZZZZZZZZZZZZZZZZZZZZZZZZZZZZZZZZZZZZZZRbbbbZZZZZZZZZZZZZRRbbRRZZZZZZZZZZZZZZZZZZZZZZZZZRRRRRRRRZZZZZZcc
ccZZZZZbbRZZZZZZZZZZZZRRRRZZZZZZZZZZZZZZZZZZZZZZZZZZZZZZZZZZZZZZZZZZZZZZZZZRbbbbZZZZZZZZZZZZZRRbbRRZZZZZZZZZZZZZZZZZZZZZZZZZRRRRRRRRZZZZZZcc
ccZZZZZbbRZZZZZZZZZZZZRRRRRZZZZZZZZZZZZZZZZZZZZZZZZZZZZZZZZZZZZZZZZZZZZZZZRRbbbbZZZZZZZZZZZZZRRbbRRZZZZZZZZZZZZZZZZZZZZZZZZZRRRRbbbRZZZZZZcc
ccZZZZZbbZZZZZZZZZZZZZZRRRRRZZZZZZZZZZZZZZZZZZZZRRRRRRRRRRRRZZZZZZZZZZZZZZZRbbbbZZZZZZZZZZZZZRRbbRRZZZZZZZZZZZZZZZZZZZZZZZZZRRRRbbbRZZZZZZcc
ccZZZZZbbRZZZZZZZZZZZZZZRRRRRZZZZZZZZZZZZZZZZZZZRRRRRRRRRRRRZZZZZZZZZZZZZZZRbbbbZZZZZZZZZZZZRRRbbRRRZZZZZZZZZZZZZZZZZZZZZZZRRRRRbmbRZZZZZZcc
ccZZZZZbbRZZZZZZZZZZZZZZZRRRRRRZZZZZZZZZZZZZZZRRRRRRRRRRRRRRZZZZZZZZZZZZZZZRbbbbZZZZZZZZZZZZRRRbbRRRRZZZZZZZZZZZZZZZZZZZZZZRRRRRbbbRZZZZZZcc
ccZZZZZbbRZZZZZZZZZZZZZZRRRRRRRZZZZZZZZZZZZZZZRRRRRRRZZZZRRRZZZZZZZZZZZZZZZRbbbbZZZZZZZZZZZRRRRbbRRRRRZZZZZZZZZZZZZZZZZZZZRRRRRRbbbRZZZZZZcc
ccZZZZZbbRZZZZZZZZZZZZZRRRRRRRRRRRZZZZZZZZZZRRRRRZZZZZZZZZRRZZZZZZZZZZZZZZRRbbbbRZZZZZZZZZZRRRRRRRRRRRRZZZZZZZZZZZZZZZRRRRRRRRRRRRRRZZZZZZcc
ccZZZZZbbRZZZZZZZZZZZZRRRRRZZZRRRRZZZZZZZZRRRRZZZZZZZZZZZZRRRZZZZZZZZZZZZZRRbbbbRRRZZZZZZZZRRRRRRRRRRRRRRRRRRRRRRRRRRRRRRRRRRRRRRRRRRZZZZZcc
ccZZZZZbbRZZZZZZZZZZZRRRRRZZZZZZRRRRZZZZRRRRRZZZZZZZZZZZZZZRRZZZZZZZZZZZZZRRbbbbRRRRRRRRRRRbbbRRZZRRRRRRRRRRRRRRRRRRRRRRRRRRRRRRRRRRRZZZZZcc
ccZZZZZbbRZZZZZZZZZRRRRRRZZZZZZZZRRRRRZRRRRRZZZZZZZZZZZZZZZRRZZZZZZZZZZZZZRRbbbbRRRRRRRRRRRbmbRRZZRRRRRRRRRRRRRRRRRRRRRRRRRRRZZRRRRRRRZZZZcc
ccZZZZZbbRRZZZZZZZRRRRRRZZZZZZZZZRRRRRRRRRRZZZZZZZZZZZZZZZZZRZZZZZZZZZZZZZRRbbbbRRRRRRRRRRRbbbRRRZRRRRRRRRRRRRRRRRRRRRRRRRRRZZZZRRRRRRRZZZcc
ccZZZZZZRRRZZZZZZRRRRRRZZZZZZZZZZZZZRbbbbZZZZZZZZZZZZZZZZZZZRRZZZZZZZZZZZZRRbbbbRRRRZZZZRRRRRRRRRRRRRRRRRZZZZZZZZZRRRRRRRRRRZZZZRRRRRRRZZZcc
ccZZZZZZRRRZZZZZRRRRRZZZZZZZZZZZZZZRRbbbbZZZZZZZZZZZZZZZZZZZZRRZZZZZZZZZZZRRbbbbRRRZZZZZRRRRRRRRRRRRRRRRRZZZZZZZZRRRRRRRRRRRZZZZRRRRRRRZZZcc
ccZZZZZZRRRZZZZRRRRRRZZZZZZZZZZZZZZZRbbubZZZZZZZZZZZZZZZZZZZZRRZZZZZZZZZZZZZZRRRRRRZZZZZZRRRRRRRRRRRRRRRZZZZZZZZRRRRRRRRRRRRRRRRRRRRRRRZZZcc
ccZZZZZZZRRRZZRRRRRRZZZZZZZZZZZZZZZRRbbbbRRZZZZZZZZZZZZZZZZZZRRRRZZZZZZZZZZZZRRRRRRZZZZZZRRRRRRRZZRRRRRZZZZZZZZRRRRRRRZZRRRRRRRRRRRRRRZZZZcc
ccZZZZZZZRRRZRRRRRRZZZZZZZZZZZZZZZRRRbbbbRRRZZZZZZZZZZZZZZZZZZRRRRRZZZZZZZZZZRRRRRRRZZZZZRRRRRZZZZRRRRRZZZZRZZZRRRRRRZZRRRRRRRRRRRRRRZZZZZcc
ccZZZZZZZZRRZRRRRZZZZZZZZZZZZZZZZZRRZZRRRRRRZZZZZZZZZZZZZZZZZZRRRRRRZZZZZZZZZRRRRRRRRRZZZRRRRRZZZZRRRRRRRRRRRRRRRRRRZZZZZRRRRRRRRRRRZZZZZZcc
ccZZZZZZZZRRRRRRRZZZZZZZZZZZZZZZRRRZZZZRRRRRRZZZZZZZZZZZZZZZZZZRRRRRRZZZZZZRRRRRRRRRRRZZZRRRRZZZZZZRRRRRRRRRRRRRRRRZZZZZRRRRRRRRRRRRZZZZZZcc
ccZZZZZZZZRRRRRRRZZZZZZZZZZZZZZZRRZZZZZZRRRRRRZZZZZZZZZZZZZZZZZZRRRRRRRRRRRRRRRRRRRRRRRRRRRRRZZZZZZRRRRRRRRRRRRRRRRZZZZZRRRRRRZZZRRRZZZZZZcc
ccZZZZZZZZZRbuRRRRRZZZZZZZZZZZRRRZZZZZZZZRRRRRRZZZZZZZZZZZZZZZZZZRRRRRRRRRRRRRZZRRRRRRRRRRRRRZZZZZZRRRRRRRRRRRRRRRRZZZZZRRRRRRZZZRRRZZZZZZcc
ccZZZZZZZZZRbbRRRRRRRRRRZZZRRRRZZZZZZZZZZZRRRRRRZZZZZZZZZZZZZZZZZZRRRRRRRRRRRRZZZZRRRRRRRRRRRRZZZZZZZRRRRRRRRRRRRRZZZZZZRRRRRRZZRRRRZZZZZZcc
ccZZZZZZZZRRbbRRZZRRRRRRRRRRRZZZZZZZZZZZZZZRRRRRZZZZZZZZZZZZZZZZZZZZRRRARRRRRRZZZZRRRRRRRRRRRRZZZZZZZZZZZZZZZZZZZZZZZZZZRRRRRZRRRRRRZZZZZZcc
ccZZZZZZZZRRbbRZZZZZZZZRRZRZZZZZZZZZZZZZZZZZRRRRZZZRRRRRRZZZZZZZZZZZZZZZZRRRRRZZZZRRRRRRRRRRRRRZZZZZZZZZZZZZZZZZZZZZZZRRRRRRRRRRRRRRRRZZZZcc
ccZZZZZZZZRRRRRZZZZZZZZZZZZZZZZZZZZZZZZZZZZZRRRRZRRRRRRRRRZZZZZZZZZZZZZZZZZZZZZZZZRRRRRRoRRRRRRZZZZZZZZZZZZZZZZZZZZZZRRRRRRRRRRRRRRRRRRZZZcc
ccZZZZZZZZRRRRZZZZZZZZZZZZZZZZZZZZZZZZZZZZZZZRRRRRRRRRRRRRZZZZZZZZZZZZZZZZZZZZZZZZRRRRRRRRRRRRRRZZZZZZZZZZZZZZZZZZZZZRRRRRRRRRRRRRRRRRRZZZcc
ccZZZZZZZZRRRRZZZZZZZZZZZZZZZZZZZZZZZZZZZZZZZZRRRRRRRRRRRRZZZZZZZZZZZZZZZZZZZZZZZZRRRRRRRRRRRRRRZZZZZZZZZZZZZZZZZZZZZRRRRRRRRRRRRRRRRRRZZZcc
ccZZZZZZZZRRRZZZZZZZZZZZZZZZZZZZZZZZZZZZZZZZZZZZZRRRRRRRRRZZZZZZZZZZZZZZZZZZZZZZZZRRRRRRRRRRRRRRZZZZZZZZZZZZZZZZZZZZZRRRRRRRRRRRRRRRRRRZZZcc
ccZZZZZZZZRRRZZZZZZZZZZZZZZZZZZZZZZZZZZZZZZZZZZZZRRRRRRRRRZZZZZZZZZZZZZZZZZZZZZZZRRRRRRRRZZRRRRRRRZZZZZZZZZZZZZZZZZRRRRRRRRRZZZRRRRRRRRZZZcc
ccZZZZZZZbbbRZZZZZZZZZZZZZZZZZZZZZZZZZZZZZZZZZZZZRRRRRRRRRZZZZZZZZZZZZZZZZZZZZZZZRRRRRRRRZZZRRRRRRRZZZZZZZZZZZZZZZRRRRRRRRZZZZZRRRRRRRZZZZcc
ccZZZZZZZbbbRZZZZZZZZZZZZZZZZZZZZZZZZZZZZZZZZZZZZRRRRRRRRRZZZZZZZZZZZZZZZZZZZZZZRRRRRRRRZZZZZRRRRRRRZZZZZZZZZZZZZZRRRRRRZZZZZZZRRRRRRZZZZZcc
ccZZZZZZZbbbRZZZZZZZZZZZZZZZZZZZZZZZZZZZZZZZZZZZZZRRRRRRRRRZZZZZZZZZZZZZZZZZZZZZRRRRRRRZZZZZZRRRRRRRRRZZZZZZZZZZZRRRRRRRZZZZZZRRRRRRRZZZZZcc
ccZZZZZZZbbbRRZZZZZZZZZZZZZZZZZZZZZZZZZZZZZZZZZZZZZRRRRRRRRRZZZZZZZZZZZZZZZZZZZZRRRRRRRZZZZZRRRRRRRRRRRZZZZZZZZRRRRRRRRZZZZRRRRRRRRRRZZZZZcc
ccZZZZZZZbMbRRZZZZZZZZZZZZRRZZZZZZZZZZZZZZZZZZZZZZZRRRRRRRRRRZZZZZZZZZZZZZZZZZZRRRRRRRZZZZZZRRRRRRRRRRRRRRRRRRRRRRRRRRRRRRRRRRRRRRRRZZZZZZcc
ccZZZZZZZbbbRRRRZZZZZRRRRRRRRRRRRRRZZZZZZZZZZZZZZZZZRRRRRRRRRRZZZZZZZZZZZZZZZZRRRRRRRZZZZZZRRRRRRRRRRRRRRRRRRRRRRRRRRRRRRRRRRRRRRRRRZZZZZZcc
ccZZZZZZRRRRRRRRZZZZRRRRRRRRRRRRRRRRZZZZZZZZZZZZZZbbbbbbbbbbbbbbbbbbbbbRRRRRRRRRRRRRRZZZZRRRRRRRRRRRRRRRRRRRRRRRRbbbbRRRRRRRRRZRRRRRZZZZZZcc
ccZZZZZZRRZZRRRRZZZRRRRRbbbbbbbbbRRRRRRRRRRRRRRRRRbbbbbbbbbbbbbbbbbbbbbRRRRRRRRRRRRRRRRRRRRRRRRRRRRRRRRRRZZRRRRRRbbubRRRRRRRRRRRRRRRZZZZZZcc
ccZZZZZZRRZZRRRZZZZRRRRRbbbbbbbbbRRRRRbbbbbbbbbbbbbbbbbbvbbbbbbbbbbbbbbbbbbbbbRRRRRRRRRRRRRRRRRZZRRRRRRRRZZZZRRRRbbbbRRRRRRRRZZZRRRRZZZZZZcc
ccZZZZZZRRZZRRRRZZZRRRRRbbbbbbbbbRRRRRbbbbbbbbbbbbbbbbbbbbbbbbbbbbbbbbbbbbbbbbRRRRRRRRRRRRRRRRZZZZRRRRRRRRZZZZRRRRRRRZZZZZZZZZZZRRRRRZZZZZcc
ccZZZZZZRRZZZRRRRZZRRRRRbbbbbvbbbRRRRbbbbbbbbbbbbbbbbbbbbbbbbbbbbbbbbbbbbbbbbbRRRRRRRRRRRRRRZZZZZZZZRRRRRRRZZZRRRRRRZZZZZZZZZZZRRRRRRZZZZZcc
ccZZZZZZRRZZZZZZRRRRRRRRbbbbbbbbbRRRRbbbbbbbbbbbbbbbbbbbbbbbbbbbbbbbbbbbbbbbbbRRRRRRRRRRRRRRZZZZZZZZZZZRRRRRRRRRRRRRZZZZZZZZZZZRRRRRRZZZZZcc
ccZZZZZRRRZZZZZZZZRRRRRRbbbbbbbbbRRRRbbbbbbbbbbbbbbbbbbbbbbbbbbbbbbbbbbbbbbbbbRRRRRRRRRRRRZZZZZZZZZZZZZRRRRRRRRRRRRZZZZZZZZZZZZRRRRRRRZZZZcc
ccZZZZZRRRZZZZZZZZZRRRRRRRRRbbbbbRRRRbbbbbbbbbbbbbbbbbbbbbbbbbbbbbbbbbbbbbbbbbRRRRRRRRRRZZZZZZZZZZZZZZZZRRRRRRRRRRRZZZZZZZZZZZRRRRRRRRRZZZcc
ccZZZZZRRRZZZZZZZZZZRRRRRRRRRRRRRRRRRbbbbbbbbbbbbbbbbbbbbbbbbbbbbbbbbbbbbbbbbbRRRRRRRRRRZZZZZZZZZZZZZZZZRRRRRRRRRRRZZZZZZZZZZZRRRRRRRRRZZZcc
ccZZZZZZRRRZZZZZZZZZRRRRRRRRRRRRRRRRRbbbbbbbbbbbbbbbbbbbbbbbbbbbbbbbbbbbbbbbbbRRRRRRRRRZZZZZZZZZZZZZZZZRRRRRRRRRRRRZZZZZZZZZZZRRRRRRRRRRRZcc
ccZZZZZZRRRZZZZZZZZZZZRRRRRRZZZZZZRRRbbbbbbbbbbbbbbbbbbbbbbbbbbbbbbvbbbbbbbbbbRRRRRRRZZZZZZZZZZZZZZZZZZRRRRRRRRRRRRRZZZZZZZZZZRRRRRRRRRRZZcc
ccZZZZZZRRRZZZZZZZZZZZRZZZZZZZZZZRRRRbbbbbbbbbbbbbbbbbbbbbbbbbbbbbbbbbbbbbbbbbRRRRRRZZZZZZZZZZZZZZZZZZZRRRRRRRRRRRRRRRRRZZZZZRRRRRRRRRRRRZcc
ccZZZZZZZRRZZZZZZZZZZZZZZZZZZZZZZRRRRbbbbbbbbbbbbbbbbbbbbbbbbbbbbbbbbbbbbbbbbbRRRRRZZZZZZZZZZZZZZZZZZZRRRRRRRRRRRRRRRRRRRRZZRRRRRRRRRRRRZZcc
ccZZZZZZZRRRRZZZZZZZZZZZZZZZZZZZZRbbbbbbbbbbbbbbbbbbbbbbbbbbbbbbbbbbbbbbbbbbbbRRRRRRRZZZZZZZZZZZZZZZRRRRRRRRZZZZZRRRRRRRRRRRRRRRRRRRZRRRZZcc
ccZZZZZZZZRRRRZZZZZZZZZZZZZZZZZZRRbbbbbbbbbbbbbbbbbbbbbbbbbbbbbbbbbbbbbbbbbbbbRRRRRRRRRZZZZZZZZZZRRRRRRRRRRRRZZZZRRRRRRRRRRRRRRRRRRZZZRRZZcc
ccZZZZZZZZRRRRRZZZZZZZZZZZZZZZZRRRbbbbbbvbbbbbbbbbbbbbbbbbbbbbbbbbbbbbbbbbbbbbRRRRRRRRRRRZZZZZRRRRRRRRRRRRRRRRRRRRRRRRRRRRRRRRRRRRRZZZRRZZcc
ccZZZZZZZZZRRRRRZZZZZZZZZZZZZZZRRRbbbbbbbbbbbbbbbbbbbbbbbbbbbbbbbbbbbbbbbbbbbbRRRRRRRRRRRRRRRRRRRRRRRRRRRRRRRRRRRRRRRRRRRRRRRRRRRRRZZRRRZZcc
ccZZZZZZZZZZRRRRRZZZZZZZZZZZZZRRRRbbbbbbbbbbbbbbbbbbbbbbbbbbbbbbbbbbbbbbbbbbbbRRRRRRRRRRRRRRRRRRRRRRRRRRRRRRRRRRRRRRRRRRRRRRRRRRRRRRRRRZZZcc
ccZZZZZZZZZZRRRRRZRZZZZZZZZZZZRRRRbbbbbbbbbbbbbbbbbbbbbbbbbbbbbbbbbbbbbbbbbbbbRRRRRRRRRRRRRRRRRRRRRRoRRRRRRRRRRRRRRRRRRRRRRRRRRRRRRbbbRZZZcc
ccZZZZZZZZZZRRRRRRRRRZZZZZZZZRRRRRbbbbbbbbbbbbbbbbbbbbbbbbbbbbbbbbbbbbbbbbbbbbRRRRRRRRRRRRRRRRRRRRRRRRRRRRRRRRRRRRRRRRRRRRRRRZZZRRRbubRZZZcc
ccZZZZZZZZZZRRRZRRRRRRRZZZZZZRRRRRbbbbbbbbbbbbbbbbbbbbbbbbbbbbbbbbbbbbbbbbbbbbRRRRRRRRRRRRRRRRRRRRRRRRRRRRRRRRRRRRRRRRRRRRRRZZZZRRRbbbRZZZcc
ccZZZZZZZZZZRRRZZZZRRRRRRRRZZRRRRRbbbbbbbbbbbbbbbbbbbbbbbbbbbbbbbbbbbbbbbbbbbbRRRRRRRRRRRRRRRRRRRRRRZZRZZZZZZRZRRRRRRRRRRRRZZZZZZRRbbbRZZZcc
ccZZZZZZZZZRRRZZZZZZZZZRRRRRRRRRRRRRRbbbbbbbbbbbbbbbbbbbbbbbbbbbbbbbbbbbbbbbbbRRRRRRRRRRRRRRRRRRRZZZZZZZZZZZZZZZZZRRRRRRRRRZZZZZZRRRRRRRRZcc
ccZZZZZZZZZRRRKKKKKKKKKZZZRRRRRRRRRRRbbbbbbbbbbbbbbbbbbbbbbbbbbbbbbbbbbbbbbbbbRRRRRRRRRRRRRRRZZZZZZZZZZZZZZZZZZZZZZZZRRRRRRRZZZZZRRRRRRRRZcc
ccZZZZZZZRRRRZZZZZZZZZZZZZZRRRRRRRRRRbbbbbbbbbbbbbbbbbbbbbbbbbbbbbbbbbbbbbbbbbRRRRRRRRRRRRRZZZZZZZZZZZZZZZZZZZZZZZZZZZZZRRRRRRZZZZZRRRRZZZcc
ccZZZZZZbbbRZZZZZZZZZZZZZZZRRRRRRRRRRbbbbbbbbbbbbbbbbbbbbbbbbbbbbbbbbbbbbvbbbbRRRRRRRRRRZZZZZZZZZZZRRRRRZZRRRRRRRRRZZZZZZZRRRRZZZZZZZZZZZZcc
ccZZZZZRbMbZZZZZZZZZZZZZZZZRRRRRRRRRRbbbbbbbbbbbbbbbbbbbbbbbbbbbbbbbbbbbbbbbbbRRRRRRRRRZZZZZZZZRRRRRRRRRRRRRRbbbbbRRRRRZZZZRRRRRZZZZZZZZZZcc
ccZZZZZRbbbRZZZZZZZZZZZZZZZRRRRRRRRRRbbbbbbbbbbbbbbbbbbbbbbbbbbbbbbbbbbbbbbbbbRRRRRRRZZZZZZRRRRRRRRRRRRRRRRRRObbbbRRRRRRZZZZZRRRZZZZZZZZZZcc
ccZZZZZRRRZRRRZZZZZZZZZZZZZRRRRRRRRRRbbbbbbbbbbbbbbbbbbbbbbbbbbbbbbbbbbbbbbbbbRRRRRZZZZZZRRRRRRRRRRRRRRRRRRZZRRRRRRRRRRRRRZZZZRRRZZZZZZZZZcc
ccZZZZRRRRZRRRRZZZZZZZZZZZZRRRRRRRRRRbbbbbbbbbbbbbbbbbbbbbbbbbbbbbbbbbbbbbbbbbRRRRZZZZZZRRRRRRRRRRZRRRRRZRRRRRRRRRRRRRRRRRRZZZZRRZZZZZZZZZcc
ccZZZZRRRZZZRRRRZZZZZZZZZZZRRRRRRRRRRbbbbbvbbbbbbbbbbbbbbbbbbbbbbbbbbbbbbbbbbbRRRRZZZRRRRRRRRRZRRRRRRRRRRRRRRRRRRRRRRRRRRRRRRZZRRRZZZZZZZZcc
ccZZZRRRRZZZZRRRRZZZZZZZZZZZRRRRRRRRRbbbbbbbbbbbbbbbbbbbbbbbbbbbbbbbbbbbbbbbbbRRRRZZZRRRRRRRRRRRRRRRRRRRRRRRRRRRRRZZZRRRRRRRRRZZRRRZZZZZZZcc
ccZZZRRRRZZZZZZRRZZZZZZZZZZZZRRRRRRRRbbbbbbbbbbbbbbbbbbbbbbbbbbbbbbbbbbbbbbbbbRRZZZZZRRRRZRRRbbbbbbbRRRRRRRRRRRRRRRRRRRRRRRRRRZZZRRRZZZZZZcc
ccZZZRRRRZZZZZZZRRZZZZZZZZZZZRRRRRRRRbbbbbbbbbbbbbbbbbbbbbbbbbbbbbbbbbbbbbbbbbRRZZZZRRRRRRRRRbbbbbbbRRRRRRRRRRRRRRRRbbbbbbRRRRRZZRRRZZZZZZcc
ccZZZRRRRZZZZZZZRRRZZZZZZZZZZZRRRRRRRbbbbbbbbbbbbbbbbbbbbbbbbbbbbbbbbbbbbbbbbbRZZZZZRRRRRRRRRbbbDbbbRRZZRRRRZZZRRRRRbbbbbbRRRRRRZZRRZZZZZZcc
ccZZZRRRRZZZZZZZZRRRZZZZZZZZZZZZRRRRRbbbbbbbbbbbbbbbbbbbbbbbbbbbbbbbbbbbbbbbbbRZZZZZRRRRRRRRRbbbbbbbRZZRRRRRRRZZRRRRbbbbbbRRRRRRRZRRZZZZZZcc
ccZZZRRRRZZZZZZZZZRRZZZZZZZZZZZZZZRRRbbbbbbbbbbbbbbbbbbbbbbbbbbbbbbbbbbbbbbbbRZZZZZRRRRZRRRRRbbbbbbbRRRRRRRRRRRRRRRRRRRRRRRRZRRRRRRRZZZZZZcc
ccZZZZRRRZZZZZZZZZRRZZZZZZZZZZZZZZRRRbbbbbbbbbbbbbbbbbbbbbbbbbbbbbbbbbbbbbbbbRZZZZRRRRRRRRRRRRRRRRbbbbbbbbbbbbbbbbRRRRRRRRRRRRRRRRRRRZZZZZcc
ccZZZZRRRZZZZZZZZZZRRZZZZZZZZZZZZZZZRbbbbbbbbbbbbbbbbbbbbbbbbbbbbbbbbbbbbbbbbRZZZRRRZRRRRRRRRRRRRRbbbbbbbbbbbbbbbbRRRZRRRRRRRRRRRRRRRZZZZZcc
ccZZZZRRRZZZZZZZZZZRRZZZZZZZZZZZZZZZRbbbbbbbbbbbbbbbbbbbbbbbbbbbbbbbbbbbbbbbbZZZRRRZZRRRRRRZZZRRbbbbbbbbbbbbbbbbbbRRRZZZRRRRRRRRRRRRRZZZZZcc
ccZZZZRRRZZZZZZZZZZRRZZZZZZZZZZZZZZZZbbbbbbbbbbbbbbbbbbbbbbbbbbbbbbbbbbbbbbbbZZRRRRRRRRRRRZZZRRRbbbbbbbbbbbbbbbbbbRRRRRRRRRRRRRRRRRRRZZZZZcc
ccZZZZRRRZZZZZZZZZZRRZZZZZZZZZZZZZZZZbbbbbbbbbbbbbbbbbbbbbbbbbbbbbbbbbbbbbbbbZZRRRRRRRRRRRZZRRRRbbbbbbbbbbbbbbbbbbRRRRRRRRRRRRRRRRRRRZZZZZcc
ccZZZZRRRZZZZZZZZZZRRZZZZZZZZZZZZZZZZZZZRRRRRRRRRRRRRRRRRbbbbbbbbbbbbbbRRRRRRZZRRRRRRRRRRRZRRRRRbbbbbbbbbbbbbbbbbbRRRRRRRZZRRRRRRRRRRRZZZZcc
ccZZZZRRRRZZZZZZZZZRRRZZZZZZZZZZZZZZZZZZZRRRRRRRRRRRRRRRRbbbbbbbbbbbbbbRRRRRZZZRRRRRRRRRRRRRRRRRbbbbbbbbbbbbbbbbbbRRRRRRRRZRRRRRRZZRRRZZZZcc
ccZZZZRRRRZZZZZZZZZRRRZZZZZZZZZZZZZZZZZZZZZRRRRRRRRRRRRRRbbbbbbbbbbbbbbRRRRRZZZRRRRRRRRRRRRRRRRRbbbbbbbbbbbbbbbbbbbbbbbbRRRRRRRRRRZRRRZZZZcc
ccZZZZZRRRRZZZZZZZZRRRRZZZZZZZZZZZZZZZZZZZZZRRRRRRRRRRRRRbbbbbbbbbbbbbbRRRRRZZZRRRZRRRRRRRRRRRRRbbbbbbbbbbbbbbbbbbbbbbbbRRRRRRRRRRRRRRZZZZcc
ccZZZZZRRRRZZZZZZZZZRRRZZZZZZZZZZZZZZZZZZZZZRRRRRRRRRRRRRbbbbbbbbbbbbbbRRRRRZZZRRRRRRRRRRRRRRRRRbbbbbbbbbbbbbbbbbbbbbbbbRRRRRRRRRRRRRRZZZZcc
ccZZZZZRRRRZZZZZZZZZRRRRZZZZZZZZZZZZZZZZZZZZZRRRRRRRRRRRRbbbbbbbbbbbbbbZZRRRRZZRRRRRRRRRRRRRRRRRbbbbbbbbbbbbbbbbbbbbbbbbRRRRRRRRRRRNRRZZZZcc
ccZZZZZRRRRZZZZZZZZZRRRRZZZZZZZZZZZZZZZZZZZZZZRRRRRRRRRRRbbbbbbbbbbbbbbZZRRRRZZRRRRRRRRRRRRRRRRRbbbbbbbbbbbbbbbbbbbbbbbDRRRRRRRRRRRRRRZZZZcc
ccZZZZZZRRRZZZZZZZZZZRRRZZZZZZZZZZZZZZZZZZZZZZZRRRRRRRRRRbbbbbbbbbbbbbbZZRRRRZZZRRRRRRRRRRRRRRRRbbbbbbbbbbbbbbbbbbbbbbbbRRRRZRRRRRRRRRZZZZcc
ccZZZZZZRRRZZZZZZZZZZZRRRZZZZZZZZZZZZZZZZZZZZZZZRRRRRRRRRbbbbbbbbbbbbbbZZRRRRRRZRRRRRRRRRRRRRRRRbbbbbbbbbbbbbbbbbbbbbbbbRRRRZRRRRZRRZRZZZZcc
ccZZZZZZZRRZZZZZZZZZZZZRRRZZZZZZZZZZZZZZZZZZZZZZZZRRRRRRRbbbbbbbbbbbbbbZZRRRRRRRRRRRZZRRRRRRRRRRbbbbbbbbbbbbbbbbbbbbbbbbRRRZZRRRRRRRRRZZZZcc
ccZZZZZZZRRZZZZZZZZZZZZZRRRZZZZZZZZZZZZZZZZZZZZZZRRRRRRRRbbbbbbbbbbbbbbRZZRRRRRRZRRRZZRRRRRRRRRRbbbbbbbbbbbbbbbbbbbbbbbbRRRZZRRRRRRRRRZZZZcc
ccZZZZZZZRRZZZZZZZZZZZZZZRRZZZZZZZZZZZZZZZZZZZZZZEEEEHEEEUUUUUUUUUUUUUUEHHHEEEHHHHRRRRRRRRRRRbbbbbbbbbbbbbbbbbbbbbRRRRRRRRRZZRRRRRRRRRZZZZcc
ccZZZZZZZRRRZZZZZZZZZZZZZZRRZZZZZZZZZZZZZZZZZRRRREHHHHEEEEEEEEEEEEEEEEEEEHHHHHHEEHZZZRRRRRRRRbbbbbbbbbbbbbbbbbbbbbRRRRRRRRRRRRRRRRRRRRZZZZcc
ccZZZZZZZRRRZZZZZZZZZZZZZZRRRZZZZZZZZZZZZZZRRRRRRHHHHHHEEEEEEEEEEEEEEEEEEEHHEHHHHHZZZRRRRRRRRbbbbbbbbbbbbbbbbbbbbbRRRRRRRRRRRRRRRRRRRZZZZZcc
ccZZZZZZZRRRZZZZZZZZZZZZZZZRRZZZZZZZZZZZZZRRRRRZZHHHHHHEEEEEEEEEEEEEEEEEEEEEEHHHHHZZZRRRRRRRRbbbbbbbbbbbbbbbbbbbbbRRRRRRRRRRRRRRRRRRRZZZZZcc
ccZZZZZZZRRRZZZZZZZZZZZZZZZRRRZZZZZZZZZZZRRRRZZZZHHHHHEEEEEEEEEEEEEEEEEEEEEEEEEHHHRZZRRRRZZZRbbbDbbbbbRRRRRRRRRRRRRRRRRRRRRRRRRRRRRRRZZZZZcc
ccZZZZZZZZRRRZZZZZZZZZZZZZZZRRRZZZZZZZZZRRRZZZZZZHHHUUUUUUUUUUUUUUUUUUUUUUUUUUUHHHZZZRRRRRZZRbbbbbbbbbRRRRRRRRRRRRRRRRRRRRRRRRRZZRRRZZZZZZcc
ccZZZZZZZZRRRRZZZZZZZZZZZZZZZRRZZZZZRRRRRRZZZZZZZHHHUUUUUUUUUUUUUUUUUUUUUUUUUUUHHEZRZZRRRRRRbbbbbbRRRRRRRRRRRRRRRRRRRRRRRRRRRRRRRRRRZZZZZZcc
ccZZZZZZZZZRRRRZZZZZZZZZZZZRRRRRRRRARRRRRRZZZZZZZHHHUUUUUUUUUUUUUUUUUUUUUUUUUUUHHERZZZRRRRRRbbbbbbRRRRRRRRRRRRRRRRRRRRRRRRRRRRRRRRRZZZZZZZcc
ccZZZZZZZZZRRRRRZZZZZZZRRRRRRRRRRRRRZZZZRRZZZZZZZHHEUUUUUUUUUUUUUUJUUUUUUUUUUUUHHERZRZZRRRRRbbbbbbRRRRRRRRRRRRRRRRRRRRRRRRRRRRRRRRZZZZZZZZcc
ccZZZZZZZZZZRRRRRRRRRRRRRRRRRRRRZZZZZZZZRRZZZZZZZHHHUUUUUUUUUUUUUUUUUUUUUUUUUUUHHERZZZRRRRRRbbbbbbZRRRRRRRRRRRRRRRRRRZZZRRRRRRRRRRZZZZZZZZcc
ccZZZZZZZZZZZRRARRRRRRRRRRRRZZZZZZZZZZZZZRRZZZZZZHHHUUUUUUUUUUUUUUUUUUUUUUUUUUUHHHZRZZZRRRRRbbbbbbZZRRRRRRRRZZRRRRRRZZRRRRfRZRRRRZZZZZZZZZcc
ccZZZZZZZZZZZRRRRZZRZZZRZZZZZZZZZZZZZZZZZRRRRZZZZHHEUUUUUUUUUUUUUUUUUUUUUUUUUkUHHHZZZRZZRRRRbbbbbbRRZZRRRRRRZZZRRRRRRRRRRRRRRRRRZZZZZZZZZZcc
ccZZZZZZZZZZZZRRRZZZZZZZZZZZZZZZZZZZZZZZZRRRRZZZZHHHUUUUUUUUUUUUUUUUUUUUUUUUUUUHHHZZRRRRRRRRRRRRRRRRRRRRRRRRRRRRRRRRRRRRRRRRRRRZZZZZZZZZZZcc
ccZZZZZZZZZZZZRRRZZZZZZZZZZZZZZZZZZZZZZZZZRRRZZZZHHHUUUUUUUUUUUUUUUUUUUUUUUUUUUHHHZZZRRRRRRRRRRRRRRRRRRRRRRRRRRRRRRRRRRRRRRRRRZZZZZZZZZZZZcc
ccZZZZZZZZZZZZZRRRZZZZZZZZZZZZZZZZZZZZZZZZZRRZZZZHHHUUUUUUUUUUUUUUUUUUUUUUUUUUUHHHZZZRRRRRRRRZRRRRRRRRRRRRRRRRRRRRRRRRRRRRRRZZZZZZZZZZZZZZcc
ccZZZZZZZZZZZZZRRRRRZZZZZZZZZZZZZZZZZZZZZZZRRZZZZHHHUUUUUUUUUUUUUUUUUUUUUUUUUUUHHHZZZRRRRRRRRRRRRRRRRRRRRRRRRRRRRRRRRRZRRRRZZZZZZZZZZZZZZZcc
ccZZZZZZZZZZZZZZRRRRZZZZZZZZZZZZZZZZZZZZZZZZRZZZZHHHUUUUUUUUUUUUUUUUUUUUUUUUUUHHHHZRRRZZZZRRRRRRRRRRZRRRRRRRRRRRRRRRRRRRRRZZZZZZZZZZZZZZZZcc
ccZZZZZZZZZZZZZZZRRRRRRRZZZZZZZZZZZZZZZZZZZZRRZZZHHHHUUUUUUUUUUUUUUUUUUUUUUUUUHHHHZRRRZZZZZRRRRRRRRRZRRRRRRRRRRRRZRRRRRRRZZZZZZZZZZZZZZZZZcc
ccZZZZZZZZZZZZZZZZRRRRRRRRRRRRRRRZZZZZZZZZZZRRRZZHHHHUUUUUUUUUUUUUUUUUUUUUUUUUHHHHRRRRZZZZZZZRRRRRRRRRRRRRZZRRRRRRRRRRRZZZZZZZZZZZZZZZZZZZcc
ccZZZZZZZZZZZZZZZZZZZRRRRRRRRRRRRRRZZZZZZZZZRRRRZHHHHHHHEEEEEEEEEEUUUUUUHEUUEHHHEERRZZZZZZZZZZZZRRRRRRRRRRRRRRRRRRRRRRZZZZZZZZZZZZZZZZZZZZcc
ccZZZZZZZZZZZZZZZZZZZZZZZZZRRRRRRRRRRRRRRRRRRRRRREHHHHHHHHEEEEEEEEUUUUUUHHHHHHHEEERZZZZZZZZZZZZZZZRRRRRRRRRNRRRRRRRRZZZZZZZZZZZZZZZZZZZZZZcc
ccZZZZZZZZZZZZZZZZZZZZZZZZZZZZZZZZZZRRRRRRRRRRRRRUUUHHHHHHHHHHEEEHUUUUUUHHHHEEEEEEZZZZZZZZZZZZZZZZZZZRRRRRRRRRRRZZZZZZZZZZZZZZZZZZZZZZZZZZcc
ccZZZZZZZZZZZZZZZZZZZZZZZZZZZZZZZZZZZZZZZZZRRZRRRUUUdUUUHHHHEEEHHHHHHHEEEEEEEEHHHHZZZZZZZZZZZZZZZZZZZZZZZZZZZZZZZZZZZZZZZZZZZZZZZZZZZZZZZZcc
ccZZZZZZZZZZZZZZZZZZZZZZZZZZZZZZZZZZZZZZZZZZZZZZZHHEUUUUUUUEEHHHHHHHHHHHHHHHHHHHHHZZZZZZZZZZZZZZZZZZZZZZZZZZZZZZZZZZZZZZZZZZZZZZZZZZZZZZZZcc
ccyZZZZZZZZZZZZZZZZZZZZZZZZZZZZZZZZZZZZZZZZZZZZZZHHHHHHHHHHHHHHHHHHHHHHHHHHHHHHHHHZZZZZZZZZZZZZZZZZZZZZZZZZZZZZZZZZZZZZZZZZZZZZZZZZZZZZZZZcc
cccccccccccccccccccccccccccccccccccccccccccccccccccccccccccccccccccccccccccccccccccccccccccccccccccccccccccccccccccccccccccccccccccccccccccc
cccccccccccccccccccccccccccccccccccccccccccccccccccccccccccccccccccccccccccccccccccccccccccccccccccccccccccccccccccccccccccccccccccccccccccc
"}
