"a" = (/obj/triumph_away_spawner/D/alien_hard,/turf/simulated/mineral/floor/vacuum,/area/triumph_away/poi_d/unexplored)
"b" = (/turf/unsimulated/wall/planetary/normal,/area/triumph_away/poi_d/explored)
"c" = (/turf/unsimulated/mineral,/area/triumph_away/poi_d/explored)
"d" = (/obj/triumph_away_spawner/D/alien_medium,/turf/simulated/mineral/floor/vacuum,/area/triumph_away/poi_d/explored)
"f" = (/obj/triumph_away_spawner/D/hound_spawner,/turf/simulated/mineral/floor/vacuum,/area/triumph_away/poi_d/unexplored)
"g" = (/obj/triumph_away_spawner/D/carp_large,/turf/simulated/mineral/floor/vacuum,/area/triumph_away/poi_d/unexplored)
"k" = (/obj/away_mission_init/poi_d,/turf/simulated/mineral/floor/vacuum,/area/triumph_away/poi_d/explored)
"o" = (/obj/triumph_away_spawner/D/carp_medium,/turf/simulated/mineral/floor/vacuum,/area/triumph_away/poi_d/unexplored)
"v" = (/obj/triumph_away_spawner/D/carp_small,/turf/simulated/mineral/floor/vacuum,/area/triumph_away/poi_d/unexplored)
"A" = (/obj/triumph_away_spawner/D/alien_easy,/turf/simulated/mineral/floor/vacuum,/area/triumph_away/poi_d/unexplored)
"E" = (/turf/simulated/mineral/floor/vacuum,/area/triumph_away/poi_d/explored)
"H" = (/turf/simulated/mineral/vacuum,/area/triumph_away/poi_d/explored)
"I" = (/obj/shuttle_connector/poi_d,/turf/simulated/mineral/floor/vacuum,/area/triumph_away/poi_d/explored)
"J" = (/turf/simulated/mineral/floor/vacuum,/area/shuttle/excursion/poi_d)
"K" = (/turf/simulated/mineral,/area/triumph_away/poi_d/unexplored)
"N" = (/obj/triumph_away_spawner/D/drone_spawner,/turf/simulated/mineral/floor/vacuum,/area/triumph_away/poi_d/unexplored)
"R" = (/turf/simulated/mineral/floor/vacuum,/area/triumph_away/poi_d/unexplored)
"Z" = (/turf/simulated/mineral/vacuum,/area/triumph_away/poi_d/unexplored)

(1,1,1) = {"
bbbbbbbbbbbbbbbbbbbbbbbbbbbbbbbbbbbbbbbbbbbbbbbbbbbbbbbbbbbbbbbbbbbbbbbbbbbbbbbbbbbbbbbbbbbbbbbbbbbbbbbbbbbbbbbbbbbbbbbbbbbbbbbbbbbbbbbbbbbb
bccccccccccccccccccccccccccccccccccccccccccccccccccccccccccccccccccccccccccccccccccccccccccccccccccccccccccccccccccccccccccccccccccccccccccb
bcZZZZZZZZZZZZZZZZZZZZZZZZZZZZZZZZZZZZZZZZZZZZZZZZZZZZZZZZZZZZZZZZZZZZZZZZZZZZZZZZZZZZZZZZZZZZZZZZZZZZZZZZZZZZZZZZZZZZZZZZZZZZZZZZZZZZZZZZcb
bcZZZZZZZZZZZZZZZZZZZZZZZZZZZZZZZZZZZZZZZZZZZZZZZZZZZZZZZZZZZZZZZZZZZZZZZZZZZZZZZZZZZZZZZZZZZZZZZZZZZZZZZZZZZZZZZZZZZZZZZZZZZZZZZZZZZZZZZZcb
bcZZZZZZZZZZRRRZRRRRRRRRRRRZZZZZZZZZZZZZZZZZZZZZZZZZZZZZZZZZZZZZZZZZZZZZZZZZZZZZZZZZZZZZZZZZZZZZZZZZZZZZZZZZZZZZZZZZZZZZZZZZZZZZZZZZZZZZZZcb
bcZZZZZZZZZRRRRRRRRRRRRRRRRRRRZZZZZZZZZZZZZZZZZZZZZZZZZZZZZZZZZZZZZZZZZZZZZZZZZZZZZZZZZZZZZZZZZZZZZZZZZZZZZZZZZZZZZZZZZZZZZZZZZZZZZZZZZZZZcb
bcZZZZZZZZRRRRRRRRRRRRRRRRRRRRRRRZZZZZZZZZZZZZZZZZZZZZZZZZZZZZZZZZZZZZZZZZZZZZZZZZZZZZZZZZZZZZZZZZZZZZZZZZZZZZZZZRRZZZZZRRRZZZZZZZZZZZZZZZcb
bcZZZZZZZRRRRRRRZZZZZZZZZZZZRRRRRRRRZZZZZZZZZZZZZZZZZZZZZZZZZZZZZZZZZZZZZZZZZZZZZZZZZZZZRRRRRRRRRZZZZRRRRZRRZZZRRRRRZZRRRRRRRRRZZZZZZZZZZZcb
bcZZZZZZRRRRRRRZZZZZZZZZZZZZZZZRRRRRRZZZZZZZZZZZZZZZZZZZZZZZZZZZZZZZZZZZZZZZZRRRRRRRRRRRRRRRRRRRRRRRRRRRRRRRRRRRRRRRRRRRRRRRRRRRZZZZZZZZZZcb
bcZZZZZZRRRRRRZZZZZZZZZZZZZZZZZZZZZRRRZZZZZZZZZZZZZZZZZZZZZZZZZZZZZZZZZZZZZZRRRRRRRRRRRRRRRRRRRRRRRRRRRRRRRRRRRRRRRRRRRRRRRRRRRRRRZZZZZZZZcb
bcZZZZZZZRRRRZZZZZZZZZZZZZZZZZZZZZZRRRRZZZZZZZZZZZZZZZZZZZZZZZZZZZZZZZZZZZZRRRRRRRRRRRRRRRRRRRRRRRRRRRRRRRRRRRRRRRRRRRRRRRRRRRRRRRRZZZZZZZcb
bcZZZZZZRRRRRZZZZZZZZZZZZZZZZZZZZZZZRRaZZZZZZZZZZZZZZZZZZZZZZZZZZZZZZZZZZZRRRRRRRRRRRRRRRRRRRZZZZZZZRRRRRRRRRRRRRRRRRRRRRRZRRRRRRRRZZZZZZZcb
bcZZZZZRRRRRZZZZZZZZZZZZZZZZZZZZZZZZRRRRRRRRRRRRRRRRRRRRRZZZZZZZZZZZZZZZRRRRRRRRRRRRRRRRRRRRRRRZZZZRRRRRgRRRRRRRRRRRRRRRZZZRRRRRRRRRZZZZZZcb
bcZZZZZZRRZZZZZZZZZZZZZZZZZZZZZZRZRRRRRRRRRRRRRRRRRRRRRRRRRZZZZRRRRRRRRRRRRRRRRRRRRRRRRRRRRRRRRRZZZRRRRRRRRRRRRRRRRRRRRRZZZZRRRRRRRRZZZZZZcb
bcZZZZZRRRRZZZZZZZZZZZZZZZZZZZRRRRRRRRRRRRRRZRRZRRRRRRRRRRRRRZZRRRRRRRRRRRRRRRRRRRRRZZZZZZZRRRRRRRRRRRRRRRRRRRRRRRRRRRRRRZZZZRRRRRRRZZZZZZcb
bcZZZZZRRRRZZZZZZZZZZZZZZZZRRRRRRRRZZZZZZZZZZZZZZZZRRRRRRRRRRRZRRRRRRRRRRRRRRRRRRRRZZZZZZZZZZRRRRRRRRRZZZZZZZZZZZZRRRRRRRZZZZZRRRRRRZZZZZZcb
bcZZZZZRRRRZZZZZZZZZZZZZZRRRRRRRRZZZZZZZZZZZZZZZZZZZZZZZZRRRRRRRRRRRRRARRRRRRRRRRRZZZZZZZZZZZRRRRRRRRZZZZZZZZZZZZZZRRRRRRRZZZZRRRRRRZZZZZZcb
bcZZZZZRRRZZZZZZZZZZZZZZRRRRRRZZZZZZZZZZZZZZZZZZZZZZZZZZZZZRRRRRRRRRRRRRRRRRRRRRRZZZZZZZZZZZZRRRRRRRRZZZZZZZZZZZZZZZRRRRRRZZZZRRRRRRZZZZZZcb
bcZZZZZRRRZZZZZZZZZZZZZRRRRRZZZZZZZZZZZZZZZZZZZZZZZZZZZZZZZZZRRRRRRRRRRRRRRRRRRRZZZZZZZZZZZZZRRRRRRRZZZZZZZZZZZZZZZZRRRRRRRRRRRRRRRRZZZZZZcb
bcZZZZZRRRZZZZZZZZZZZRRRRRZZZZZZZZZZZZZZZZZZZZZZZZZZZZZZZZZZZZZZZZZZZRRRRRRRRRRRZZZZZZZZZZZZZRRRRRRZZZZZZZZZZZZZZZZZRRRRRRRRRRRRRRRRZZZZZZcb
bcZZZZZRRaZZZZZZZZZZZRRZZZZZZZZZZZZZZZZZZZZZZZZZZZZZZZZZZZZZZZZZZZZZZRRRRRRRRRRRZZZZZZZZZZZZZRRRRRRZZZZZZZZZZZZZZZZZZRRRRRRRRRRRRRRRZZZZZZcb
bcZZZZZRRRZZZZZZZZZZZRRRZZZZZZZZZZZZZZZZZZZZZZZZZZZZZZZZZZZZZZZZZZZZZZRRRRRRRRRRZZZZZZZZZZZZZRRRRRRZZZZZZZZZZZZZZZZZZZZRRRRRRRRRRRRRZZZZZZcb
bcZZZZZRRRZZZZZZZZZZZRoRZZZZZZZZZZZZZZZZZZZZZZZZZZZZZZZZZZZZZZZZZZZZZZZRRRRRRRRRZZZZZZZZZZZZZRRRRRRZZZZZZZZZZZZZZZZZZZZZZRRRRRRRRRRRZZZZZZcb
bcZZZZZRRRZZZZZZZZZZZRRRRZZZZZZZZZZZZZZZZZZZZZZZZZZZZZZZZZZZZZZZZZZZZZZZZRRRRRRRZZZZZZZZZZZZZRRRRRRZZZZZZZZZZZZZZZZZZZZZZZRRRRRRRRRRZZZZZZcb
bcZZZZZRRRZZZZZZZZZZZRRRZZZZZZZZZZZZZZZZZZZZZZZZZZZZZZZZZZZZZZZZZZZZZZZZZZRRRRRRZZZZZZZZZZZZZRRRRRRZZZZZZZZZZZZZZZZZZZZZZZZZRRRRRRRRZZZZZZcb
bcZZZZZRRRZZZZZZZZZZZRRRRZZZZZZZZZZZZZZZZZZZZZZZZZZZZZZZZZZZZZZZZZZZZZZZZZZRRRRRZZZZZZZZZZZZZRRRRRRZZZZZZZZZZZZZZZZZZZZZZZZZRRRRRRRRZZZZZZcb
bcZZZZZRRRZZZZZZZZZZZZRRRRZZZZZZZZZZZZZZZZZZZZZZZZZZZZZZZZZZZZZZZZZZZZZZZZZRRRRRZZZZZZZZZZZZZRRRRRRZZZZZZZZZZZZZZZZZZZZZZZZZRRRRRRRRZZZZZZcb
bcZZZZZRRRZZZZZZZZZZZZRRRRRZZZZZZZZZZZZZZZZZZZZZZZZZZZZZZZZZZZZZZZZZZZZZZZRRRRRRZZZZZZZZZZZZZRRRRRRZZZZZZZZZZZZZZZZZZZZZZZZZRRRRRRRRZZZZZZcb
bcZZZZZRRZZZZZZZZZZZZZZRRRRRZZZZZZZZZZZZZZZZZZZZRRRRRRRRRRRRZZZZZZZZZZZZZZZRRRRRZZZZZZZZZZZZZRRRRRRZZZZZZZZZZZZZZZZZZZZZZZZZRRRRRRRRZZZZZZcb
bcZZZZZRRRZZZZZZZZZZZZZZRRRRRZZZZZZZZZZZZZZZZZZZRRRRRRRRRRRRZZZZZZZZZZZZZZZRRRRRZZZZZZZZZZZZRRRRRRRRZZZZZZZZZZZZZZZZZZZZZZZRRRRRRgRRZZZZZZcb
bcZZZZZRRRZZZZZZZZZZZZZZZRRRRRRZZZZZZZZZZZZZZZRRRRRRRRRRRRRRZZZZZZZZZZZZZZZRRRRRZZZZZZZZZZZZRRRRRRRRRZZZZZZZZZZZZZZZZZZZZZZRRRRRRRRRZZZZZZcb
bcZZZZZRRRZZZZZZZZZZZZZZRRRRRRRZZZZZZZZZZZZZZZRRRRRRRZZZZRRRZZZZZZZZZZZZZZZRRRRRZZZZZZZZZZZRRRRRRRRRRRZZZZZZZZZZZZZZZZZZZZRRRRRRRRRRZZZZZZcb
bcZZZZZRRRZZZZZZZZZZZZZRRRRRRRRRRRZZZZZZZZZZRRRRRZZZZZZZZZRRZZZZZZZZZZZZZZRRRRRRRZZZZZZZZZZRRRRRRRRRRRRZZZZZZZZZZZZZZZRRRRRRRRRRRRRRZZZZZZcb
bcZZZZZRRRZZZZZZZZZZZZRRRRRZZZRRRRZZZZZZZZRRRRZZZZZZZZZZZZRRRZZZZZZZZZZZZZRRRRRRRRRZZZZZZZZRRRRRRRRRRRRRRRRRRRRRRRRRRRRRRRRRRRRRRRRRRZZZZZcb
bcZZZZZRRRZZZZZZZZZZZRRRRRZZZZZZRRRRZZZZRRRRRZZZZZZZZZZZZZZRRZZZZZZZZZZZZZRRRRRRRRRRRRRRRRRRRRRRZZRRRRRRRRRRRRRRRRRRRRRRRRRRRRRRRRRRRZZZZZcb
bcZZZZZRRRZZZZZZZZZRRRRRRZZZZZZZZRRRRRZRRRRRZZZZZZZZZZZZZZZRRZZZZZZZZZZZZZRRRRRRRRRRRRRRRRRRgRRRZZRRRRRRRRRRRRRRRRRRRRRRRRRRRZZRRRRRRRZZZZcb
bcZZZZZRRRRZZZZZZZRRRRRRZZZZZZZZZRRRRRRRRRRZZZZZZZZZZZZZZZZZRZZZZZZZZZZZZZRRRRRRRRRRRRRRRRRRRRRRRZRRRRRRRRRRRRRRRRRRRRRRRRRRZZZZRRRRRRRZZZcb
bcZZZZZZRRRZZZZZZRRRRRRZZZZZZZZZZZZZRRRRRZZZZZZZZZZZZZZZZZZZRRZZZZZZZZZZZZRRRRRRRRRRZZZZRRRRRRRRRRRRRRRRRZZZZZZZZZRRRRRRRRRRZZZZRRRRRRRZZZcb
bcZZZZZZRRRZZZZZRRRRRZZZZZZZZZZZZZZRRRRRRZZZZZZZZZZZZZZZZZZZZRRZZZZZZZZZZZRRRRRRRRRZZZZZRRRRRRRRRRRRRRRRRZZZZZZZZRRRRRRRRRRRZZZZRRRRRRRZZZcb
bcZZZZZZRRRZZZZRRRRRRZZZZZZZZZZZZZZZRRRoRZZZZZZZZZZZZZZZZZZZZRRZZZZZZZZZZZZZZRRRRRRZZZZZZRRRRRRRRRRRRRRRZZZZZZZZRRRRRRRRRRRRRRRRRRRRRRRZZZcb
bcZZZZZZZRRRZZRRRRRRZZZZZZZZZZZZZZZRRRRRRRRZZZZZZZZZZZZZZZZZZRRRRZZZZZZZZZZZZRRRRRRZZZZZZRRRRRRRZZRRRRRZZZZZZZZRRRRRRRZZRRRRRRRRRRRRRRZZZZcb
bcZZZZZZZRRRZRRRRRRZZZZZZZZZZZZZZZRRRRRRRRRRZZZZZZZZZZZZZZZZZZRRRRRZZZZZZZZZZRRRRRRRZZZZZRRRRRZZZZRRRRRZZZZRZZZRRRRRRZZRRRRRRRRRRRRRRZZZZZcb
bcZZZZZZZZRRZRRRRZZZZZZZZZZZZZZZZZRRZZRRRRRRZZZZZZZZZZZZZZZZZZRRRRRRZZZZZZZZZRRRRRRRRRZZZRRRRRZZZZRRRRRRRRRRRRRRRRRRZZZZZRRRRRRRRRRRZZZZZZcb
bcZZZZZZZZRRRRRRRZZZZZZZZZZZZZZZRRRZZZZRRRRRRZZZZZZZZZZZZZZZZZZRRRRRRZZZZZZRRRRRRRRRRRZZZRRRRZZZZZZRRRRRRRRRRRRRRRRZZZZZRRRRRRRRRRRRZZZZZZcb
bcZZZZZZZZRRRRRRRZZZZZZZZZZZZZZZRRZZZZZZRRRRRRZZZZZZZZZZZZZZZZZZRRRRRRRRRRRRRRRRRRRRRRRRRRRRRZZZZZZRRRRRRRRRRRRRRRRZZZZZRRRRRRZZZRRRZZZZZZcb
bcZZZZZZZZZRRoRRRRRZZZZZZZZZZZRRRZZZZZZZZRRRRRRZZZZZZZZZZZZZZZZZZRRRRRRRRRRRRRZZRRRRRRRRRRRRRZZZZZZRRRRRRRRRRRRRRRRZZZZZRRRRRRZZZRRRZZZZZZcb
bcZZZZZZZZZRRRRRRRRRRRRRZZZRRRRZZZZZZZZZZZRRRRRRZZZZZZZZZZZZZZZZZZRRRRRRRRRRRRZZZZRRRRRRRRRRRRZZZZZZZRRRRRRRRRRRRRZZZZZZRRRRRRZZRRRRZZZZZZcb
bcZZZZZZZZRRRRRRZZRRRRRRRRRRRZZZZZZZZZZZZZZRRRRRZZZZZZZZZZZZZZZZZZZZRRRARRRRRRZZZZRRRRRRRRRRRRZZZZZZZZZZZZZZZZZZZZZZZZZZRRRRRZRRRRRRZZZZZZcb
bcZZZZZZZZRRRRRZZZZZZZZRRZRZZZZZZZZZZZZZZZZZRRRRZZZRRRRRRZZZZZZZZZZZZZZZZRRRRRZZZZRRRRRRRRRRRRRZZZZZZZZZZZZZZZZZZZZZZZRRRRRRRRRRRRRRRRZZZZcb
bcZZZZZZZZRRRRRZZZZZZZZZZZZZZZZZZZZZZZZZZZZZRRRRZRRRRRRRRRZZZZZZZZZZZZZZZZZZZZZZZZRRRRRRoRRRRRRZZZZZZZZZZZZZZZZZZZZZZRRRRRRRRRRRRRRRRRRZZZcb
bcZZZZZZZZRRRRZZZZZZZZZZZZZZZZZZZZZZZZZZZZZZZRRRRRRRRRRRRRZZZZZZZZZZZZZZZZZZZZZZZZRRRRRRRRRRRRRRZZZZZZZZZZZZZZZZZZZZZRRRRRRRRRRRRRRRRRRZZZcb
bcZZZZZZZZRRRRZZZZZZZZZZZZZZZZZZZZZZZZZZZZZZZZRRRRRRRRRRRRZZZZZZZZZZZZZZZZZZZZZZZZRRRRRRRRRRRRRRZZZZZZZZZZZZZZZZZZZZZRRRRRRRRRRRRRRRRRRZZZcb
bcZZZZZZZZRRRZZZZZZZZZZZZZZZZZZZZZZZZZZZZZZZZZZZZRRRRRRRRRZZZZZZZZZZZZZZZZZZZZZZZZRRRRRRRRRRRRRRZZZZZZZZZZZZZZZZZZZZZRRRRRRRRRRRRRRRRRRZZZcb
bcZZZZZZZZRRRZZZZZZZZZZZZZZZZZZZZZZZZZZZZZZZZZZZZRRRRRRRRRZZZZZZZZZZZZZZZZZZZZZZZRRRRRRRRZZRRRRRRRZZZZZZZZZZZZZZZZZRRRRRRRRRZZZRRRRRRRRZZZcb
bcZZZZZZZZRRRZZZZZZZZZZZZZZZZZZZZZZZZZZZZZZZZZZZZRRRRRRRRRZZZZZZZZZZZZZZZZZZZZZZZRRRRRRRRZZZRRRRRRRZZZZZZZZZZZZZZZRRRRRRRRZZZZZRRRRRRRZZZZcb
bcZZZZZZZZRRRZZZZZZZZZZZZZZZZZZZZZZZZZZZZZZZZZZZZRRRRRRRRRZZZZZZZZZZZZZZZZZZZZZZRRRRRRRRZZZZZRRRRRRRZZZZZZZZZZZZZZRRRRRRZZZZZZZRRRRRRZZZZZcb
bcZZZZZZZZRRRZZZZZZZZZZZZZZZZZZZZZZZZZZZZZZZZZZZZZRRRRRRRRRZZZZZZZZZZZZZZZZZZZZZRRRRRRRZZZZZZRRRRRRRRRZZZZZZZZZZZRRRRRRRZZZZZZRRRRRRRZZZZZcb
bcZZZZZZZRRRRRZZZZZZZZZZZZZZZZZZZZZZZZZZZZZZZZZZZZZRRRRRRRRRZZZZZZZZZZZZZZZZZZZZRRRRRRRZZZZZRRRRRRRRRRRZZZZZZZZRRRRRRRRZZZZRRRRRRRRRRZZZZZcb
bcZZZZZZZRARRRZZZZZZZZZZZZRRZZZZZZZZZZZZZZZZZZZZZZZRRRRRRRRRRZZZZZZZZZZZZZZZZZZRRRRRRRZZZZZZRRRRRRRRRRRRRRRRRRRRRRRRRRRRRRRRRRRRRRRRZZZZZZcb
bcZZZZZZZRRRRRRRZZZZZRRRRRRRRRRRRRRZZZZZZZZZZZZZZZZZRRRRRRRRRRZZZZZZZZZZZZZZZZRRRRRRRZZZZZZRRRRRRRRRRRRRRRRRRRRRRRRRRRRRRRRRRRRRRRRRZZZZZZcb
bcZZZZZZRRRRRRRRZZZZRRRRRRRRRRRRRRRRZZZZZZZZZZZZZZRRRRRRRRRRRRRRRRRRRRRRRRRRRRRRRRRRRZZZZRRRRRRRRRRRRRRRRRRRRRRRRRRRRRRRRRRRRRZRRRRRZZZZZZcb
bcZZZZZZRRZZRRRRZZZRRRRRRRRRRRRRRRRRRRRRRRRRRRRRRRRRRRRRRRRRRRRRRRRRRRRRRRRRRRRRRRRRRRRRRRRRRRRRRRRRRRRRRZZRRRRRRRRoRRRRRRRRRRRRRRRRZZZZZZcb
bcZZZZZZRRZZRRRZZZZRRRRRRRRRRRRRRRRRRRRRRRRRRRRRRRRRRRRRvRRRRRRRRRRRRRRRRRRRRRRRRRRRRRRRRRRRRRRZZRRRRRRRRZZZZRRRRRRRRRRRRRRRRZZZRRRRZZZZZZcb
bcZZZZZZRRZZRRRRZZZRRRRRRRRRRRRRRRRRRRRRRRRRRRRRRRRRRRRRRRRRRRRRRRRRRRRRRRRRRRRRRRRRRRRRRRRRRRZZZZRRRRRRRRZZZZRRRRRRRZZZZZZZZZZZRRRRRZZZZZcb
bcZZZZZZRRZZZRRRRZZRRRRRRRRRRvRRRRRRRRRRRRRRRRRRRRRRRRRRRRRRRRRRRRRRRRRRRRRRRRRRRRRRRRRRRRRRZZZZZZZZRRRRRRRZZZRRRRRRZZZZZZZZZZZRRRRRRZZZZZcb
bcZZZZZZRRZZZZZZRRRRRRRRRRRRRRRRRRRRRRRRRRRRRRRRRRRRRRRRRRRRRRRRRRRRRRRRRRRRRRRRRRRRRRRRRRRRZZZZZZZZZZZRRRRRRRRRRRRRZZZZZZZZZZZRRRRRRZZZZZcb
bcZZZZZRRRZZZZZZZZRRRRRRRRRRRRRRRRRRRRRRRRRRRRRRRRRRRRRRRRRRRRRRRRRRRRRRRRRRRRRRRRRRRRRRRRZZZZZZZZZZZZZRRRRRRRRRRRRZZZZZZZZZZZZRRRRRRRZZZZcb
bcZZZZZRRRZZZZZZZZZRRRRRRRRRRRRRRRRRRRRRRRRRRRRRRRRRRRRRRRRRRRRRRRRRRRRRRRRRRRRRRRRRRRRRZZZZZZZZZZZZZZZZRRRRRRRRRRRZZZZZZZZZZZRRRRRRRRRZZZcb
bcZZZZZRRRZZZZZZZZZZRRRRRRRRRRRRRRRRRRRRRRRRRRRRRRRRRRRRRRRRRRRRRRRRRRRRRRRRRRRRRRRRRRRRZZZZZZZZZZZZZZZZRRRRRRRRRRRZZZZZZZZZZZRRRRRRRRRZZZcb
bcZZZZZZRRRZZZZZZZZZRRRRRRRRRRRRRRRRRRRRRRRRRRRRRRRRRRRRRRRRRRRRRRRRRRRRRRRRRRRRRRRRRRRZZZZZZZZZZZZZZZZRRRRRRRRRRRRZZZZZZZZZZZRRRRRRRRRRRZcb
bcZZZZZZRRRZZZZZZZZZZZRRRRRRZZZZZZRRRRRRRRRRRRRRRRRRRRRRRRRRRRRRRRRvRRRRRRRRRRRRRRRRRZZZZZZZZZZZZZZZZZZRRRRRRRRRRRRRZZZZZZZZZZRRRRRRRRRRRZcb
bcZZZZZZRRRZZZZZZZZZZZRZZZZZZZZZZRRRRRRRRRRRRRRRRRRRRRRRRRRRRRRRRRRRRRRRRRRRRRRRRRRRZZZZZZZZZZZZZZZZZZZRRRRRRRRRRRRRRRRRZZZZZRRRRRRRRRRRRRcb
bcZZZZZZZRRZZZZZZZZZZZZZZZZZZZZZZRRRRRRRRRRRRRRRRRRRRRRRRRRRRRRRRRRRRRRRRRRRRRRRRRRZZZZZZZZZZZZZZZZZZZRRRRRRRRRRRRRRRRRRRRZZRRRRRRRRRRRRRRcb
bcZZZZZZZRRRRZZZZZZZZZZZZZZZZZZZZRRRRRRRRRRRRRRRRRRRRRRRRRRRRRRRRRRRRRRRRRRRRRRRRRRRRZZZZZZZZZZZZZZZRRRRRRRRZZZZZRRRRRRRRRRRRRRRRRRRZRRRRRcb
bcZZZZZZZZRRRRZZZZZZZZZZZZZZZZZZRRRRRRRRRRRRRRRRRRRRRRRRRRRRRRRRRRRRRRRRRRRRRRRRRRRRRRRZZZZZZZZZZRRRRRRRRRRRRZZZZRRRRRRRRRRRRRRRRRRZZZRRRRcb
bcZZZZZZZZRRRRRZZZZZZZZZZZZZZZZRRRRRRRRRvRRRRRRRRRRRRRRRRRRRRRRRRRRRRRRRRRRRRRRRRRRRRRRRRZZZZZRRRRRRRRRRRRRRRRRRRRRRRRRRRRRRRRRRRRRZZZRRRRcb
bcZZZZZZZZZRRRRRZZZZZZZZZZZZZZZRRRRRRRRRRRRRRRRRRRRRRRRRRRRRRRRRRRRRRRRRRRRRRRRRRRRRRRRRRRRRRRRRRRRRRRRRRRRRRRRRRRRRRRRRRRRRRRRRRRRZZRRRRRcb
bcZZZZZZZZZZRRRRRZZZZZZZZZZZZZRRRRRRRRRRRRRRRRRRRRRRRRRRRRRRRRRRRRRRRRRRRRRRRRRRRRRRRRRRRRRRRRRRRRRRRRRRRRRRRRRRRRRRRRRRRRRRRRRRRRRRRRRRRRcb
bcZZZZZZZZZZRRRRRZRZZZZZZZZZZZRRRRRRRRRRRRRRRRRRRRRRRRRRRRRRRRRRRRRRRRRRRRRRRRRRRRRRRRRRRRRRRRRRRRRRoRRRRRRRRRRRRRRRRRRRRRRRRRRRRRRRRRRRRRcb
bcZZZZZZZZZZRRRRRRRRRZZZZZZZZRRRRRRRRRRRRRRRRRRRRRRRRRRRRRRRRRRRRRRRRRRRRRRRRRRRRRRRRRRRRRRRRRRRRRRRRRRRRRRRRRRRRRRRRRRRRRRRRZZZRRRRoRRRRRcb
bcZZZZZZZZZZRRRZRRRRRRRZZZZZZRRRRRRRRRRRRRRRRRRRRRRRRRRRRRRRRRRRRRRRRRRRRRRRRRRRRRRRRRRRRRRRRRRRRRRRRRRRRRRRRRRRRRRRRRRRRRRRZZZZRRRRRRRRRRcb
bcZZZZZZZZZZRRRZZZZRRRRRRRRZZRRRRRRRRRRRRRRRRRRRRRRRRRRRRRRRRRRRRRRRRRRRRRRRRRRRRRRRRRRRRRRRRRRRRRRRZZRZZZZZZRZRRRRRRRRRRRRZZZZZZRRRRRRRRZcb
bcZZZZZZZZZRRRZZZZZZZZZRRRRRRRRRRRRRRRRRRRRRRRRRRRRRRRRRRRRRRRRRRRRRRRRRRRRRRRRRRRRRRRRRRRRRRRRRRZZZZZZZZZZZZZZZZZRRRRRRRRRZZZZZZRRRRRRRRZcb
bcZZZZZZZZZRRRKKKKKKKKKZZZRRRRRRRRRRRRRRRRRRRRRRRRRRRRRRRRRRRRRRRRRRRRRRRRRRRRRRRRRRRRRRRRRRRZZZZZZZZZZZZZZZZZZZZZZZZRRRRRRRZZZZZRRRRRRRRZcb
bcZZZZZZZRRRRZZZZZZZZZZZZZZRRRRRRRRRRRRRRRRRRRRRRRRRRRRRRRRRRRRRRRRRRRRRRRRRRRRRRRRRRRRRRRRZZZZZZZZZZZZZZZZZZZZZZZZZZZZZRRRRRRZZZZZRRRRZZZcb
bcZZZZZZRRRRZZZZZZZZZZZZZZZRRRRRRRRRRRRRRRRRRRRRRRRRRRRRRRRRRRRRRRRRRRRRRvRRRRRRRRRRRRRRZZZZZZZZZZZRRRRRZZRRRRRRRRRZZZZZZZRRRRZZZZZZZZZZZZcb
bcZZZZZRRARZZZZZZZZZZZZZZZZRRRRRRRRRRRRRRRRRRRRRRRRRRRRRRRRRRRRRRRRRRRRRRRRRRRRRRRRRRRRZZZZZZZZRRRRRRRRRRRRRRRRRRRRRRRRZZZZRRRRRZZZZZZZZZZcb
bcZZZZZRRRRRZZZZZZZZZZZZZZZRRRRRRRRRRRRRRRRRRRRRRRRRRRRRRRRRRRRRRRRRRRRRRRRRRRRRRRRRRZZZZZZRRRRRRRRRRRRRRRRRRNRRRRRRRRRRZZZZZRRRZZZZZZZZZZcb
bcZZZZZRRRZRRRZZZZZZZZZZZZZRRRRRRRRRRRRRRRRRRRRRRRRRRRRRRRRRRRRRRRRRRRRRRRRRRRRRRRRZZZZZZRRRRRRRRRRRRRRRRRRZZRRRRRRRRRRRRRZZZZRRRZZZZZZZZZcb
bcZZZZRRRRZRRRRZZZZZZZZZZZZRRRRRRRRRRRRRRRRRRRRRRRRRRRRRRRRRRRRRRRRRRRRRRRRRRRRRRRZZZZZZRRRRRRRRRRZRRRRRZRRRRRRRRRRRRRRRRRRZZZZRRZZZZZZZZZcb
bcZZZZRRRZZZRRRRZZZZZZZZZZZRRRRRRRRRRRRRRRvRRRRRRRRRRRRRRRRRRRRRRRRRRRRRRRRRRRRRRRZZZRRRRRRRRRZRRRRRRRRRRRRRRRRRRRRRRRRRRRRRRZZRRRZZZZZZZZcb
bcZZZRRRRZZZZRRRRZZZZZZZZZZZRRRRRRRRRRRRRRRRRRRRRRRRRRRRRRRRRRRRRRRRRRRRRRRRRRRRRRZZZRRRRRRRRRRRRRRRRRRRRRRRRRRRRRZZZRRRRRRRRRZZRRRZZZZZZZcb
bcZZZRRRRZZZZZZRRZZZZZZZZZZZZRRRRRRRRRRRRRRRRRRRRRRRRRRRRRRRRRRRRRRRRRRRRRRRRRRRZZZZZRRRRZRRRRRRRRRRRRRRRRRRRRRRRRRRRRRRRRRRRRZZZRRRZZZZZZcb
bcZZZRRRRZZZZZZZRRZZZZZZZZZZZRRRRRRRRRRRRRRRRRRRRRRRRRRRRRRRRRRRRRRRRRRRRRRRRRRRZZZZRRRRRRRRRRRRRRRRRRRRRRRRRRRRRRRRRRRRRRRRRRRZZRRRZZZZZZcb
bcZZZRRRRZZZZZZZRRRZZZZZZZZZZZRRRRRRRRRRRRRRRRRRRRRRRRRRRRRRRRRRRRRRRRRRRRRRRRRZZZZZRRRRRRRRRRRRfRRRRRZZRRRRZZZRRRRRRRRRRRRRRRRRZZRRZZZZZZcb
bcZZZRRRRZZZZZZZZRRRZZZZZZZZZZZZRRRRRRRRRRRRRRRRRRRRRRRRRRRRRRRRRRRRRRRRRRRRRRRZZZZZRRRRRRRRRRRRRRRRRZZRRRRRRRZZRRRRRRRRRRRRRRRRRZRRZZZZZZcb
bcZZZRRRRZZZZZZZZZRRZZZZZZZZZZZZZZRRRRRRRRRRRRRRRRRRRRRRRRRRRRRRRRRRRRRRRRRRRRZZZZZRRRRZRRRRRRRRRRRRRRRRRRRRRRRRRRRRRRRRRRRRZRRRRRRRZZZZZZcb
bcZZZZRRRZZZZZZZZZRRZZZZZZZZZZZZZZRRRRRRRRRRRRRRRRRRRRRRRRRRRRRRRRRRRRRRRRRRRRZZZZRRRRRRRRRRRRRRRRRRRRRRRRRRRRRRRRRRRRRRRRRRRRRRRRRRRZZZZZcb
bcZZZZRRRZZZZZZZZZZRRZZZZZZZZZZZZZZZRRRRRRRRRRRRRRRRRRRRRRRRRRRRRRRRRRRRRRRRRRZZZRRRZRRRRRRRRRRRRRRRRRRRRRRRRRRRRRRRRZRRRRRRRRRRRRRRRZZZZZcb
bcZZZZRRRZZZZZZZZZZRRZZZZZZZZZZZZZZZRRRRRRRRRRRRRRRRRRRRRRRRRRRRRRRRRRRRRRRRRZZZRRRZZRRRRRRZZZRRRRRRRRRRRRRRRRRRRRRRRZZZRRRRRRRRRRRRRZZZZZcb
bcZZZZRRRZZZZZZZZZZRRZZZZZZZZZZZZZZZZRRRRRRRRRRRRRRRRRRRRRRRRRRRRRRRRRRRRRRRRZZRRRRRRRRRRRZZZRRRRRRRRRRRRRRRRRRRRRRRRRRRRRRRRRRRRRRRRZZZZZcb
bcZZZZRRRZZZZZZZZZZRRZZZZZZZZZZZZZZZZZRRRRRRRRRRRRRRRRRRRRRRRRRRRRRRRRRRRRRRRZZRRRRRRRRRRRZZRRRRRRRRRRRRRRRRRRRRRRRRRRRRRRRRRRRRRRRRRZZZZZcb
bcZZZZRRRZZZZZZZZZZRRZZZZZZZZZZZZZZZZZZZRRRRRRRRRRRRRRRRRRRRRRRRRRRRRRRRRRRRRZZRRRRRRRRRRRZRRRRRRRRRRRRRRRRRRRRRRRRRRRRRRZZRRRRRRRRRRRZZZZcb
bcZZZZRRRRZZZZZZZZZRRRZZZZZZZZZZZZZZZZZZZRRRRRRRRRRRRRRRRRRRRRRRRRRRRRRRRRRRZZZRRRRRRRRRRRRRRRRRRRRRRRRRRRRRRRRRRRRRRRRRRRZRRRRRRZZRRRZZZZcb
bcZZZZRRRRZZZZZZZZZRRRZZZZZZZZZZZZZZZZZZZZZRRRRRRRRRRRRRRRRRRRRRRRRRRRRRRRRRZZZRRRRRRRRRRRRRRRRRRRRRRRRRRRRRRRRRRRRRRRRRRRRRRRRRRRZRRRZZZZcb
bcZZZZZRRRRZZZZZZZZRRRRZZZZZZZZZZZZZZZZZZZZZRRRRRRRRRRRRRRRRRRRRRRRRRRRRRRRRZZZRRRZRRRRRRRRRRRRRRRRRRRRRRRRRRRRRRRRRRRRRRRRRRRRRRRRRRRZZZZcb
bcZZZZZRRRRZZZZZZZZZRRRZZZZZZZZZZZZZZZZZZZZZRRRRRRRRRRRRRRRRRRRRRRRRRRRRRRRRZZZRRRRRRRRRRRRRRRRRRRRRRRRRRRRRRRRRRRRRRRRRRRRRRRRRRRRRRRZZZZcb
bcZZZZZRRRRZZZZZZZZZRRRRZZZZZZZZZZZZZZZZZZZZZRRRRRRRRRRRRRRRRRRRRRRRRRRZZRRRRZZRRRRRRRRRRRRRRRRRRRRRRRRRRRRRRRRRRRRRRRRRRRRRRRRRRRRNRRZZZZcb
bcZZZZZRRRRZZZZZZZZZRRRRZZZZZZZZZZZZZZZZZZZZZZRRRRRRRRRRRRRRRRRRRRRRRRRZZRRRRZZRRRRRRRRRRRRRRRRRRRRRRRRRRRRRRRRRRRRRRRRfRRRRRRRRRRRRRRZZZZcb
bcZZZZZZRRRZZZZZZZZZZRRRZZZZZZZZZZZZZZZZZZZZZZZRRRRRRRRRRRRRRRRRRRRRRRRZZRRRRZZZRRRRRRRRRRRRRRRRRRRRRRRRRRRRRRRRRRRRRRRRRRRRZRRRRRRRRRZZZZcb
bcZZZZZZRRRZZZZZZZZZZZRRRZZZZZZZZZZZZZZZZZZZZZZZRRRRRRRRRRRRRRRRRRRRRRRZZRRRRRRZRRRRRRRRRRRRRRRRRRRRRRRRRRRRRRRRRRRRRRRRRRRRZRRRRZRRZRZZZZcb
bcZZZZZZZRRZZZZZZZZZZZZRRRZZZZZZZZZZZZZZZZZZZZZZZZRRRRRRRRRRRRRRRRRRRRRZZRRRRRRRRRRRZZRRRRRRRRRRRRRRRRRRRRRRRRRRRRRRRRRRRRRZZRRRRRRRRRZZZZcb
bcZZZZZZZRRZZZZZZZZZZZZZRRRZZZZZZZZZZZZZZZZZZZZZZRRRRRRRRRRRRRRRRRRRRRRRZZRRRRRRZRRRZZRRRRRRRRRRRRRRRRRRRRRRRRRRRRRRRRRRRRRZZRRRRRRRRRZZZZcb
bcZZZZZZZRRZZZZZZZZZZZZZZRRZZZZZZZZZZZZZZZZZZZZZZEEEEHEEEEEEEEEEEEEEEEEEHHHEEEHHHHRRRRRRRRRRRRRRRRRRRRRRRRRRRRRRRRRRRRRRRRRZZRRRRRRRRRZZZZcb
bcZZZZZZZRRRZZZZZZZZZZZZZZRRZZZZZZZZZZZZZZZZZRRRREHHHHEEEEEEEEEEEEEEEEEEEHHHHHHEEHZZZRRRRRRRRRRRRRRRRRRRRRRRRRRRRRRRRRRRRRRRRRRRRRRRRRZZZZcb
bcZZZZZZZRRRZZZZZZZZZZZZZZRRRZZZZZZZZZZZZZZRRRRRRHHHHHHEEEEEEEEEEEEEEEEEEEHHEHHHHHZZZRRRRRRRRRRRRRRRRRRRRRRRRRRRRRRRRRRRRRRRRRRRRRRRRZZZZZcb
bcZZZZZZZRRRZZZZZZZZZZZZZZZRRZZZZZZZZZZZZZRRRRRZZHHHHHHEEEEEEEEEEEEEEEEEEEEEEHHHHHZZZRRRRRRRRRRRRRRRRRRRRRRRRRRRRRRRRRRRRRRRRRRRRRRRRZZZZZcb
bcZZZZZZZRRRZZZZZZZZZZZZZZZRRRZZZZZZZZZZZRRRRZZZZHHHHHEEEEEEEEEEEEEEEEEEEEEEEEEHHHRZZRRRRZZZRRRRfRRRRRRRRRRRRRRRRRRRRRRRRRRRRRRRRRRRRZZZZZcb
bcZZZZZZZZRRRZZZZZZZZZZZZZZZRRRZZZZZZZZZRRRZZZZZZHHHEEEEEEEEEEEEEEEEEEEEEEEEEEEHHHZZZRRRRRZZRRRRRRRRRRRRRRRRRRRRRRRRRRRRRRRRRRRZZRRRZZZZZZcb
bcZZZZZZZZRRRRZZZZZZZZZZZZZZZRRZZZZZRRRRRRZZZZZZZHHHEEEEEEEEEEJJJJJJJJJJJJJJEEEHHEZRZZRRRRRRRRRRRRRRRRRRRRRRRRRRRRRRRRRRRRRRRRRRRRRRZZZZZZcb
bcZZZZZZZZZRRRRZZZZZZZZZZZZRRRRRRRRARRRRRRZZZZZZZHHHEEEEEEEEEEJJJJJJJJJJJJJJEEEHHERZZZRRRRRRRRRRRRRRRRRRRRRRRRRRRRRRRRRRRRRRRRRRRRRZZZZZZZcb
bcZZZZZZZZZRRRRRZZZZZZZRRRRRRRRRRRRRZZZZRRZZZZZZZHHEEEEEEEEEEEJJJJJJJJJJJJJJEEEHHERZRZZRRRRRRRRRRRRRRRRRRRRRRRRRRRRRRRRRRRRRRRRRRRZZZZZZZZcb
bcZZZZZZZZZZRRRRRRRRRRRRRRRRRRRRZZZZZZZZRRZZZZZZZHHHEEEEEEEEEJJJJJJJJJJJJJJJEEEHHERZZZRRRRRRRRRRRRZRRRRRRRRRRRRRRRRRRZZZRRRRRRRRRRZZZZZZZZcb
bcZZZZZZZZZZZRRARRRRRRRRRRRRZZZZZZZZZZZZZRRZZZZZZHHHEEJJJJJJJJJJJJJJJJJJEEEEEEEHHHZRZZZRRRRRRRRRRRZZRRRRRRRRZZRRRRRRZZRRRRfRZRRRRZZZZZZZZZcb
bcZZZZZZZZZZZRRRRZZRZZZRZZZZZZZZZZZZZZZZZRRRRZZZZHHEEEJJJJJJJJJJJJJJJJJJEEEEEkEHHHZZZRZZRRRRRRRRRRRRZZRRRRRRZZZRRRRRRRRRRRRRRRRRZZZZZZZZZZcb
bcZZZZZZZZZZZZRRRZZZZZZZZZZZZZZZZZZZZZZZZRRRRZZZZHHHEEJJJJJJJJJJJJJJJJJJJJJJEEEHHHZZRRRRRRRRRRRRRRRRRRRRRRRRRRRRRRRRRRRRRRRRRRRZZZZZZZZZZZcb
bcZZZZZZZZZZZZRRRZZZZZZZZZZZZZZZZZZZZZZZZZRRRZZZZHHHEEJJJJJJJJJJJJJJJJJJJJJJEEEHHHZZZRRRRRRRRRRRRRRRRRRRRRRRRRRRRRRRRRRRRRRRRRZZZZZZZZZZZZcb
bcZZZZZZZZZZZZZRRRZZZZZZZZZZZZZZZZZZZZZZZZZRRZZZZHHHEEJJJJJJJJJJJJJJJJJJJJJJEEEHHHZZZRRRRRRRRZRRRRRRRRRRRRRRRRRRRRRRRRRRRRRRZZZZZZZZZZZZZZcb
bcZZZZZZZZZZZZZRRRRRZZZZZZZZZZZZZZZZZZZZZZZRRZZZZHHHEEJJJJJJJJJJJJJJJJJJJJJJEEEHHHZZZRRRRRRRRRRRRRRRRRRRRRRRRRRRRRRRRRZRRRRZZZZZZZZZZZZZZZcb
bcZZZZZZZZZZZZZZRRRRZZZZZZZZZZZZZZZZZZZZZZZZRZZZZHHHEEEEEEEEEEEEEEEEEEEEEEEEEEHHHHZRRRZZZZRRRRRRRRRRZRRRRRRRRRRRRRRRRRRRRRZZZZZZZZZZZZZZZZcb
bcZZZZZZZZZZZZZZZRRRRRRRZZZZZZZZZZZZZZZZZZZZRRZZZHHHHEEEEEIEEEEEEEEEEEEEEEEEEEHHHHZRRRZZZZZRRRRRRRRRZRRRRRRRRRRRRZRRRRRRRZZZZZZZZZZZZZZZZZcb
bcZZZZZZZZZZZZZZZZRRRRRRRRRRRRRRRZZZZZZZZZZZRRRZZHHHHEEEEEEEEEEEEEEEEEEEEEEEEEHHHHRRRRZZZZZZZRRRRRRRRRRRRRZZRRRRRRRRRRRZZZZZZZZZZZZZZZZZZZcb
bcZZZZZZZZZZZZZZZZZZZRRRRRRRRRRRRRRZZZZZZZZZRRRRZHHHHHHHEEEEEEEEEEEEEEEEHEEEEHHHEERRZZZZZZZZZZZZRRRRRRRRRRRRRRRRRRRRRRZZZZZZZZZZZZZZZZZZZZcb
bcZZZZZZZZZZZZZZZZZZZZZZZZZRRRRRRRRRRRRRRRRRRRRRREHHHHHHHHEEEEEEEEEEEEEEHHHHHHHEEERZZZZZZZZZZZZZZZRRRRRRRRRNRRRRRRRRZZZZZZZZZZZZZZZZZZZZZZcb
bcZZZZZZZZZZZZZZZZZZZZZZZZZZZZZZZZZZRRRRRRRRRRRRREEEHHHHHHHHHHEEEHHEEEEEHHHHEEEEEEZZZZZZZZZZZZZZZZZZZRRRRRRRRRRRZZZZZZZZZZZZZZZZZZZZZZZZZZcb
bcZZZZZZZZZZZZZZZZZZZZZZZZZZZZZZZZZZZZZZZZZRRZRRREEEdEEEHHHHEEEHHHHHHHEEEEEEEEHHHHZZZZZZZZZZZZZZZZZZZZZZZZZZZZZZZZZZZZZZZZZZZZZZZZZZZZZZZZcb
bcZZZZZZZZZZZZZZZZZZZZZZZZZZZZZZZZZZZZZZZZZZZZZZZHHEEEEEEEHEEHHHHHHHHHHHHHHHHHHHHHZZZZZZZZZZZZZZZZZZZZZZZZZZZZZZZZZZZZZZZZZZZZZZZZZZZZZZZZcb
bcZZZZZZZZZZZZZZZZZZZZZZZZZZZZZZZZZZZZZZZZZZZZZZZHHHHHHHHHHHHHHHHHHHHHHHHHHHHHHHHHZZZZZZZZZZZZZZZZZZZZZZZZZZZZZZZZZZZZZZZZZZZZZZZZZZZZZZZZcb
bccccccccccccccccccccccccccccccccccccccccccccccccccccccccccccccccccccccccccccccccccccccccccccccccccccccccccccccccccccccccccccccccccccccccccb
bbbbbbbbbbbbbbbbbbbbbbbbbbbbbbbbbbbbbbbbbbbbbbbbbbbbbbbbbbbbbbbbbbbbbbbbbbbbbbbbbbbbbbbbbbbbbbbbbbbbbbbbbbbbbbbbbbbbbbbbbbbbbbbbbbbbbbbbbbbb
"}
