"a" = (/obj/triumph_away_spawner/D/alien_hard,/turf/simulated/mineral/floor/vacuum,/area/triumph_away/poi_d/unexplored)
"c" = (/turf/unsimulated/mineral,/area/triumph_away/poi_d/explored)
"d" = (/obj/triumph_away_spawner/D/alien_medium,/turf/simulated/mineral/floor/vacuum,/area/triumph_away/poi_d/explored)
"f" = (/obj/triumph_away_spawner/D/hound_spawner,/turf/simulated/mineral/floor/vacuum,/area/triumph_away/poi_d/unexplored)
"g" = (/obj/triumph_away_spawner/D/carp_large,/turf/simulated/mineral/floor/vacuum,/area/triumph_away/poi_d/unexplored)
"k" = (/obj/away_mission_init/poi_d,/turf/simulated/mineral/floor/vacuum,/area/triumph_away/poi_d/explored)
"o" = (/obj/triumph_away_spawner/D/carp_medium,/turf/simulated/mineral/floor/vacuum,/area/triumph_away/poi_d/unexplored)
"v" = (/obj/triumph_away_spawner/D/carp_small,/turf/simulated/mineral/floor/vacuum,/area/triumph_away/poi_d/unexplored)
"y" = (/obj/effect/overmap/visitable/sector/class_d,/turf/simulated/mineral/vacuum,/area/triumph_away/poi_d/unexplored)
"A" = (/obj/triumph_away_spawner/D/alien_easy,/turf/simulated/mineral/floor/vacuum,/area/triumph_away/poi_d/unexplored)
"E" = (/turf/simulated/mineral/floor/vacuum,/area/triumph_away/poi_d/explored)
"H" = (/turf/simulated/mineral/vacuum,/area/triumph_away/poi_d/explored)
"J" = (/obj/effect/shuttle_landmark/automatic,/turf/simulated/mineral/floor/vacuum,/area/triumph_away/poi_d/explored)
"K" = (/turf/simulated/mineral,/area/triumph_away/poi_d/unexplored)
"N" = (/obj/triumph_away_spawner/D/drone_spawner,/turf/simulated/mineral/floor/vacuum,/area/triumph_away/poi_d/unexplored)
"R" = (/turf/simulated/mineral/floor/vacuum,/area/triumph_away/poi_d/unexplored)
"Z" = (/turf/simulated/mineral/vacuum,/area/triumph_away/poi_d/unexplored)

(1,1,1) = {"
cccccccccccccccccccccccccccccccccccccccccccccccccccccccccccccccccccccccccccccccccccccccccccccccccccccccccccccccccccccccccccccccccccccccccccc
cccccccccccccccccccccccccccccccccccccccccccccccccccccccccccccccccccccccccccccccccccccccccccccccccccccccccccccccccccccccccccccccccccccccccccc
ccZZZZZZZZZZZZZZZZZZZZZZZZZZZZZZZZZZZZZZZZZZZZZZZZZZZZZZZZZZZZZZZZZZZZZZZZZZZZZZZZZZZZZZZZZZZZZZZZZZZZZZZZZZZZZZZZZZZZZZZZZZZZZZZZZZZZZZZZcc
ccZZZZZZZZZZZZZZZZZZZZZZZZZZZZZZZZZZZZZZZZZZZZZZZZZZZZZZZZZZZZZZZZZZZZZZZZZZZZZZZZZZZZZZZZZZZZZZZZZZZZZZZZZZZZZZZZZZZZZZZZZZZZZZZZZZZZZZZZcc
ccZZZZZZZZZZRRRZRRRRRRRRRRRZZZZZZZZZZZZZZZZZZZZZZZZZZZZZZZZZZZZZZZZZZZZZZZZZZZZZZZZZZZZZZZZZZZZZZZZZZZZZZZZZZZZZZZZZZZZZZZZZZZZZZZZZZZZZZZcc
ccZZZZZZZZZRRRRRRRRRRRRRRRRRRRZZZZZZZZZZZZZZZZZZZZZZZZZZZZZZZZZZZZZZZZZZZZZZZZZZZZZZZZZZZZZZZZZZZZZZZZZZZZZZZZZZZZZZZZZZZZZZZZZZZZZZZZZZZZcc
ccZZZZZZZZRRRRRRRRRRRRRRRRRRRRRRRZZZZZZZZZZZZZZZZZZZZZZZZZZZZZZZZZZZZZZZZZZZZZZZZZZZZZZZZZZZZZZZZZZZZZZZZZZZZZZZZRRZZZZZRRRZZZZZZZZZZZZZZZcc
ccZZZZZZZRRRRRRRZZZZZZZZZZZZRRRRRRRRZZZZZZZZZZZZZZZZZZZZZZZZZZZZZZZZZZZZZZZZZZZZZZZZZZZZRRRRRRRRRZZZZRRRRZRRZZZRRRRRZZRRRRRRRRRZZZZZZZZZZZcc
ccZZZZZZRRRRRRRZZZZZZZZZZZZZZZZRRRRRRZZZZZZZZZZZZZZZZZZZZZZZZZZZZZZZZZZZZZZZZRRRRRRRRRRRRRRRRRRRRRRRRRRRRRRRRRRRRRRRRRRRRRRRRRRRZZZZZZZZZZcc
ccZZZZZZRRRRRRZZZZZZZZZZZZZZZZZZZZZRRRZZZZZZZZZZZZZZZZZZZZZZZZZZZZZZZZZZZZZZRRRRRRRRRRRRRRRRRRRRRRRRRRRRRRRRRRRRRRRRRRRRRRRRRRRRRRZZZZZZZZcc
ccZZZZZZZRRRRZZZZZZZZZZZZZZZZZZZZZZRRRRZZZZZZZZZZZZZZZZZZZZZZZZZZZZZZZZZZZZRRRRRRRRRRRRRRRRRRRRRRRRRRRRRRRRRRRRRRRRRRRRRRRRRRRRRRRRZZZZZZZcc
ccZZZZZZRRRRRZZZZZZZZZZZZZZZZZZZZZZZRRaZZZZZZZZZZZZZZZZZZZZZZZZZZZZZZZZZZZRRRRRRRRRRRRRRRRRRRZZZZZZZRRRRRRRRRRRRRRRRRRRRRRZRRRRRRRRZZZZZZZcc
ccZZZZZRRRRRZZZZZZZZZZZZZZZZZZZZZZZZRRRRRRRRRRRRRRRRRRRRRZZZZZZZZZZZZZZZRRRRRRRRRRRRRRRRRRRRRRRZZZZRRRRRgRRRRRRRRRRRRRRRZZZRRRRRRRRRZZZZZZcc
ccZZZZZZRRZZZZZZZZZZZZZZZZZZZZZZRZRRRRRRRRRRRRRRRRRRRRRRRRRZZZZRRRRRRRRRRRRRRRRRRRRRRRRRRRRRRRRRZZZRRRRRRRRRRRRRRRRRRRRRZZZZRRRRRRRRZZZZZZcc
ccZZZZZRRRRZZZZZZZZZZZZZZZZZZZRRRRRRRRRRRRRRZRRZRRRRRRRRRRRRRZZRRRRRRRRRRRRRRRRRRRRRZZZZZZZRRRRRRRRRRRRRRRRRRRRRRRRRRRRRRZZZZRRRRRRRZZZZZZcc
ccZZZZZRRRRZZZZZZZZZZZZZZZZRRRRRRRRZZZZZZZZZZZZZZZZRRRRRRRRRRRZRRRRRRRRRRRRRRRRRRRRZZZZZZZZZZRRRRRRRRRZZZZZZZZZZZZRRRRRRRZZZZZRRRRRRZZZZZZcc
ccZZZZZRRRRZZZZZZZZZZZZZZRRRRRRRRZZZZZZZZZZZZZZZZZZZZZZZZRRRRRRRRRRRRRARRRRRRRRRRRZZZZZZZZZZZRRRRRRRRZZZZZZZZZZZZZZRRRRRRRZZZZRRRRRRZZZZZZcc
ccZZZZZRRRZZZZZZZZZZZZZZRRRRRRZZZZZZZZZZZZZZZZZZZZZZZZZZZZZRRRRRRRRRRRRRRRRRRRRRRZZZZZZZZZZZZRRRRRRRRZZZZZZZZZZZZZZZRRRRRRZZZZRRRRRRZZZZZZcc
ccZZZZZRRRZZZZZZZZZZZZZRRRRRZZZZZZZZZZZZZZZZZZZZZZZZZZZZZZZZZRRRRRRRRRRRRRRRRRRRZZZZZZZZZZZZZRRRRRRRZZZZZZZZZZZZZZZZRRRRRRRRRRRRRRRRZZZZZZcc
ccZZZZZRRRZZZZZZZZZZZRRRRRZZZZZZZZZZZZZZZZZZZZZZZZZZZZZZZZZZZZZZZZZZZRRRRRRRRRRRZZZZZZZZZZZZZRRRRRRZZZZZZZZZZZZZZZZZRRRRRRRRRRRRRRRRZZZZZZcc
ccZZZZZRRaZZZZZZZZZZZRRZZZZZZZZZZZZZZZZZZZZZZZZZZZZZZZZZZZZZZZZZZZZZZRRRRRRRRRRRZZZZZZZZZZZZZRRRRRRZZZZZZZZZZZZZZZZZZRRRRRRRRRRRRRRRZZZZZZcc
ccZZZZZRRRZZZZZZZZZZZRRRZZZZZZZZZZZZZZZZZZZZZZZZZZZZZZZZZZZZZZZZZZZZZZRRRRRRRRRRZZZZZZZZZZZZZRRRRRRZZZZZZZZZZZZZZZZZZZZRRRRRRRRRRRRRZZZZZZcc
ccZZZZZRRRZZZZZZZZZZZRoRZZZZZZZZZZZZZZZZZZZZZZZZZZZZZZZZZZZZZZZZZZZZZZZRRRRRRRRRZZZZZZZZZZZZZRRRRRRZZZZZZZZZZZZZZZZZZZZZZRRRRRRRRRRRZZZZZZcc
ccZZZZZRRRZZZZZZZZZZZRRRRZZZZZZZZZZZZZZZZZZZZZZZZZZZZZZZZZZZZZZZZZZZZZZZZRRRRRRRZZZZZZZZZZZZZRRRRRRZZZZZZZZZZZZZZZZZZZZZZZRRRRRRRRRRZZZZZZcc
ccZZZZZRRRZZZZZZZZZZZRRRZZZZZZZZZZZZZZZZZZZZZZZZZZZZZZZZZZZZZZZZZZZZZZZZZZRRRRRRZZZZZZZZZZZZZRRRRRRZZZZZZZZZZZZZZZZZZZZZZZZZRRRRRRRRZZZZZZcc
ccZZZZZRRRZZZZZZZZZZZRRRRZZZZZZZZZZZZZZZZZZZZZZZZZZZZZZZZZZZZZZZZZZZZZZZZZZRRRRRZZZZZZZZZZZZZRRRRRRZZZZZZZZZZZZZZZZZZZZZZZZZRRRRRRRRZZZZZZcc
ccZZZZZRRRZZZZZZZZZZZZRRRRZZZZZZZZZZZZZZZZZZZZZZZZZZZZZZZZZZZZZZZZZZZZZZZZZRRRRRZZZZZZZZZZZZZRRRRRRZZZZZZZZZZZZZZZZZZZZZZZZZRRRRRRRRZZZZZZcc
ccZZZZZRRRZZZZZZZZZZZZRRRRRZZZZZZZZZZZZZZZZZZZZZZZZZZZZZZZZZZZZZZZZZZZZZZZRRRRRRZZZZZZZZZZZZZRRRRRRZZZZZZZZZZZZZZZZZZZZZZZZZRRRRRRRRZZZZZZcc
ccZZZZZRRZZZZZZZZZZZZZZRRRRRZZZZZZZZZZZZZZZZZZZZRRRRRRRRRRRRZZZZZZZZZZZZZZZRRRRRZZZZZZZZZZZZZRRRRRRZZZZZZZZZZZZZZZZZZZZZZZZZRRRRRRRRZZZZZZcc
ccZZZZZRRRZZZZZZZZZZZZZZRRRRRZZZZZZZZZZZZZZZZZZZRRRRRRRRRRRRZZZZZZZZZZZZZZZRRRRRZZZZZZZZZZZZRRRRRRRRZZZZZZZZZZZZZZZZZZZZZZZRRRRRRgRRZZZZZZcc
ccZZZZZRRRZZZZZZZZZZZZZZZRRRRRRZZZZZZZZZZZZZZZRRRRRRRRRRRRRRZZZZZZZZZZZZZZZRRRRRZZZZZZZZZZZZRRRRRRRRRZZZZZZZZZZZZZZZZZZZZZZRRRRRRRRRZZZZZZcc
ccZZZZZRRRZZZZZZZZZZZZZZRRRRRRRZZZZZZZZZZZZZZZRRRRRRRZZZZRRRZZZZZZZZZZZZZZZRRRRRZZZZZZZZZZZRRRRRRRRRRRZZZZZZZZZZZZZZZZZZZZRRRRRRRRRRZZZZZZcc
ccZZZZZRRRZZZZZZZZZZZZZRRRRRRRRRRRZZZZZZZZZZRRRRRZZZZZZZZZRRZZZZZZZZZZZZZZRRRRRRRZZZZZZZZZZRRRRRRRRRRRRZZZZZZZZZZZZZZZRRRRRRRRRRRRRRZZZZZZcc
ccZZZZZRRRZZZZZZZZZZZZRRRRRZZZRRRRZZZZZZZZRRRRZZZZZZZZZZZZRRRZZZZZZZZZZZZZRRRRRRRRRZZZZZZZZRRRRRRRRRRRRRRRRRRRRRRRRRRRRRRRRRRRRRRRRRRZZZZZcc
ccZZZZZRRRZZZZZZZZZZZRRRRRZZZZZZRRRRZZZZRRRRRZZZZZZZZZZZZZZRRZZZZZZZZZZZZZRRRRRRRRRRRRRRRRRRRRRRZZRRRRRRRRRRRRRRRRRRRRRRRRRRRRRRRRRRRZZZZZcc
ccZZZZZRRRZZZZZZZZZRRRRRRZZZZZZZZRRRRRZRRRRRZZZZZZZZZZZZZZZRRZZZZZZZZZZZZZRRRRRRRRRRRRRRRRRRgRRRZZRRRRRRRRRRRRRRRRRRRRRRRRRRRZZRRRRRRRZZZZcc
ccZZZZZRRRRZZZZZZZRRRRRRZZZZZZZZZRRRRRRRRRRZZZZZZZZZZZZZZZZZRZZZZZZZZZZZZZRRRRRRRRRRRRRRRRRRRRRRRZRRRRRRRRRRRRRRRRRRRRRRRRRRZZZZRRRRRRRZZZcc
ccZZZZZZRRRZZZZZZRRRRRRZZZZZZZZZZZZZRRRRRZZZZZZZZZZZZZZZZZZZRRZZZZZZZZZZZZRRRRRRRRRRZZZZRRRRRRRRRRRRRRRRRZZZZZZZZZRRRRRRRRRRZZZZRRRRRRRZZZcc
ccZZZZZZRRRZZZZZRRRRRZZZZZZZZZZZZZZRRRRRRZZZZZZZZZZZZZZZZZZZZRRZZZZZZZZZZZRRRRRRRRRZZZZZRRRRRRRRRRRRRRRRRZZZZZZZZRRRRRRRRRRRZZZZRRRRRRRZZZcc
ccZZZZZZRRRZZZZRRRRRRZZZZZZZZZZZZZZZRRRoRZZZZZZZZZZZZZZZZZZZZRRZZZZZZZZZZZZZZRRRRRRZZZZZZRRRRRRRRRRRRRRRZZZZZZZZRRRRRRRRRRRRRRRRRRRRRRRZZZcc
ccZZZZZZZRRRZZRRRRRRZZZZZZZZZZZZZZZRRRRRRRRZZZZZZZZZZZZZZZZZZRRRRZZZZZZZZZZZZRRRRRRZZZZZZRRRRRRRZZRRRRRZZZZZZZZRRRRRRRZZRRRRRRRRRRRRRRZZZZcc
ccZZZZZZZRRRZRRRRRRZZZZZZZZZZZZZZZRRRRRRRRRRZZZZZZZZZZZZZZZZZZRRRRRZZZZZZZZZZRRRRRRRZZZZZRRRRRZZZZRRRRRZZZZRZZZRRRRRRZZRRRRRRRRRRRRRRZZZZZcc
ccZZZZZZZZRRZRRRRZZZZZZZZZZZZZZZZZRRZZRRRRRRZZZZZZZZZZZZZZZZZZRRRRRRZZZZZZZZZRRRRRRRRRZZZRRRRRZZZZRRRRRRRRRRRRRRRRRRZZZZZRRRRRRRRRRRZZZZZZcc
ccZZZZZZZZRRRRRRRZZZZZZZZZZZZZZZRRRZZZZRRRRRRZZZZZZZZZZZZZZZZZZRRRRRRZZZZZZRRRRRRRRRRRZZZRRRRZZZZZZRRRRRRRRRRRRRRRRZZZZZRRRRRRRRRRRRZZZZZZcc
ccZZZZZZZZRRRRRRRZZZZZZZZZZZZZZZRRZZZZZZRRRRRRZZZZZZZZZZZZZZZZZZRRRRRRRRRRRRRRRRRRRRRRRRRRRRRZZZZZZRRRRRRRRRRRRRRRRZZZZZRRRRRRZZZRRRZZZZZZcc
ccZZZZZZZZZRRoRRRRRZZZZZZZZZZZRRRZZZZZZZZRRRRRRZZZZZZZZZZZZZZZZZZRRRRRRRRRRRRRZZRRRRRRRRRRRRRZZZZZZRRRRRRRRRRRRRRRRZZZZZRRRRRRZZZRRRZZZZZZcc
ccZZZZZZZZZRRRRRRRRRRRRRZZZRRRRZZZZZZZZZZZRRRRRRZZZZZZZZZZZZZZZZZZRRRRRRRRRRRRZZZZRRRRRRRRRRRRZZZZZZZRRRRRRRRRRRRRZZZZZZRRRRRRZZRRRRZZZZZZcc
ccZZZZZZZZRRRRRRZZRRRRRRRRRRRZZZZZZZZZZZZZZRRRRRZZZZZZZZZZZZZZZZZZZZRRRARRRRRRZZZZRRRRRRRRRRRRZZZZZZZZZZZZZZZZZZZZZZZZZZRRRRRZRRRRRRZZZZZZcc
ccZZZZZZZZRRRRRZZZZZZZZRRZRZZZZZZZZZZZZZZZZZRRRRZZZRRRRRRZZZZZZZZZZZZZZZZRRRRRZZZZRRRRRRRRRRRRRZZZZZZZZZZZZZZZZZZZZZZZRRRRRRRRRRRRRRRRZZZZcc
ccZZZZZZZZRRRRRZZZZZZZZZZZZZZZZZZZZZZZZZZZZZRRRRZRRRRRRRRRZZZZZZZZZZZZZZZZZZZZZZZZRRRRRRoRRRRRRZZZZZZZZZZZZZZZZZZZZZZRRRRRRRRRRRRRRRRRRZZZcc
ccZZZZZZZZRRRRZZZZZZZZZZZZZZZZZZZZZZZZZZZZZZZRRRRRRRRRRRRRZZZZZZZZZZZZZZZZZZZZZZZZRRRRRRRRRRRRRRZZZZZZZZZZZZZZZZZZZZZRRRRRRRRRRRRRRRRRRZZZcc
ccZZZZZZZZRRRRZZZZZZZZZZZZZZZZZZZZZZZZZZZZZZZZRRRRRRRRRRRRZZZZZZZZZZZZZZZZZZZZZZZZRRRRRRRRRRRRRRZZZZZZZZZZZZZZZZZZZZZRRRRRRRRRRRRRRRRRRZZZcc
ccZZZZZZZZRRRZZZZZZZZZZZZZZZZZZZZZZZZZZZZZZZZZZZZRRRRRRRRRZZZZZZZZZZZZZZZZZZZZZZZZRRRRRRRRRRRRRRZZZZZZZZZZZZZZZZZZZZZRRRRRRRRRRRRRRRRRRZZZcc
ccZZZZZZZZRRRZZZZZZZZZZZZZZZZZZZZZZZZZZZZZZZZZZZZRRRRRRRRRZZZZZZZZZZZZZZZZZZZZZZZRRRRRRRRZZRRRRRRRZZZZZZZZZZZZZZZZZRRRRRRRRRZZZRRRRRRRRZZZcc
ccZZZZZZZZRRRZZZZZZZZZZZZZZZZZZZZZZZZZZZZZZZZZZZZRRRRRRRRRZZZZZZZZZZZZZZZZZZZZZZZRRRRRRRRZZZRRRRRRRZZZZZZZZZZZZZZZRRRRRRRRZZZZZRRRRRRRZZZZcc
ccZZZZZZZZRRRZZZZZZZZZZZZZZZZZZZZZZZZZZZZZZZZZZZZRRRRRRRRRZZZZZZZZZZZZZZZZZZZZZZRRRRRRRRZZZZZRRRRRRRZZZZZZZZZZZZZZRRRRRRZZZZZZZRRRRRRZZZZZcc
ccZZZZZZZZRRRZZZZZZZZZZZZZZZZZZZZZZZZZZZZZZZZZZZZZRRRRRRRRRZZZZZZZZZZZZZZZZZZZZZRRRRRRRZZZZZZRRRRRRRRRZZZZZZZZZZZRRRRRRRZZZZZZRRRRRRRZZZZZcc
ccZZZZZZZRRRRRZZZZZZZZZZZZZZZZZZZZZZZZZZZZZZZZZZZZZRRRRRRRRRZZZZZZZZZZZZZZZZZZZZRRRRRRRZZZZZRRRRRRRRRRRZZZZZZZZRRRRRRRRZZZZRRRRRRRRRRZZZZZcc
ccZZZZZZZRARRRZZZZZZZZZZZZRRZZZZZZZZZZZZZZZZZZZZZZZRRRRRRRRRRZZZZZZZZZZZZZZZZZZRRRRRRRZZZZZZRRRRRRRRRRRRRRRRRRRRRRRRRRRRRRRRRRRRRRRRZZZZZZcc
ccZZZZZZZRRRRRRRZZZZZRRRRRRRRRRRRRRZZZZZZZZZZZZZZZZZRRRRRRRRRRZZZZZZZZZZZZZZZZRRRRRRRZZZZZZRRRRRRRRRRRRRRRRRRRRRRRRRRRRRRRRRRRRRRRRRZZZZZZcc
ccZZZZZZRRRRRRRRZZZZRRRRRRRRRRRRRRRRZZZZZZZZZZZZZZRRRRRRRRRRRRRRRRRRRRRRRRRRRRRRRRRRRZZZZRRRRRRRRRRRRRRRRRRRRRRRRRRRRRRRRRRRRRZRRRRRZZZZZZcc
ccZZZZZZRRZZRRRRZZZRRRRRRRRRRRRRRRRRRRRRRRRRRRRRRRRRRRRRRRRRRRRRRRRRRRRRRRRRRRRRRRRRRRRRRRRRRRRRRRRRRRRRRZZRRRRRRRRoRRRRRRRRRRRRRRRRZZZZZZcc
ccZZZZZZRRZZRRRZZZZRRRRRRRRRRRRRRRRRRRRRRRRRRRRRRRRRRRRRvRRRRRRRRRRRRRRRRRRRRRRRRRRRRRRRRRRRRRRZZRRRRRRRRZZZZRRRRRRRRRRRRRRRRZZZRRRRZZZZZZcc
ccZZZZZZRRZZRRRRZZZRRRRRRRRRRRRRRRRRRRRRRRRRRRRRRRRRRRRRRRRRRRRRRRRRRRRRRRRRRRRRRRRRRRRRRRRRRRZZZZRRRRRRRRZZZZRRRRRRRZZZZZZZZZZZRRRRRZZZZZcc
ccZZZZZZRRZZZRRRRZZRRRRRRRRRRvRRRRRRRRRRRRRRRRRRRRRRRRRRRRRRRRRRRRRRRRRRRRRRRRRRRRRRRRRRRRRRZZZZZZZZRRRRRRRZZZRRRRRRZZZZZZZZZZZRRRRRRZZZZZcc
ccZZZZZZRRZZZZZZRRRRRRRRRRRRRRRRRRRRRRRRRRRRRRRRRRRRRRRRRRRRRRRRRRRRRRRRRRRRRRRRRRRRRRRRRRRRZZZZZZZZZZZRRRRRRRRRRRRRZZZZZZZZZZZRRRRRRZZZZZcc
ccZZZZZRRRZZZZZZZZRRRRRRRRRRRRRRRRRRRRRRRRRRRRRRRRRRRRRRRRRRRRRRRRRRRRRRRRRRRRRRRRRRRRRRRRZZZZZZZZZZZZZRRRRRRRRRRRRZZZZZZZZZZZZRRRRRRRZZZZcc
ccZZZZZRRRZZZZZZZZZRRRRRRRRRRRRRRRRRRRRRRRRRRRRRRRRRRRRRRRRRRRRRRRRRRRRRRRRRRRRRRRRRRRRRZZZZZZZZZZZZZZZZRRRRRRRRRRRZZZZZZZZZZZRRRRRRRRRZZZcc
ccZZZZZRRRZZZZZZZZZZRRRRRRRRRRRRRRRRRRRRRRRRRRRRRRRRRRRRRRRRRRRRRRRRRRRRRRRRRRRRRRRRRRRRZZZZZZZZZZZZZZZZRRRRRRRRRRRZZZZZZZZZZZRRRRRRRRRZZZcc
ccZZZZZZRRRZZZZZZZZZRRRRRRRRRRRRRRRRRRRRRRRRRRRRRRRRRRRRRRRRRRRRRRRRRRRRRRRRRRRRRRRRRRRZZZZZZZZZZZZZZZZRRRRRRRRRRRRZZZZZZZZZZZRRRRRRRRRRRZcc
ccZZZZZZRRRZZZZZZZZZZZRRRRRRZZZZZZRRRRRRRRRRRRRRRRRRRRRRRRRRRRRRRRRvRRRRRRRRRRRRRRRRRZZZZZZZZZZZZZZZZZZRRRRRRRRRRRRRZZZZZZZZZZRRRRRRRRRRZZcc
ccZZZZZZRRRZZZZZZZZZZZRZZZZZZZZZZRRRRRRRRRRRRRRRRRRRRRRRRRRRRRRRRRRRRRRRRRRRRRRRRRRRZZZZZZZZZZZZZZZZZZZRRRRRRRRRRRRRRRRRZZZZZRRRRRRRRRRRRZcc
ccZZZZZZZRRZZZZZZZZZZZZZZZZZZZZZZRRRRRRRRRRRRRRRRRRRRRRRRRRRRRRRRRRRRRRRRRRRRRRRRRRZZZZZZZZZZZZZZZZZZZRRRRRRRRRRRRRRRRRRRRZZRRRRRRRRRRRRZZcc
ccZZZZZZZRRRRZZZZZZZZZZZZZZZZZZZZRRRRRRRRRRRRRRRRRRRRRRRRRRRRRRRRRRRRRRRRRRRRRRRRRRRRZZZZZZZZZZZZZZZRRRRRRRRZZZZZRRRRRRRRRRRRRRRRRRRZRRRZZcc
ccZZZZZZZZRRRRZZZZZZZZZZZZZZZZZZRRRRRRRRRRRRRRRRRRRRRRRRRRRRRRRRRRRRRRRRRRRRRRRRRRRRRRRZZZZZZZZZZRRRRRRRRRRRRZZZZRRRRRRRRRRRRRRRRRRZZZRRZZcc
ccZZZZZZZZRRRRRZZZZZZZZZZZZZZZZRRRRRRRRRvRRRRRRRRRRRRRRRRRRRRRRRRRRRRRRRRRRRRRRRRRRRRRRRRZZZZZRRRRRRRRRRRRRRRRRRRRRRRRRRRRRRRRRRRRRZZZRRZZcc
ccZZZZZZZZZRRRRRZZZZZZZZZZZZZZZRRRRRRRRRRRRRRRRRRRRRRRRRRRRRRRRRRRRRRRRRRRRRRRRRRRRRRRRRRRRRRRRRRRRRRRRRRRRRRRRRRRRRRRRRRRRRRRRRRRRZZRRRZZcc
ccZZZZZZZZZZRRRRRZZZZZZZZZZZZZRRRRRRRRRRRRRRRRRRRRRRRRRRRRRRRRRRRRRRRRRRRRRRRRRRRRRRRRRRRRRRRRRRRRRRRRRRRRRRRRRRRRRRRRRRRRRRRRRRRRRRRRRZZZcc
ccZZZZZZZZZZRRRRRZRZZZZZZZZZZZRRRRRRRRRRRRRRRRRRRRRRRRRRRRRRRRRRRRRRRRRRRRRRRRRRRRRRRRRRRRRRRRRRRRRRoRRRRRRRRRRRRRRRRRRRRRRRRRRRRRRRRRRZZZcc
ccZZZZZZZZZZRRRRRRRRRZZZZZZZZRRRRRRRRRRRRRRRRRRRRRRRRRRRRRRRRRRRRRRRRRRRRRRRRRRRRRRRRRRRRRRRRRRRRRRRRRRRRRRRRRRRRRRRRRRRRRRRRZZZRRRRoRRZZZcc
ccZZZZZZZZZZRRRZRRRRRRRZZZZZZRRRRRRRRRRRRRRRRRRRRRRRRRRRRRRRRRRRRRRRRRRRRRRRRRRRRRRRRRRRRRRRRRRRRRRRRRRRRRRRRRRRRRRRRRRRRRRRZZZZRRRRRRRZZZcc
ccZZZZZZZZZZRRRZZZZRRRRRRRRZZRRRRRRRRRRRRRRRRRRRRRRRRRRRRRRRRRRRRRRRRRRRRRRRRRRRRRRRRRRRRRRRRRRRRRRRZZRZZZZZZRZRRRRRRRRRRRRZZZZZZRRRRRRZZZcc
ccZZZZZZZZZRRRZZZZZZZZZRRRRRRRRRRRRRRRRRRRRRRRRRRRRRRRRRRRRRRRRRRRRRRRRRRRRRRRRRRRRRRRRRRRRRRRRRRZZZZZZZZZZZZZZZZZRRRRRRRRRZZZZZZRRRRRRRRZcc
ccZZZZZZZZZRRRKKKKKKKKKZZZRRRRRRRRRRRRRRRRRRRRRRRRRRRRRRRRRRRRRRRRRRRRRRRRRRRRRRRRRRRRRRRRRRRZZZZZZZZZZZZZZZZZZZZZZZZRRRRRRRZZZZZRRRRRRRRZcc
ccZZZZZZZRRRRZZZZZZZZZZZZZZRRRRRRRRRRRRRRRRRRRRRRRRRRRRRRRRRRRRRRRRRRRRRRRRRRRRRRRRRRRRRRRRZZZZZZZZZZZZZZZZZZZZZZZZZZZZZRRRRRRZZZZZRRRRZZZcc
ccZZZZZZRRRRZZZZZZZZZZZZZZZRRRRRRRRRRRRRRRRRRRRRRRRRRRRRRRRRRRRRRRRRRRRRRvRRRRRRRRRRRRRRZZZZZZZZZZZRRRRRZZRRRRRRRRRZZZZZZZRRRRZZZZZZZZZZZZcc
ccZZZZZRRARZZZZZZZZZZZZZZZZRRRRRRRRRRRRRRRRRRRRRRRRRRRRRRRRRRRRRRRRRRRRRRRRRRRRRRRRRRRRZZZZZZZZRRRRRRRRRRRRRRRRRRRRRRRRZZZZRRRRRZZZZZZZZZZcc
ccZZZZZRRRRRZZZZZZZZZZZZZZZRRRRRRRRRRRRRRRRRRRRRRRRRRRRRRRRRRRRRRRRRRRRRRRRRRRRRRRRRRZZZZZZRRRRRRRRRRRRRRRRRRNRRRRRRRRRRZZZZZRRRZZZZZZZZZZcc
ccZZZZZRRRZRRRZZZZZZZZZZZZZRRRRRRRRRRRRRRRRRRRRRRRRRRRRRRRRRRRRRRRRRRRRRRRRRRRRRRRRZZZZZZRRRRRRRRRRRRRRRRRRZZRRRRRRRRRRRRRZZZZRRRZZZZZZZZZcc
ccZZZZRRRRZRRRRZZZZZZZZZZZZRRRRRRRRRRRRRRRRRRRRRRRRRRRRRRRRRRRRRRRRRRRRRRRRRRRRRRRZZZZZZRRRRRRRRRRZRRRRRZRRRRRRRRRRRRRRRRRRZZZZRRZZZZZZZZZcc
ccZZZZRRRZZZRRRRZZZZZZZZZZZRRRRRRRRRRRRRRRvRRRRRRRRRRRRRRRRRRRRRRRRRRRRRRRRRRRRRRRZZZRRRRRRRRRZRRRRRRRRRRRRRRRRRRRRRRRRRRRRRRZZRRRZZZZZZZZcc
ccZZZRRRRZZZZRRRRZZZZZZZZZZZRRRRRRRRRRRRRRRRRRRRRRRRRRRRRRRRRRRRRRRRRRRRRRRRRRRRRRZZZRRRRRRRRRRRRRRRRRRRRRRRRRRRRRZZZRRRRRRRRRZZRRRZZZZZZZcc
ccZZZRRRRZZZZZZRRZZZZZZZZZZZZRRRRRRRRRRRRRRRRRRRRRRRRRRRRRRRRRRRRRRRRRRRRRRRRRRRZZZZZRRRRZRRRRRRRRRRRRRRRRRRRRRRRRRRRRRRRRRRRRZZZRRRZZZZZZcc
ccZZZRRRRZZZZZZZRRZZZZZZZZZZZRRRRRRRRRRRRRRRRRRRRRRRRRRRRRRRRRRRRRRRRRRRRRRRRRRRZZZZRRRRRRRRRRRRRRRRRRRRRRRRRRRRRRRRRRRRRRRRRRRZZRRRZZZZZZcc
ccZZZRRRRZZZZZZZRRRZZZZZZZZZZZRRRRRRRRRRRRRRRRRRRRRRRRRRRRRRRRRRRRRRRRRRRRRRRRRZZZZZRRRRRRRRRRRRfRRRRRZZRRRRZZZRRRRRRRRRRRRRRRRRZZRRZZZZZZcc
ccZZZRRRRZZZZZZZZRRRZZZZZZZZZZZZRRRRRRRRRRRRRRRRRRRRRRRRRRRRRRRRRRRRRRRRRRRRRRRZZZZZRRRRRRRRRRRRRRRRRZZRRRRRRRZZRRRRRRRRRRRRRRRRRZRRZZZZZZcc
ccZZZRRRRZZZZZZZZZRRZZZZZZZZZZZZZZRRRRRRRRRRRRRRRRRRRRRRRRRRRRRRRRRRRRRRRRRRRRZZZZZRRRRZRRRRRRRRRRRRRRRRRRRRRRRRRRRRRRRRRRRRZRRRRRRRZZZZZZcc
ccZZZZRRRZZZZZZZZZRRZZZZZZZZZZZZZZRRRRRRRRRRRRRRRRRRRRRRRRRRRRRRRRRRRRRRRRRRRRZZZZRRRRRRRRRRRRRRRRRRRRRRRRRRRRRRRRRRRRRRRRRRRRRRRRRRRZZZZZcc
ccZZZZRRRZZZZZZZZZZRRZZZZZZZZZZZZZZZRRRRRRRRRRRRRRRRRRRRRRRRRRRRRRRRRRRRRRRRRRZZZRRRZRRRRRRRRRRRRRRRRRRRRRRRRRRRRRRRRZRRRRRRRRRRRRRRRZZZZZcc
ccZZZZRRRZZZZZZZZZZRRZZZZZZZZZZZZZZZRRRRRRRRRRRRRRRRRRRRRRRRRRRRRRRRRRRRRRRRRZZZRRRZZRRRRRRZZZRRRRRRRRRRRRRRRRRRRRRRRZZZRRRRRRRRRRRRRZZZZZcc
ccZZZZRRRZZZZZZZZZZRRZZZZZZZZZZZZZZZZRRRRRRRRRRRRRRRRRRRRRRRRRRRRRRRRRRRRRRRRZZRRRRRRRRRRRZZZRRRRRRRRRRRRRRRRRRRRRRRRRRRRRRRRRRRRRRRRZZZZZcc
ccZZZZRRRZZZZZZZZZZRRZZZZZZZZZZZZZZZZZRRRRRRRRRRRRRRRRRRRRRRRRRRRRRRRRRRRRRRRZZRRRRRRRRRRRZZRRRRRRRRRRRRRRRRRRRRRRRRRRRRRRRRRRRRRRRRRZZZZZcc
ccZZZZRRRZZZZZZZZZZRRZZZZZZZZZZZZZZZZZZZRRRRRRRRRRRRRRRRRRRRRRRRRRRRRRRRRRRRRZZRRRRRRRRRRRZRRRRRRRRRRRRRRRRRRRRRRRRRRRRRRZZRRRRRRRRRRRZZZZcc
ccZZZZRRRRZZZZZZZZZRRRZZZZZZZZZZZZZZZZZZZRRRRRRRRRRRRRRRRRRRRRRRRRRRRRRRRRRRZZZRRRRRRRRRRRRRRRRRRRRRRRRRRRRRRRRRRRRRRRRRRRZRRRRRRZZRRRZZZZcc
ccZZZZRRRRZZZZZZZZZRRRZZZZZZZZZZZZZZZZZZZZZRRRRRRRRRRRRRRRRRRRRRRRRRRRRRRRRRZZZRRRRRRRRRRRRRRRRRRRRRRRRRRRRRRRRRRRRRRRRRRRRRRRRRRRZRRRZZZZcc
ccZZZZZRRRRZZZZZZZZRRRRZZZZZZZZZZZZZZZZZZZZZRRRRRRRRRRRRRRRRRRRRRRRRRRRRRRRRZZZRRRZRRRRRRRRRRRRRRRRRRRRRRRRRRRRRRRRRRRRRRRRRRRRRRRRRRRZZZZcc
ccZZZZZRRRRZZZZZZZZZRRRZZZZZZZZZZZZZZZZZZZZZRRRRRRRRRRRRRRRRRRRRRRRRRRRRRRRRZZZRRRRRRRRRRRRRRRRRRRRRRRRRRRRRRRRRRRRRRRRRRRRRRRRRRRRRRRZZZZcc
ccZZZZZRRRRZZZZZZZZZRRRRZZZZZZZZZZZZZZZZZZZZZRRRRRRRRRRRRRRRRRRRRRRRRRRZZRRRRZZRRRRRRRRRRRRRRRRRRRRRRRRRRRRRRRRRRRRRRRRRRRRRRRRRRRRNRRZZZZcc
ccZZZZZRRRRZZZZZZZZZRRRRZZZZZZZZZZZZZZZZZZZZZZRRRRRRRRRRRRRRRRRRRRRRRRRZZRRRRZZRRRRRRRRRRRRRRRRRRRRRRRRRRRRRRRRRRRRRRRRfRRRRRRRRRRRRRRZZZZcc
ccZZZZZZRRRZZZZZZZZZZRRRZZZZZZZZZZZZZZZZZZZZZZZRRRRRRRRRRRRRRRRRRRRRRRRZZRRRRZZZRRRRRRRRRRRRRRRRRRRRRRRRRRRRRRRRRRRRRRRRRRRRZRRRRRRRRRZZZZcc
ccZZZZZZRRRZZZZZZZZZZZRRRZZZZZZZZZZZZZZZZZZZZZZZRRRRRRRRRRRRRRRRRRRRRRRZZRRRRRRZRRRRRRRRRRRRRRRRRRRRRRRRRRRRRRRRRRRRRRRRRRRRZRRRRZRRZRZZZZcc
ccZZZZZZZRRZZZZZZZZZZZZRRRZZZZZZZZZZZZZZZZZZZZZZZZRRRRRRRRRRRRRRRRRRRRRZZRRRRRRRRRRRZZRRRRRRRRRRRRRRRRRRRRRRRRRRRRRRRRRRRRRZZRRRRRRRRRZZZZcc
ccZZZZZZZRRZZZZZZZZZZZZZRRRZZZZZZZZZZZZZZZZZZZZZZRRRRRRRRRRRRRRRRRRRRRRRZZRRRRRRZRRRZZRRRRRRRRRRRRRRRRRRRRRRRRRRRRRRRRRRRRRZZRRRRRRRRRZZZZcc
ccZZZZZZZRRZZZZZZZZZZZZZZRRZZZZZZZZZZZZZZZZZZZZZZEEEEHEEEEEEEEEEEEEEEEEEHHHEEEHHHHRRRRRRRRRRRRRRRRRRRRRRRRRRRRRRRRRRRRRRRRRZZRRRRRRRRRZZZZcc
ccZZZZZZZRRRZZZZZZZZZZZZZZRRZZZZZZZZZZZZZZZZZRRRREHHHHEEEEEEEEEEEEEEEEEEEHHHHHHEEHZZZRRRRRRRRRRRRRRRRRRRRRRRRRRRRRRRRRRRRRRRRRRRRRRRRRZZZZcc
ccZZZZZZZRRRZZZZZZZZZZZZZZRRRZZZZZZZZZZZZZZRRRRRRHHHHHHEEEEEEEEEEEEEEEEEEEHHEHHHHHZZZRRRRRRRRRRRRRRRRRRRRRRRRRRRRRRRRRRRRRRRRRRRRRRRRZZZZZcc
ccZZZZZZZRRRZZZZZZZZZZZZZZZRRZZZZZZZZZZZZZRRRRRZZHHHHHHEEEEEEEEEEEEEEEEEEEEEEHHHHHZZZRRRRRRRRRRRRRRRRRRRRRRRRRRRRRRRRRRRRRRRRRRRRRRRRZZZZZcc
ccZZZZZZZRRRZZZZZZZZZZZZZZZRRRZZZZZZZZZZZRRRRZZZZHHHHHEEEEEEEEEEEEEEEEEEEEEEEEEHHHRZZRRRRZZZRRRRfRRRRRRRRRRRRRRRRRRRRRRRRRRRRRRRRRRRRZZZZZcc
ccZZZZZZZZRRRZZZZZZZZZZZZZZZRRRZZZZZZZZZRRRZZZZZZHHHEEEEEEEEEEEEEEEEEEEEEEEEEEEHHHZZZRRRRRZZRRRRRRRRRRRRRRRRRRRRRRRRRRRRRRRRRRRZZRRRZZZZZZcc
ccZZZZZZZZRRRRZZZZZZZZZZZZZZZRRZZZZZRRRRRRZZZZZZZHHHEEEEEEEEEEEEEEEEEEEEEEEEEEEHHEZRZZRRRRRRRRRRRRRRRRRRRRRRRRRRRRRRRRRRRRRRRRRRRRRRZZZZZZcc
ccZZZZZZZZZRRRRZZZZZZZZZZZZRRRRRRRRARRRRRRZZZZZZZHHHEEEEEEEEEEEEEEEEEEEEEEEEEEEHHERZZZRRRRRRRRRRRRRRRRRRRRRRRRRRRRRRRRRRRRRRRRRRRRRZZZZZZZcc
ccZZZZZZZZZRRRRRZZZZZZZRRRRRRRRRRRRRZZZZRRZZZZZZZHHEEEEEEEEEEEEEEEJEEEEEEEEEEEEHHERZRZZRRRRRRRRRRRRRRRRRRRRRRRRRRRRRRRRRRRRRRRRRRRZZZZZZZZcc
ccZZZZZZZZZZRRRRRRRRRRRRRRRRRRRRZZZZZZZZRRZZZZZZZHHHEEEEEEEEEEEEEEEEEEEEEEEEEEEHHERZZZRRRRRRRRRRRRZRRRRRRRRRRRRRRRRRRZZZRRRRRRRRRRZZZZZZZZcc
ccZZZZZZZZZZZRRARRRRRRRRRRRRZZZZZZZZZZZZZRRZZZZZZHHHEEEEEEEEEEEEEEEEEEEEEEEEEEEHHHZRZZZRRRRRRRRRRRZZRRRRRRRRZZRRRRRRZZRRRRfRZRRRRZZZZZZZZZcc
ccZZZZZZZZZZZRRRRZZRZZZRZZZZZZZZZZZZZZZZZRRRRZZZZHHEEEEEEEEEEEEEEEEEEEEEEEEEEkEHHHZZZRZZRRRRRRRRRRRRZZRRRRRRZZZRRRRRRRRRRRRRRRRRZZZZZZZZZZcc
ccZZZZZZZZZZZZRRRZZZZZZZZZZZZZZZZZZZZZZZZRRRRZZZZHHHEEEEEEEEEEEEEEEEEEEEEEEEEEEHHHZZRRRRRRRRRRRRRRRRRRRRRRRRRRRRRRRRRRRRRRRRRRRZZZZZZZZZZZcc
ccZZZZZZZZZZZZRRRZZZZZZZZZZZZZZZZZZZZZZZZZRRRZZZZHHHEEEEEEEEEEEEEEEEEEEEEEEEEEEHHHZZZRRRRRRRRRRRRRRRRRRRRRRRRRRRRRRRRRRRRRRRRRZZZZZZZZZZZZcc
ccZZZZZZZZZZZZZRRRZZZZZZZZZZZZZZZZZZZZZZZZZRRZZZZHHHEEEEEEEEEEEEEEEEEEEEEEEEEEEHHHZZZRRRRRRRRZRRRRRRRRRRRRRRRRRRRRRRRRRRRRRRZZZZZZZZZZZZZZcc
ccZZZZZZZZZZZZZRRRRRZZZZZZZZZZZZZZZZZZZZZZZRRZZZZHHHEEEEEEEEEEEEEEEEEEEEEEEEEEEHHHZZZRRRRRRRRRRRRRRRRRRRRRRRRRRRRRRRRRZRRRRZZZZZZZZZZZZZZZcc
ccZZZZZZZZZZZZZZRRRRZZZZZZZZZZZZZZZZZZZZZZZZRZZZZHHHEEEEEEEEEEEEEEEEEEEEEEEEEEHHHHZRRRZZZZRRRRRRRRRRZRRRRRRRRRRRRRRRRRRRRRZZZZZZZZZZZZZZZZcc
ccZZZZZZZZZZZZZZZRRRRRRRZZZZZZZZZZZZZZZZZZZZRRZZZHHHHEEEEEEEEEEEEEEEEEEEEEEEEEHHHHZRRRZZZZZRRRRRRRRRZRRRRRRRRRRRRZRRRRRRRZZZZZZZZZZZZZZZZZcc
ccZZZZZZZZZZZZZZZZRRRRRRRRRRRRRRRZZZZZZZZZZZRRRZZHHHHEEEEEEEEEEEEEEEEEEEEEEEEEHHHHRRRRZZZZZZZRRRRRRRRRRRRRZZRRRRRRRRRRRZZZZZZZZZZZZZZZZZZZcc
ccZZZZZZZZZZZZZZZZZZZRRRRRRRRRRRRRRZZZZZZZZZRRRRZHHHHHHHEEEEEEEEEEEEEEEEHEEEEHHHEERRZZZZZZZZZZZZRRRRRRRRRRRRRRRRRRRRRRZZZZZZZZZZZZZZZZZZZZcc
ccZZZZZZZZZZZZZZZZZZZZZZZZZRRRRRRRRRRRRRRRRRRRRRREHHHHHHHHEEEEEEEEEEEEEEHHHHHHHEEERZZZZZZZZZZZZZZZRRRRRRRRRNRRRRRRRRZZZZZZZZZZZZZZZZZZZZZZcc
ccZZZZZZZZZZZZZZZZZZZZZZZZZZZZZZZZZZRRRRRRRRRRRRREEEHHHHHHHHHHEEEHHEEEEEHHHHEEEEEEZZZZZZZZZZZZZZZZZZZRRRRRRRRRRRZZZZZZZZZZZZZZZZZZZZZZZZZZcc
ccZZZZZZZZZZZZZZZZZZZZZZZZZZZZZZZZZZZZZZZZZRRZRRREEEdEEEHHHHEEEHHHHHHHEEEEEEEEHHHHZZZZZZZZZZZZZZZZZZZZZZZZZZZZZZZZZZZZZZZZZZZZZZZZZZZZZZZZcc
ccZZZZZZZZZZZZZZZZZZZZZZZZZZZZZZZZZZZZZZZZZZZZZZZHHEEEEEEEHEEHHHHHHHHHHHHHHHHHHHHHZZZZZZZZZZZZZZZZZZZZZZZZZZZZZZZZZZZZZZZZZZZZZZZZZZZZZZZZcc
ccyZZZZZZZZZZZZZZZZZZZZZZZZZZZZZZZZZZZZZZZZZZZZZZHHHHHHHHHHHHHHHHHHHHHHHHHHHHHHHHHZZZZZZZZZZZZZZZZZZZZZZZZZZZZZZZZZZZZZZZZZZZZZZZZZZZZZZZZcc
cccccccccccccccccccccccccccccccccccccccccccccccccccccccccccccccccccccccccccccccccccccccccccccccccccccccccccccccccccccccccccccccccccccccccccc
cccccccccccccccccccccccccccccccccccccccccccccccccccccccccccccccccccccccccccccccccccccccccccccccccccccccccccccccccccccccccccccccccccccccccccc
"}
