"a" = (/turf/template_noop,/area/template_noop)
"e" = (/turf/simulated/mineral/floor/vacuum,/area/triumph_away/poi_d/explored)
"i" = (/turf/simulated/shuttle/floor,/area/triumph_away/poi_d/explored)
"p" = (/obj/structure/bed/chair{dir = 4},/obj/item/radio/intercom{pixel_y = -26},/obj/structure/closet/walllocker/emerglocker{icon_state = "oxygen_tank_open"; pixel_y = 28},/turf/simulated/shuttle/floor,/area/triumph_away/poi_d/explored)
"r" = (/obj/structure/door_assembly{icon_state = "door_as_gext3"},/turf/simulated/mineral/floor/vacuum,/area/triumph_away/poi_d/explored)
"u" = (/obj/item/tool/crowbar/red,/turf/simulated/mineral/floor/vacuum,/area/triumph_away/poi_d/explored)
"v" = (/obj/structure/shuttle/engine/propulsion/burst{dir = 8; icon_state = "propulsion"},/turf/simulated/shuttle/wall,/area/triumph_away/poi_d/explored)
"w" = (/obj/structure/bed/chair{dir = 4},/turf/simulated/shuttle/floor,/area/triumph_away/poi_d/explored)
"z" = (/obj/structure/grille,/obj/structure/shuttle/window,/turf/simulated/shuttle/floor,/area/triumph_away/poi_d/explored)
"C" = (/turf/simulated/shuttle/wall,/area/triumph_away/poi_d/explored)
"D" = (/obj/random/humanoidremains,/obj/item/clothing/suit/space/emergency{breaches = list("huge tear"); name = "Ruined Softsuit"},/obj/item/clothing/head/helmet/space/emergency,/obj/effect/decal/cleanable/blood,/obj/item/tank/emergency/oxygen,/obj/item/clothing/mask/breath,/turf/simulated/mineral/floor/vacuum,/area/triumph_away/poi_d/explored)
"K" = (/obj/random/humanoidremains,/obj/structure/bed/chair{dir = 4},/obj/effect/decal/cleanable/blood,/turf/simulated/shuttle/floor,/area/triumph_away/poi_d/explored)

(1,1,1) = {"
aaaeeeeeee
uerevCCCCe
eDeeipwKze
aeDevCCCCa
aaeueeaaaa
"}
