"aV" = (/obj/machinery/atmospherics/pipe/manifold/hidden{dir = 1},/turf/simulated/floor/plating,/area/triumph_away/poi_d/POIs/mercbunker)
"bD" = (/obj/machinery/door/airlock/multi_tile,/turf/simulated/floor/tiled/white,/area/triumph_away/poi_d/POIs/mercbunker)
"da" = (/turf/simulated/mineral/vacuum,/area/triumph_away/poi_d/explored)
"dI" = (/obj/random/trash_pile,/obj/structure/closet/cabinet,/turf/simulated/floor/airless,/area/triumph_away/poi_d/explored)
"ga" = (/obj/item/stool/padded,/turf/simulated/floor/tiled,/area/triumph_away/poi_d/POIs/mercbunker)
"gP" = (/obj/machinery/vending/cola,/turf/simulated/floor/tiled,/area/triumph_away/poi_d/POIs/mercbunker)
"gT" = (/obj/random/trash,/turf/simulated/mineral/floor/vacuum,/area/triumph_away/poi_d/explored)
"gW" = (/obj/machinery/door/airlock/multi_tile,/turf/simulated/floor/tiled,/area/triumph_away/poi_d/POIs/mercbunker)
"hw" = (/obj/machinery/atmospherics/pipe/simple/hidden{dir = 6},/turf/simulated/wall,/area/triumph_away/poi_d/POIs/mercbunker)
"hZ" = (/obj/machinery/atmospherics/unary/vent_pump/high_volume,/turf/simulated/floor/tiled,/area/triumph_away/poi_d/POIs/mercbunker)
"is" = (/obj/machinery/light{dir = 8},/turf/simulated/floor/tiled,/area/triumph_away/poi_d/POIs/mercbunker)
"js" = (/obj/structure/sign/warning{pixel_x = 32},/turf/simulated/floor/airless,/area/triumph_away/poi_d/explored)
"jx" = (/obj/random/trash_pile,/turf/simulated/floor/airless,/area/triumph_away/poi_d/explored)
"jF" = (/obj/structure/table/reinforced,/obj/item/storage/box/shotgunshells/large,/turf/simulated/floor/tiled,/area/triumph_away/poi_d/POIs/mercbunker)
"jG" = (/turf/simulated/floor/tiled/kafel_full,/area/triumph_away/poi_d/POIs/mercbunker)
"kp" = (/obj/machinery/vending/boozeomat,/turf/simulated/wall,/area/triumph_away/poi_d/POIs/mercbunker)
"kP" = (/obj/machinery/light,/turf/simulated/floor/tiled,/area/triumph_away/poi_d/POIs/mercbunker)
"mn" = (/turf/template_noop,/area/template_noop)
"no" = (/obj/structure/table/marble,/turf/simulated/floor/tiled,/area/triumph_away/poi_d/POIs/mercbunker)
"nC" = (/obj/machinery/door/airlock/external/glass{frequency = 804; icon_state = "door_locked"; id_tag = "bunkerD_internal"; locked = 1},/turf/simulated/floor/tiled,/area/triumph_away/poi_d/POIs/mercbunker)
"pq" = (/obj/machinery/atmospherics/pipe/manifold/hidden{dir = 4},/turf/simulated/floor/plating,/area/triumph_away/poi_d/POIs/mercbunker)
"pJ" = (/obj/machinery/vending/snack,/turf/simulated/floor/tiled,/area/triumph_away/poi_d/POIs/mercbunker)
"qa" = (/obj/structure/toilet{pixel_y = 15},/turf/simulated/floor/tiled/white,/area/triumph_away/poi_d/POIs/mercbunker)
"qm" = (/obj/structure/closet/secure_closet/freezer/meat,/turf/simulated/floor/tiled/kafel_full,/area/triumph_away/poi_d/POIs/mercbunker)
"rc" = (/turf/simulated/floor/tiled/white,/area/triumph_away/poi_d/POIs/mercbunker)
"uD" = (/turf/simulated/floor/tiled,/area/triumph_away/poi_d/POIs/mercbunker)
"vP" = (/obj/structure/table/marble,/obj/item/reagent_containers/food/condiment/small/saltshaker,/turf/simulated/floor/tiled,/area/triumph_away/poi_d/POIs/mercbunker)
"wt" = (/obj/structure/table/reinforced,/obj/item/rig/merc,/turf/simulated/floor/tiled,/area/triumph_away/poi_d/POIs/mercbunker)
"xq" = (/obj/structure/closet/gimmick/tacticool,/obj/item/material/knife/tacknife,/turf/simulated/floor/tiled,/area/triumph_away/poi_d/POIs/mercbunker)
"yw" = (/obj/structure/table/reinforced,/obj/item/ammo_magazine/m45tommy,/obj/item/ammo_magazine/m45tommy,/obj/item/ammo_magazine/m45tommy,/turf/simulated/floor/tiled,/area/triumph_away/poi_d/POIs/mercbunker)
"zH" = (/obj/machinery/appliance/cooker/fryer,/obj/item/reagent_containers/cooking_container/fryer,/obj/machinery/light{dir = 4},/turf/simulated/floor/tiled,/area/triumph_away/poi_d/POIs/mercbunker)
"zZ" = (/obj/machinery/embedded_controller/radio/airlock/docking_port{frequency = 804; id_tag = "bunkerD"},/turf/simulated/wall,/area/triumph_away/poi_d/POIs/mercbunker)
"Ac" = (/obj/machinery/door/airlock/freezer,/turf/simulated/floor/tiled/kafel_full,/area/triumph_away/poi_d/POIs/mercbunker)
"As" = (/obj/structure/curtain/open/shower,/obj/machinery/shower{pixel_y = 16},/turf/simulated/floor/tiled/white,/area/triumph_away/poi_d/POIs/mercbunker)
"BE" = (/obj/machinery/light/small{dir = 1},/turf/simulated/floor/tiled/kafel_full,/area/triumph_away/poi_d/POIs/mercbunker)
"Ch" = (/turf/simulated/mineral/floor/vacuum,/area/triumph_away/poi_d/unexplored)
"Ci" = (/turf/simulated/wall,/area/triumph_away/poi_d/explored)
"CA" = (/obj/structure/table/reinforced,/obj/item/storage/firstaid/clotting,/turf/simulated/floor/tiled,/area/triumph_away/poi_d/POIs/mercbunker)
"Df" = (/obj/structure/bed,/obj/item/bedsheet,/turf/simulated/floor/tiled,/area/triumph_away/poi_d/POIs/mercbunker)
"Di" = (/obj/machinery/door/airlock/maintenance/common,/turf/simulated/floor/plating,/area/triumph_away/poi_d/POIs/mercbunker)
"Ex" = (/obj/machinery/embedded_controller/radio/airlock/docking_port{frequency = 804; id_tag = "bunkerD"; pixel_x = 24; pixel_y = -2},/obj/machinery/airlock_sensor{frequency = 804; id_tag = "bunkerD_sensor"; pixel_x = 24; pixel_y = 6},/turf/simulated/floor/tiled,/area/triumph_away/poi_d/POIs/mercbunker)
"FF" = (/obj/structure/table/reinforced,/obj/item/storage/firstaid/combat,/turf/simulated/floor/tiled,/area/triumph_away/poi_d/POIs/mercbunker)
"Hi" = (/obj/structure/closet/crate/freezer/rations,/turf/simulated/floor/tiled/kafel_full,/area/triumph_away/poi_d/POIs/mercbunker)
"Hy" = (/mob/living/simple_mob/humanoid/merc/ranged/grenadier,/turf/simulated/floor/tiled,/area/triumph_away/poi_d/POIs/mercbunker)
"HQ" = (/obj/machinery/door/airlock/vault/bolted,/turf/simulated/floor/tiled,/area/triumph_away/poi_d/POIs/mercbunker)
"HS" = (/turf/simulated/floor/airless,/area/triumph_away/poi_d/POIs/mercbunker)
"HX" = (/turf/simulated/floor/airless,/area/triumph_away/poi_d/explored)
"Ij" = (/obj/random/trash,/obj/random/trash,/turf/simulated/floor/airless,/area/triumph_away/poi_d/explored)
"JG" = (/turf/simulated/mineral/floor/vacuum,/area/triumph_away/poi_d/explored)
"KB" = (/turf/simulated/wall,/area/triumph_away/poi_d/POIs/mercbunker)
"LA" = (/turf/simulated/wall/r_wall,/area/triumph_away/poi_d/POIs/mercbunker)
"LW" = (/obj/machinery/atmospherics/portables_connector{dir = 1},/obj/machinery/portable_atmospherics/canister/air/airlock,/turf/simulated/floor/plating,/area/triumph_away/poi_d/POIs/mercbunker)
"Mc" = (/obj/structure/sign/warning{pixel_x = 32},/obj/random/trash,/turf/simulated/floor/airless,/area/triumph_away/poi_d/explored)
"Nd" = (/obj/machinery/atmospherics/pipe/simple/hidden{dir = 8},/turf/simulated/wall,/area/triumph_away/poi_d/POIs/mercbunker)
"NS" = (/obj/machinery/appliance/cooker/oven,/turf/simulated/floor/tiled,/area/triumph_away/poi_d/POIs/mercbunker)
"Ot" = (/obj/structure/table/standard{name = "plastic table frame"},/obj/machinery/microwave,/turf/simulated/floor/tiled,/area/triumph_away/poi_d/POIs/mercbunker)
"Pc" = (/obj/structure/table/rack/shelf,/obj/item/storage/toolbox/syndicate,/turf/simulated/floor/plating,/area/triumph_away/poi_d/POIs/mercbunker)
"Ph" = (/obj/machinery/vending/dinnerware,/turf/simulated/floor/tiled/kafel_full,/area/triumph_away/poi_d/POIs/mercbunker)
"PI" = (/turf/simulated/wall{can_open = 1},/area/triumph_away/poi_d/POIs/mercbunker)
"QW" = (/obj/machinery/atmospherics/pipe/simple/hidden{dir = 6},/obj/machinery/light/small{dir = 8},/turf/simulated/floor/plating,/area/triumph_away/poi_d/POIs/mercbunker)
"RE" = (/obj/structure/closet/secure_closet/freezer/fridge,/turf/simulated/floor/tiled/kafel_full,/area/triumph_away/poi_d/POIs/mercbunker)
"Tf" = (/mob/living/simple_mob/humanoid/merc/melee/sword,/turf/simulated/floor/tiled,/area/triumph_away/poi_d/POIs/mercbunker)
"TB" = (/obj/machinery/atmospherics/pipe/manifold/hidden{dir = 8},/turf/simulated/floor/tiled,/area/triumph_away/poi_d/POIs/mercbunker)
"TI" = (/obj/structure/table/reinforced,/obj/item/gun/projectile/automatic/tommygun,/obj/machinery/light{dir = 4},/turf/simulated/floor/tiled,/area/triumph_away/poi_d/POIs/mercbunker)
"Us" = (/mob/living/simple_mob/humanoid/merc/ranged,/turf/simulated/floor/tiled,/area/triumph_away/poi_d/POIs/mercbunker)
"Vq" = (/obj/machinery/atmospherics/pipe/simple/hidden,/obj/structure/table/rack/shelf,/obj/item/clothing/gloves/yellow,/obj/item/clothing/gloves/yellow,/turf/simulated/floor/plating,/area/triumph_away/poi_d/POIs/mercbunker)
"VY" = (/obj/machinery/atmospherics/unary/vent_pump/high_volume{dir = 8; frequency = 1379; id_tag = "rnd_s_airlock_pump"},/turf/simulated/floor/tiled,/area/triumph_away/poi_d/POIs/mercbunker)
"Wd" = (/obj/random/trash,/turf/simulated/floor/airless,/area/triumph_away/poi_d/explored)
"Xh" = (/obj/structure/sink{dir = 8; pixel_x = -15},/obj/structure/mirror{pixel_x = -30},/turf/simulated/floor/tiled/white,/area/triumph_away/poi_d/POIs/mercbunker)
"XL" = (/obj/structure/table/reinforced,/obj/random/ammo,/obj/random/ammo,/obj/random/ammo,/obj/random/ammo,/obj/random/ammo,/turf/simulated/floor/tiled,/area/triumph_away/poi_d/POIs/mercbunker)
"XU" = (/obj/machinery/door/airlock/external/glass{frequency = 804; icon_state = "door_locked"; id_tag = "bunkerD_internal"; locked = 1},/obj/machinery/atmospherics/pipe/simple/hidden{dir = 9},/turf/simulated/floor/tiled,/area/triumph_away/poi_d/POIs/mercbunker)
"Ys" = (/obj/structure/bed,/obj/structure/bed,/obj/item/bedsheet,/turf/simulated/floor/tiled,/area/triumph_away/poi_d/POIs/mercbunker)
"YM" = (/mob/living/simple_mob/humanoid/merc/ranged/smg,/turf/simulated/floor/tiled,/area/triumph_away/poi_d/POIs/mercbunker)
"Zm" = (/obj/machinery/door/airlock/external/glass{frequency = 804; icon_state = "door_locked"; id_tag = "bunkerD_external"; locked = 1},/turf/simulated/floor/tiled,/area/triumph_away/poi_d/POIs/mercbunker)

(1,1,1) = {"
mnmnmnmnmnmnmnmnmnmnmnmnmnmnmndadadadadadadadamnmn
mnmndadadadadadadadadadadadadadadadadadadadadadada
mndadadadadadadadadadadadadadadadadadadadadadadada
dadadadadadajxHXjxdaCidadaKBzZKBdadaKBKBKBKBKBdada
dadadadajxHXWdWdWdjsKBKBKBKBPIKBKBKBKBqmBEHiKBdada
dadadajxHXWdHXjxWdWdPIHSHSHSHSZmhZExKBqmjGHiKBdada
dadadaWdWdjxjxHXIjMcKBHSHSHSHSZmTBVYKBREjGHiKBdada
dadadajxWdHXjxHXWdjxKBKBKBhwNdNdXUnCKBREjGPhKBdada
dadadadajxHXWdHXdIdaKBPcPcVqKBuDuDuDKBKBAcKBKBdada
dadadadadaWdWdWddadaKBQWaVpqDiuDuDuDganouDuDkpdada
ChdadadadaHXWdWddadaKBLWLWLWKBisuDuDganouDzHKBdada
ChdadadadagTJGJGdadaKBKBKBKBKBUsuDuDgavPuDNSKBdada
ChdadadadaJGJGdadadaKBAsqaKBpJuDuDuDuDUsuDOtKBdada
ChdadadaJGJGJGJGdadaKBXhrcKBgPuDuDuDLALALALAKBdada
ChChdadaJGJGJGdadaKBKBKBbDKBKBKBgWLALAXLjFLALAdada
ChChChJGJGJGdadadaKBuDuDuDuDuDuDuDLAHyuDuDwtLAdada
ChChChJGJGJGdadadaKBuDYMuDuDuDuDuDHQuDuDuDTILAdada
ChChChJGJGdadadadaKBDfuDxqKBxqTfDfLAHyuDuDywLAdada
ChChChdadadadadadaKBYsuDxqKBxquDDfLALAFFCALALAdada
ChChChdadadadadadaKBDfkPxqKBxqkPDfKBLALALALAdadada
ChChChdadadadadadaKBKBKBKBKBKBKBKBKBdadadadadadada
ChChChdadadadadadadadadadadadadadadadadadadadadamn
ChChChChdadadadadadadadadadadadadadadadadadadamnmn
ChChChChChChChdadadadadadadadadadadadadamnmnmnmnmn
ChChChChChChChChChChChChChChChChChChChChmnmnmnmnmn
"}
