"a" = (/turf/template_noop,/area/template_noop)
"b" = (/obj/machinery/door/airlock/maintenance/command{req_one_access = null},/turf/simulated/floor/tiled,/area/triumph_away/poi_d/POIs/landing_pad)
"c" = (/obj/structure/bed/chair{dir = 4},/obj/machinery/light/small{dir = 1},/turf/simulated/floor/tiled,/area/triumph_away/poi_d/POIs/landing_pad)
"d" = (/obj/triumph_away_spawner/D/drone_spawner,/turf/simulated/floor/tiled,/area/triumph_away/poi_d/POIs/landing_pad)
"g" = (/turf/simulated/floor/airless,/area/triumph_away/poi_d/POIs/landing_pad)
"i" = (/turf/simulated/floor/tiled,/area/triumph_away/poi_d/POIs/landing_pad)
"k" = (/obj/machinery/drone_fabricator/derelict,/turf/simulated/floor/tiled,/area/triumph_away/poi_d/POIs/landing_pad)
"l" = (/obj/structure/sink{dir = 8; pixel_x = -15},/obj/structure/mirror/raider{pixel_x = -30},/turf/simulated/floor/tiled/white,/area/triumph_away/poi_d/POIs/landing_pad)
"m" = (/obj/machinery/light{dir = 4},/turf/simulated/floor/tiled,/area/triumph_away/poi_d/POIs/landing_pad)
"n" = (/turf/simulated/mineral/floor/vacuum,/area/template_noop)
"p" = (/obj/machinery/door/airlock/maintenance/int,/turf/simulated/floor/tiled/white,/area/triumph_away/poi_d/POIs/landing_pad)
"q" = (/obj/machinery/door/blast/shutters{dir = 8; id = "matdropcargo"},/turf/simulated/floor/airless,/area/triumph_away/poi_d/POIs/landing_pad)
"r" = (/obj/structure/closet/crate,/obj/machinery/light{dir = 8},/obj/item/stack/cable_coil,/obj/item/stack/cable_coil,/obj/item/stack/cable_coil,/turf/simulated/floor/tiled,/area/triumph_away/poi_d/POIs/landing_pad)
"t" = (/obj/structure/closet/crate,/obj/fiftyspawner/wood,/obj/fiftyspawner/wood,/obj/fiftyspawner/wood,/turf/simulated/floor/tiled,/area/triumph_away/poi_d/POIs/landing_pad)
"u" = (/obj/machinery/door/airlock/maintenance/cargo{req_one_access = null},/turf/simulated/floor/tiled,/area/triumph_away/poi_d/POIs/landing_pad)
"w" = (/obj/structure/closet/crate,/obj/item/airlock_electronics,/obj/item/airlock_electronics,/obj/item/airlock_electronics,/turf/simulated/floor/tiled,/area/triumph_away/poi_d/POIs/landing_pad)
"x" = (/obj/structure/window/reinforced/full,/obj/structure/window/reinforced{dir = 4},/obj/structure/grille,/turf/simulated/floor/airless,/area/triumph_away/poi_d/POIs/landing_pad)
"B" = (/obj/structure/closet/crate,/obj/fiftyspawner/steel,/obj/fiftyspawner/steel,/obj/fiftyspawner/steel,/turf/simulated/floor/tiled,/area/triumph_away/poi_d/POIs/landing_pad)
"D" = (/obj/machinery/power/port_gen/pacman,/turf/simulated/floor/tiled,/area/triumph_away/poi_d/POIs/landing_pad)
"E" = (/obj/machinery/door/airlock/maintenance/int,/turf/simulated/floor/tiled,/area/triumph_away/poi_d/POIs/landing_pad)
"F" = (/obj/structure/table/standard,/obj/random/tech_supply,/obj/random/tech_supply,/obj/random/tech_supply,/turf/simulated/floor/tiled,/area/triumph_away/poi_d/POIs/landing_pad)
"H" = (/obj/machinery/door/airlock/glass_external{frequency = null; icon_state = "door_locked"; id_tag = "matdrop"; locked = 1},/turf/simulated/floor/tiled,/area/triumph_away/poi_d/POIs/landing_pad)
"J" = (/obj/item/modular_computer/console{dir = 8; icon_state = "broken"},/turf/simulated/floor/tiled,/area/triumph_away/poi_d/POIs/landing_pad)
"M" = (/obj/structure/closet/crate,/obj/fiftyspawner/phoron,/turf/simulated/floor/tiled,/area/triumph_away/poi_d/POIs/landing_pad)
"N" = (/turf/simulated/wall/titanium,/area/triumph_away/poi_d/POIs/landing_pad)
"P" = (/obj/structure/bed,/turf/simulated/floor/tiled,/area/triumph_away/poi_d/POIs/landing_pad)
"R" = (/obj/machinery/light/small,/turf/simulated/floor/tiled,/area/triumph_away/poi_d/POIs/landing_pad)
"S" = (/obj/machinery/button/remote/airlock/survival_pod{id = "matdrop"; pixel_y = 25},/turf/simulated/floor/tiled,/area/triumph_away/poi_d/POIs/landing_pad)
"T" = (/obj/machinery/button/remote/airlock/survival_pod{dir = 4; id = "matdropcargo"; pixel_x = -25},/obj/structure/closet/crate,/obj/fiftyspawner/rods,/turf/simulated/floor/tiled,/area/triumph_away/poi_d/POIs/landing_pad)
"V" = (/obj/machinery/door/blast/shutters{dir = 8; id = "matdropcargo"},/obj/machinery/door/blast/shutters{dir = 8; id = "matdropcargo"},/turf/simulated/floor/airless,/area/triumph_away/poi_d/POIs/landing_pad)
"W" = (/obj/structure/closet/crate,/obj/fiftyspawner/rglass,/obj/fiftyspawner/rglass,/obj/fiftyspawner/rglass,/turf/simulated/floor/tiled,/area/triumph_away/poi_d/POIs/landing_pad)
"X" = (/obj/structure/grille,/obj/structure/window/reinforced/full,/obj/structure/window/reinforced{dir = 4},/turf/simulated/floor/airless,/area/triumph_away/poi_d/POIs/landing_pad)
"Y" = (/obj/structure/toilet{pixel_y = 15},/obj/structure/loot_pile/surface/medicine_cabinet/fresh{pixel_x = -30},/turf/simulated/floor/tiled/white,/area/triumph_away/poi_d/POIs/landing_pad)

(1,1,1) = {"
aaaaaannnnnaaaa
aaNNNNNNggNNNNn
aNNkidDNNHNiJxn
nNTMiiiuSibiJxn
nqWtiimNRiNRJxn
nVwBiiNNNENNNNn
nNrBiiNYNicFXnn
aNNkidNlpdiPNna
aaNNNNNNNNNNNaa
aaaaaaaaaaaaaaa
"}
