"a" = (/turf/template_noop,/area/template_noop)
"o" = (/obj/random/outcrop,/turf/simulated/mineral/floor/vacuum,/area/triumph_away/poi_d/explored)
"u" = (/obj/structure/meteorite,/turf/simulated/mineral/floor/vacuum,/area/triumph_away/poi_d/explored)
"w" = (/obj/effect/floor_decal/asteroid,/turf/simulated/mineral/floor/vacuum,/area/triumph_away/poi_d/explored)
"Y" = (/turf/simulated/mineral/floor/vacuum,/area/triumph_away/poi_d/explored)

(1,1,1) = {"
aaaaaaa
aaoYYaa
awYYwoa
aoYuYYa
aYwYYwa
aaYwoaa
aaaaaaa
"}
