//MAP CONVERTED BY dmm2tgm.py THIS HEADER COMMENT PREVENTS RECONVERSION, DO NOT REMOVE
"a" = (
/turf/template_noop,
/area/template_noop)
"b" = (
/obj/effect/alien/resin/wall,
/turf/simulated/mineral/floor/vacuum,
/area/triumph_away/poi_d/explored)
"c" = (
/obj/structure/simple_door/resin,
/obj/effect/alien/weeds,
/turf/simulated/mineral/floor/vacuum,
/area/triumph_away/poi_d/explored)
"d" = (
/obj/effect/alien/weeds,
/obj/structure/bed/nest,
/obj/item/gun/projectile/p92x/large,
/turf/simulated/mineral/floor/vacuum,
/area/triumph_away/poi_d/explored)
"e" = (
/obj/effect/alien/weeds,
/turf/simulated/mineral/floor/vacuum,
/area/triumph_away/poi_d/explored)
"f" = (
/obj/effect/alien/weeds,
/obj/item/clothing/suit/storage/vest/tactical,
/turf/simulated/mineral/floor/vacuum,
/area/triumph_away/poi_d/explored)
"g" = (
/obj/effect/alien/weeds,
/obj/structure/bed/nest,
/obj/fiftyspawner/osmium,
/turf/simulated/mineral/floor/vacuum,
/area/triumph_away/poi_d/explored)
"h" = (
/obj/effect/alien/weeds,
/obj/random/multiple/minevault,
/mob/living/simple_mob/animal/space/alien/sentinel/praetorian,
/turf/simulated/mineral/floor/vacuum,
/area/triumph_away/poi_d/explored)
"i" = (
/obj/effect/alien/weeds,
/obj/effect/alien/egg,
/turf/simulated/mineral/floor/vacuum,
/area/triumph_away/poi_d/explored)
"j" = (
/obj/effect/alien/weeds,
/obj/effect/alien/weeds/node,
/mob/living/simple_mob/animal/space/alien/queen/empress,
/turf/simulated/mineral/floor/vacuum,
/area/triumph_away/poi_d/explored)
"k" = (
/obj/effect/alien/weeds,
/obj/item/clothing/head/helmet/tac,
/obj/item/gun/projectile/SVD,
/turf/simulated/mineral/floor/vacuum,
/area/triumph_away/poi_d/explored)
"A" = (
/obj/effect/alien/weeds,
/obj/structure/bed/nest,
/obj/fiftyspawner/durasteel,
/turf/simulated/mineral/floor/vacuum,
/area/triumph_away/poi_d/explored)
"X" = (
/obj/effect/alien/weeds,
/obj/structure/bed/nest,
/obj/fiftyspawner/phoron,
/turf/simulated/mineral/floor/vacuum,
/area/triumph_away/poi_d/explored)

(1,1,1) = {"
a
a
a
a
a
a
a
a
a
"}
(2,1,1) = {"
a
a
b
b
b
b
b
a
a
"}
(3,1,1) = {"
a
b
b
g
i
h
b
b
a
"}
(4,1,1) = {"
a
b
d
e
e
e
k
b
a
"}
(5,1,1) = {"
a
c
e
e
j
e
e
c
a
"}
(6,1,1) = {"
a
b
f
e
e
e
A
b
a
"}
(7,1,1) = {"
a
b
b
h
i
X
b
b
a
"}
(8,1,1) = {"
a
a
b
b
b
b
b
a
a
"}
(9,1,1) = {"
a
a
a
a
a
a
a
a
a
"}
