//MAP CONVERTED BY dmm2tgm.py THIS HEADER COMMENT PREVENTS RECONVERSION, DO NOT REMOVE
"a" = (
/turf/template_noop,
/area/template_noop)
"b" = (
/turf/simulated/mineral/vacuum,
/area/template_noop)
"c" = (
/turf/simulated/wall/r_wall,
/area/triumph_away/poi_d/explored)
"d" = (
/obj/effect/decal/cleanable/dirt,
/turf/simulated/floor/tiled/airless,
/area/triumph_away/poi_d/explored)
"e" = (
/obj/structure/closet/crate/mimic/cointoss,
/obj/effect/decal/cleanable/dirt,
/obj/fiftyspawner/mhydrogen,
/turf/simulated/floor/tiled/airless,
/area/triumph_away/poi_d/explored)
"w" = (
/turf/simulated/mineral/vacuum,
/area/triumph_away/poi_d/explored)

(1,1,1) = {"
a
a
b
b
a
a
"}
(2,1,1) = {"
a
b
b
b
b
a
"}
(3,1,1) = {"
b
b
b
b
b
w
"}
(4,1,1) = {"
b
b
b
b
w
c
"}
(5,1,1) = {"
b
b
b
w
d
c
"}
(6,1,1) = {"
b
b
w
w
e
c
"}
(7,1,1) = {"
a
w
w
c
c
c
"}
