//MAP CONVERTED BY dmm2tgm.py THIS HEADER COMMENT PREVENTS RECONVERSION, DO NOT REMOVE
"a" = (
/turf/space/basic,
/area/shuttle/trade_ship/starbord_dock)
"B" = (
/turf/space/basic,
/area/space)
"H" = (
/obj/effect/shuttle_landmark/trade/hangar,
/obj/machinery/embedded_controller/radio/airlock/docking_port{
	frequency = 1380;
	id_tag = "tradeport_hangar_docker";
	pixel_x = -25
	},
/obj/overmap/entity/visitable/ship/landable/trade,
/turf/space/basic,
/area/shuttle/trade_ship/starbord_dock)
"Q" = (
/obj/machinery/embedded_controller/radio/airlock/airlock_controller{
	frequency = 8018;
	id_tag = "trade_space_lock";
	pixel_x = -25
	},
/turf/space/basic,
/area/shuttle/trade_ship/port_dock)
"T" = (
/turf/space/basic,
/area/shuttle/trade_ship/port_dock)

(1,1,1) = {"
a
a
a
B
B
B
B
B
B
B
B
B
B
B
B
B
B
T
T
T
"}
(2,1,1) = {"
a
H
a
B
B
B
B
B
B
B
B
B
B
B
B
B
B
T
Q
T
"}
(3,1,1) = {"
a
a
a
B
B
B
B
B
B
B
B
B
B
B
B
B
B
T
T
T
"}
(4,1,1) = {"
a
a
a
B
B
B
B
B
B
B
B
B
B
B
B
B
B
T
T
T
"}
