//MAP CONVERTED BY dmm2tgm.py THIS HEADER COMMENT PREVENTS RECONVERSION, DO NOT REMOVE
"a" = (
/obj/effect/floor_decal/industrial/warning{
	dir = 10;
	icon_state = "warning"
	},
/turf/simulated/floor/reinforced,
/area/killhouse/teleporter)
"j" = (
/obj/item/radio/beacon{
	anchored = 1
	},
/turf/simulated/floor/reinforced,
/area/killhouse/teleporter)
"l" = (
/obj/machinery/tele_projector{
	dir = 8
	},
/obj/effect/floor_decal/industrial/warning,
/obj/machinery/light,
/turf/simulated/floor/reinforced,
/area/killhouse/teleporter)
"s" = (
/obj/machinery/tele_pad,
/obj/effect/floor_decal/industrial/warning,
/turf/simulated/floor/reinforced,
/area/killhouse/teleporter)
"z" = (
/obj/effect/floor_decal/industrial/warning{
	dir = 4;
	icon_state = "warning"
	},
/turf/simulated/floor/reinforced,
/area/killhouse/teleporter)
"B" = (
/obj/effect/floor_decal/industrial/warning{
	dir = 1;
	icon_state = "warning"
	},
/turf/simulated/floor/reinforced,
/area/killhouse/teleporter)
"J" = (
/turf/simulated/floor/reinforced,
/area/killhouse/teleporter)
"L" = (
/obj/effect/floor_decal/industrial/warning{
	dir = 6;
	icon_state = "warning"
	},
/obj/machinery/power/apc/hyper{
	cell_type = /obj/item/cell/infinite
	},
/turf/simulated/floor/reinforced,
/area/killhouse/teleporter)
"Q" = (
/obj/effect/floor_decal/industrial/warning{
	dir = 8;
	icon_state = "warning"
	},
/turf/simulated/floor/reinforced,
/area/killhouse/teleporter)
"S" = (
/obj/effect/floor_decal/industrial/warning{
	dir = 5;
	icon_state = "warning"
	},
/turf/simulated/floor/reinforced,
/area/killhouse/teleporter)
"V" = (
/obj/machinery/computer/teleporter{
	dir = 1
	},
/obj/effect/floor_decal/industrial/warning,
/turf/simulated/floor/reinforced,
/area/killhouse/teleporter)
"Z" = (
/obj/effect/floor_decal/industrial/warning{
	dir = 9;
	icon_state = "warning"
	},
/turf/simulated/floor/reinforced,
/area/killhouse/teleporter)

(1,1,1) = {"
Z
Q
Q
a
"}
(2,1,1) = {"
B
J
J
s
"}
(3,1,1) = {"
B
j
J
l
"}
(4,1,1) = {"
B
J
J
V
"}
(5,1,1) = {"
S
z
z
L
"}
