//MAP CONVERTED BY dmm2tgm.py THIS HEADER COMMENT PREVENTS RECONVERSION, DO NOT REMOVE
"a" = (
/turf/space/basic,
/area/space)
"c" = (
/obj/structure/cable{
	icon_state = "4-8"
	},
/turf/simulated/floor/plating/indoors,
/area/space)
"d" = (
/obj/structure/handrail{
	dir = 4
	},
/obj/structure/cable,
/obj/machinery/power/terminal{
	dir = 4
	},
/turf/simulated/floor/plating/indoors,
/area/space)
"e" = (
/obj/structure/handrail{
	dir = 8
	},
/obj/structure/cable{
	icon_state = "2-8"
	},
/turf/simulated/floor/plating/indoors,
/area/space)
"g" = (
/obj/effect/floor_decal/industrial/warning/full,
/obj/structure/cable{
	icon_state = "0-2"
	},
/turf/simulated/floor/plating/indoors,
/area/space)
"h" = (
/obj/structure/handrail{
	dir = 8
	},
/turf/simulated/floor/plating/indoors,
/area/space)
"i" = (
/turf/simulated/shuttle/wall/voidcraft,
/area/space)
"j" = (
/obj/machinery/shipsensors,
/turf/simulated/floor/plating/outdoors,
/area/space)
"k" = (
/obj/structure/handrail{
	dir = 4
	},
/turf/simulated/floor/plating/indoors,
/area/space)
"l" = (
/obj/effect/floor_decal/industrial/warning/full,
/obj/machinery/power/apc/south_mount,
/obj/structure/cable{
	icon_state = "0-4"
	},
/turf/simulated/floor/plating/indoors,
/area/space)
"q" = (
/turf/simulated/wall/rshull,
/area/space)
"s" = (
/obj/effect/floor_decal/industrial/warning/full,
/obj/structure/cable{
	icon_state = "0-4"
	},
/turf/simulated/floor/plating/indoors,
/area/space)
"t" = (
/obj/structure/railing,
/turf/simulated/floor/plating/indoors,
/area/space)
"w" = (
/obj/effect/floor_decal/industrial/warning/full,
/turf/simulated/floor/plating/indoors,
/area/space)
"y" = (
/obj/effect/floor_decal/industrial/warning/full,
/turf/space/basic,
/area/space)
"B" = (
/obj/spawner/window/low_wall/reinforced/full,
/turf/simulated/floor/plating/indoors,
/area/space)
"E" = (
/turf/simulated/floor/plating/indoors,
/area/space)
"I" = (
/obj/effect/floor_decal/industrial/warning/full,
/obj/structure/cable{
	icon_state = "4-8"
	},
/turf/simulated/floor/plating/indoors,
/area/space)
"L" = (
/obj/structure/table/rack/shelf,
/turf/simulated/floor/plating/indoors,
/area/space)
"M" = (
/obj/machinery/power/terminal{
	dir = 1
	},
/turf/simulated/floor/plating/indoors,
/area/space)
"N" = (
/obj/structure/railing{
	dir = 1
	},
/obj/structure/cable{
	icon_state = "1-8"
	},
/turf/simulated/floor/plating/indoors,
/area/space)
"P" = (
/obj/machinery/door/airlock/external/glass,
/turf/simulated/floor/plating/indoors,
/area/space)

(1,1,1) = {"
a
a
a
a
a
a
a
a
a
a
a
a
a
a
a
a
"}
(2,1,1) = {"
a
a
a
a
a
a
a
a
a
a
a
a
a
a
a
a
"}
(3,1,1) = {"
a
a
a
a
a
a
a
a
a
a
a
a
a
a
a
a
"}
(4,1,1) = {"
a
a
a
a
a
a
a
a
y
y
y
a
a
a
a
a
"}
(5,1,1) = {"
a
a
a
a
a
a
j
q
B
B
q
a
a
a
a
a
"}
(6,1,1) = {"
a
a
a
a
a
q
B
q
w
w
w
q
w
a
a
a
"}
(7,1,1) = {"
a
a
a
a
q
L
t
k
h
E
E
q
w
a
a
a
"}
(8,1,1) = {"
a
a
a
a
B
w
E
l
i
s
M
P
a
a
a
a
"}
(9,1,1) = {"
a
a
a
a
B
w
E
c
i
I
E
P
a
a
a
a
"}
(10,1,1) = {"
a
a
a
a
q
L
t
e
d
c
E
q
w
a
a
a
"}
(11,1,1) = {"
a
a
a
a
a
q
B
q
g
N
E
q
w
a
a
a
"}
(12,1,1) = {"
a
a
a
a
a
a
a
q
B
B
q
a
a
a
a
a
"}
(13,1,1) = {"
a
a
a
a
a
a
a
a
y
y
y
a
a
a
a
a
"}
(14,1,1) = {"
a
a
a
a
a
a
a
a
a
a
a
a
a
a
a
a
"}
(15,1,1) = {"
a
a
a
a
a
a
a
a
a
a
a
a
a
a
a
a
"}
(16,1,1) = {"
a
a
a
a
a
a
a
a
a
a
a
a
a
a
a
a
"}
