//MAP CONVERTED BY dmm2tgm.py THIS HEADER COMMENT PREVENTS RECONVERSION, DO NOT REMOVE
"aa" = (
/obj/machinery/artifact_analyser,
/turf/simulated/floor/plating/outdoors,
/area/space)
"ae" = (
/obj/structure/window/reinforced{
	dir = 4
	},
/obj/effect/decal/warning_stripes,
/turf/simulated/floor/plating/indoors,
/area/space)
"as" = (
/obj/machinery/door/airlock/multi_tile/glass{
	dir = 1
	},
/turf/simulated/floor/plating/indoors,
/area/space)
"bj" = (
/obj/machinery/computer/shuttle_control{
	dir = 4
	},
/turf/simulated/floor/plating/indoors,
/area/space)
"bl" = (
/obj/machinery/atmospherics/component/unary/engine/biggest{
	dir = 1
	},
/turf/space/basic,
/area/space)
"cg" = (
/obj/structure/closet/secure_closet/engineering_electrical,
/obj/structure/window/reinforced,
/obj/structure/window/reinforced{
	dir = 1
	},
/turf/simulated/floor/plating/indoors,
/area/space)
"cF" = (
/obj/structure/closet/secure_closet/engineering_welding,
/obj/structure/window/reinforced{
	dir = 1
	},
/obj/structure/window/reinforced,
/turf/simulated/floor/plating/indoors,
/area/space)
"dB" = (
/turf/simulated/floor/plating/indoors,
/area/space)
"dT" = (
/obj/machinery/door/airlock/external/glass,
/turf/simulated/floor/plating/indoors,
/area/space)
"et" = (
/turf/simulated/wall/r_wall/prepainted/science,
/area/space)
"fT" = (
/turf/simulated/wall,
/area/space)
"hx" = (
/obj/machinery/door/window/brigdoor,
/turf/simulated/floor/plating/outdoors,
/area/space)
"iD" = (
/obj/machinery/air_alarm{
	dir = 4
	},
/obj/machinery/radiocarbon_spectrometer,
/turf/simulated/floor/plating/outdoors,
/area/space)
"jk" = (
/obj/structure/table/rack/shelf,
/turf/simulated/floor/plating/indoors,
/area/space)
"kf" = (
/obj/effect/decal/warning_stripes,
/turf/simulated/floor/plating/indoors,
/area/space)
"km" = (
/obj/structure/window/reinforced{
	dir = 8
	},
/obj/effect/decal/warning_stripes,
/turf/simulated/floor/plating/indoors,
/area/space)
"kB" = (
/obj/structure/bed/chair/shuttle{
	dir = 8
	},
/turf/simulated/floor/plating/indoors,
/area/space)
"mh" = (
/obj/machinery/door/airlock/external/glass,
/turf/space/basic,
/area/space)
"mx" = (
/obj/machinery/door/blast/regular,
/obj/structure/atmospheric_retention_field,
/turf/simulated/floor/plating/indoors,
/area/space)
"mS" = (
/obj/structure/table/reinforced,
/obj/structure/window/reinforced{
	dir = 8
	},
/turf/simulated/floor/plating/indoors,
/area/space)
"nK" = (
/obj/structure/table/rack/shelf,
/obj/structure/window/reinforced{
	dir = 4
	},
/obj/structure/window/reinforced{
	dir = 4
	},
/turf/simulated/floor/plating/indoors,
/area/space)
"qa" = (
/obj/spawner/window/low_wall/reinforced/full,
/turf/simulated/floor/plating/outdoors,
/area/space)
"si" = (
/obj/structure/window/reinforced{
	dir = 1
	},
/obj/structure/window/reinforced,
/obj/structure/window/reinforced{
	dir = 4
	},
/obj/machinery/door/window{
	dir = 8
	},
/turf/simulated/floor/plating/indoors,
/area/space)
"ve" = (
/turf/simulated/floor/plating/indoors,
/turf/simulated/wall/r_wall/prepainted/science,
/area/space)
"xN" = (
/obj/structure/window/reinforced{
	dir = 1
	},
/turf/simulated/floor/plating/outdoors,
/area/space)
"yF" = (
/obj/machinery/power/smes,
/obj/structure/window/reinforced,
/turf/simulated/floor/plating/indoors,
/area/space)
"zG" = (
/obj/machinery/computer/shuttle_control{
	dir = 4
	},
/obj/structure/window/reinforced{
	dir = 8
	},
/turf/simulated/floor/plating/indoors,
/area/space)
"zV" = (
/obj/machinery/atmospherics/pipe/tank/phoron{
	dir = 4
	},
/turf/simulated/floor/plating/indoors,
/area/space)
"Ae" = (
/obj/structure/bed/chair/shuttle{
	dir = 1
	},
/turf/space/basic,
/area/space)
"AS" = (
/obj/structure/table/rack/shelf,
/obj/structure/window/reinforced{
	dir = 4
	},
/turf/simulated/floor/plating/indoors,
/area/space)
"Bx" = (
/obj/machinery/power/apc/east_mount,
/obj/structure/table/rack/shelf,
/turf/simulated/floor/plating/indoors,
/area/space)
"BX" = (
/obj/machinery/atmospherics/component/unary/engine/bigger,
/turf/space/basic,
/area/space)
"BY" = (
/obj/machinery/atmospherics/component/binary/pump/fuel,
/turf/simulated/floor/plating/indoors,
/area/space)
"CZ" = (
/obj/machinery/atmospherics/component/binary/pump/fuel{
	dir = 8
	},
/turf/simulated/floor/plating/indoors,
/area/space)
"Dp" = (
/obj/machinery/atmospherics/component/unary/engine/bigger,
/turf/simulated/floor/plating/indoors,
/area/space)
"DA" = (
/turf/simulated/floor/plating/outdoors,
/area/space)
"DI" = (
/obj/spawner/window/reinforced/full,
/turf/simulated/floor/plating/indoors,
/area/space)
"Eq" = (
/obj/structure/window/reinforced{
	dir = 1
	},
/obj/structure/window/reinforced,
/obj/machinery/door/window{
	dir = 8
	},
/obj/structure/window/reinforced{
	dir = 4
	},
/turf/simulated/floor/plating/indoors,
/area/space)
"EF" = (
/obj/machinery/power/smes,
/turf/simulated/floor/plating/indoors,
/area/space)
"EJ" = (
/obj/machinery/atmospherics/pipe/tank/phoron{
	dir = 8
	},
/turf/simulated/floor/plating/indoors,
/area/space)
"Fy" = (
/obj/machinery/computer/shuttle_control,
/turf/space/basic,
/area/space)
"Fz" = (
/obj/effect/decal/warning_stripes,
/obj/effect/decal/warning_stripes,
/turf/simulated/floor/plating/indoors,
/area/space)
"Gf" = (
/obj/machinery/artifact_scanpad,
/turf/simulated/floor/plating/outdoors,
/area/space)
"Ho" = (
/obj/machinery/mech_recharger,
/turf/simulated/floor/plating/indoors,
/area/space)
"HB" = (
/obj/spawner/window/reinforced/full,
/turf/simulated/floor/plating,
/area/space)
"HM" = (
/obj/spawner/window/low_wall/reinforced/full,
/turf/simulated/floor/plating/indoors,
/area/space)
"HQ" = (
/obj/structure/anomaly_container,
/turf/space/basic,
/area/space)
"Is" = (
/obj/structure/table/reinforced,
/turf/simulated/floor/plating/indoors,
/area/space)
"IM" = (
/obj/effect/decal/warning_stripes,
/obj/structure/window/reinforced{
	dir = 1
	},
/turf/simulated/floor/plating/indoors,
/area/space)
"Jg" = (
/obj/machinery/door/airlock/glass/research,
/turf/space/basic,
/area/space)
"Jn" = (
/obj/machinery/atmospherics/pipe/tank/phoron{
	dir = 4
	},
/obj/machinery/atmospherics/pipe/tank/phoron{
	dir = 4
	},
/turf/simulated/floor/plating/indoors,
/area/space)
"Jq" = (
/turf/simulated/floor/plating,
/area/space)
"KC" = (
/obj/structure/closet/secure_closet/engineering_electrical,
/obj/structure/window/reinforced,
/turf/simulated/floor/plating/indoors,
/area/space)
"LE" = (
/obj/structure/closet/secure_closet/engineering_welding,
/obj/structure/window/reinforced{
	dir = 1
	},
/turf/simulated/floor/plating/indoors,
/area/space)
"MC" = (
/obj/structure/table/reinforced,
/turf/simulated/floor/plating/outdoors,
/area/space)
"OC" = (
/obj/structure/table/reinforced,
/turf/space/basic,
/area/space)
"Qy" = (
/obj/machinery/artifact_harvester,
/obj/machinery/air_alarm{
	dir = 8
	},
/turf/simulated/floor/plating/outdoors,
/area/space)
"QU" = (
/obj/machinery/atmospherics/component/binary/pump/fuel{
	dir = 4
	},
/turf/simulated/floor/plating/indoors,
/area/space)
"So" = (
/obj/effect/decal/warning_stripes,
/turf/space/basic,
/area/space)
"TZ" = (
/obj/effect/decal/warning_stripes,
/obj/structure/window/reinforced{
	dir = 4
	},
/turf/simulated/floor/plating/indoors,
/area/space)
"UI" = (
/obj/machinery/door/airlock/external/glass,
/turf/simulated/floor/plating,
/area/space)
"UY" = (
/obj/machinery/atmospherics/portables_connector{
	dir = 4
	},
/turf/simulated/floor/plating/indoors,
/area/space)
"UZ" = (
/obj/machinery/door/airlock/glass/research,
/turf/simulated/floor/plating/outdoors,
/area/space)
"Vt" = (
/obj/machinery/power/apc/east_mount,
/turf/simulated/floor/plating/indoors,
/area/space)
"VX" = (
/obj/machinery/power/emitter{
	dir = 4
	},
/obj/structure/window/reinforced{
	dir = 1
	},
/turf/simulated/floor/plating/outdoors,
/area/space)
"Xu" = (
/turf/space/basic,
/area/space)
"XA" = (
/obj/structure/window/reinforced{
	dir = 4
	},
/obj/structure/window/reinforced{
	dir = 8
	},
/turf/simulated/floor/plating,
/area/space)
"Zn" = (
/obj/machinery/door/airlock/glass/research,
/turf/simulated/floor/plating/indoors,
/area/space)

(1,1,1) = {"
fT
fT
fT
fT
dB
dB
fT
fT
fT
fT
Xu
Xu
Xu
Xu
Xu
Xu
Xu
Xu
Xu
Xu
Xu
Xu
Xu
Xu
Xu
Xu
Xu
Xu
Xu
Xu
Xu
Xu
Xu
Xu
Xu
Xu
Xu
Xu
Xu
Xu
"}
(2,1,1) = {"
fT
VX
iD
DA
dB
dB
HM
jk
jk
fT
Xu
Xu
Xu
Xu
Xu
Xu
Xu
Xu
Xu
Xu
Xu
Xu
Xu
Xu
Xu
Xu
Xu
Xu
Xu
Xu
Xu
Xu
Xu
Xu
Xu
Xu
Xu
Xu
Xu
Xu
"}
(3,1,1) = {"
fT
hx
DA
DA
dB
dB
Zn
dB
dB
fT
Xu
Xu
Xu
Xu
Xu
Xu
Xu
Xu
Xu
Xu
Xu
Xu
Xu
Xu
Xu
Xu
et
dT
dT
et
et
et
Xu
et
et
et
Xu
Xu
Xu
Xu
"}
(4,1,1) = {"
fT
xN
MC
DA
dB
dB
HM
jk
jk
fT
Xu
Xu
Xu
Xu
Xu
Xu
Xu
Xu
Xu
Xu
Xu
Xu
Xu
Xu
Xu
Xu
DI
dB
dB
DI
dB
dB
et
KC
dB
LE
et
Xu
Xu
Xu
"}
(5,1,1) = {"
fT
qa
qa
qa
dB
dB
fT
fT
et
fT
Xu
Xu
Xu
Xu
Xu
Xu
Xu
Xu
Xu
Xu
Xu
Xu
Xu
Xu
Xu
Xu
et
dT
dT
et
dB
dB
Zn
dB
dB
dB
dB
et
Xu
Xu
"}
(6,1,1) = {"
fT
Gf
DA
UZ
dB
dB
as
HQ
HQ
fT
Xu
Xu
Xu
Xu
Xu
et
AS
AS
nK
et
Xu
Xu
Xu
Xu
Xu
Xu
Xu
Xu
Xu
Xu
Xu
Xu
et
kf
kf
kf
si
et
BX
Xu
"}
(7,1,1) = {"
fT
aa
Qy
HM
dB
dB
dB
HQ
HQ
fT
Xu
Xu
Xu
Xu
Xu
DI
bj
Is
bj
DI
Xu
Xu
Xu
Xu
Xu
Xu
dB
dB
dB
dB
dB
dB
dB
et
et
et
et
et
dB
Xu
"}
(8,1,1) = {"
fT
fT
fT
fT
dB
dB
fT
fT
fT
fT
Xu
Xu
Xu
Xu
Xu
Jg
dB
Vt
dB
Jg
Xu
Xu
Xu
Xu
Xu
Xu
dB
dB
dB
dB
dB
dB
dB
et
kf
dB
Ho
Ho
mx
Xu
"}
(9,1,1) = {"
Xu
Xu
Xu
Xu
Xu
Xu
Xu
Xu
Xu
Xu
Xu
Xu
Xu
Xu
Xu
et
EF
et
EF
et
Xu
Xu
Xu
Xu
Xu
Xu
Xu
Xu
Xu
Xu
Xu
dB
dB
et
kf
dB
Ho
Ho
mx
Xu
"}
(10,1,1) = {"
Xu
Xu
Xu
Xu
Xu
Xu
Xu
Xu
Xu
Xu
Xu
Xu
Xu
Xu
Xu
et
et
jk
et
et
Xu
Xu
Xu
Xu
Xu
Xu
Xu
Xu
Xu
Xu
Xu
dB
dB
Zn
dB
dB
IM
et
et
bl
"}
(11,1,1) = {"
Xu
Xu
Xu
Xu
Xu
Xu
Xu
Xu
Xu
Xu
Xu
Xu
Xu
Xu
Xu
Xu
Xu
Xu
Xu
Xu
Xu
Xu
Xu
Xu
Xu
Xu
Xu
Xu
Xu
Xu
Xu
dB
dB
DI
kf
dB
kf
dB
ve
Xu
"}
(12,1,1) = {"
Xu
Xu
Xu
Xu
Xu
Xu
Xu
Xu
Xu
Xu
Xu
Xu
Xu
Xu
Xu
Xu
Xu
Xu
Xu
Xu
Xu
Xu
Xu
Xu
Xu
Xu
Xu
Xu
Xu
Xu
Xu
dB
dB
Zn
dB
dB
TZ
et
ve
Xu
"}
(13,1,1) = {"
Xu
Xu
Xu
Xu
Xu
Xu
Xu
Xu
et
HB
HB
et
Xu
Xu
Xu
Xu
Xu
Xu
Xu
Xu
Xu
Xu
Xu
Xu
Xu
Xu
Xu
Xu
Xu
Xu
Xu
dB
dB
et
kf
dB
Ho
Ho
mx
Xu
"}
(14,1,1) = {"
Xu
Xu
Xu
Xu
Xu
Xu
Xu
Xu
HB
Jq
Jq
UI
Xu
Xu
Xu
Xu
Xu
Xu
Xu
Xu
Xu
Xu
Xu
Xu
Xu
Xu
dB
dB
dB
dB
dB
dB
dB
et
kf
dB
Ho
Ho
mx
Xu
"}
(15,1,1) = {"
Xu
Xu
Xu
Xu
Xu
Xu
Xu
Xu
HB
Jq
Jq
UI
Xu
Xu
Xu
Xu
Xu
Xu
Xu
Xu
Xu
Xu
Xu
Xu
Xu
Xu
dB
dB
dB
dB
dB
dB
dB
et
et
et
et
et
Dp
Xu
"}
(16,1,1) = {"
Xu
Xu
Xu
Xu
Xu
So
Xu
Xu
et
UI
UI
et
Xu
Xu
Xu
Xu
Xu
Xu
Xu
Xu
Xu
Xu
Xu
Xu
Xu
Xu
Xu
Xu
Xu
Xu
Xu
Xu
et
dB
zV
Jn
CZ
et
Xu
Xu
"}
(17,1,1) = {"
Xu
Xu
Xu
Xu
Xu
Xu
Fy
Xu
Xu
Xu
Xu
Xu
Xu
Xu
Xu
Xu
Xu
Xu
Xu
Xu
Xu
Xu
Xu
Xu
Xu
Xu
et
dT
dT
et
dB
dB
Zn
BY
dB
dB
dB
et
Xu
Xu
"}
(18,1,1) = {"
Xu
Xu
Xu
Xu
Xu
Xu
OC
Xu
Xu
Xu
Xu
Xu
Xu
Xu
Xu
Xu
Xu
Xu
Xu
Xu
Xu
Xu
Xu
Xu
Xu
Xu
DI
dB
dB
DI
dB
dB
et
dB
EJ
EJ
et
Xu
Xu
Xu
"}
(19,1,1) = {"
Xu
Xu
Xu
Xu
Xu
Xu
Fy
Ae
Xu
Xu
Xu
Xu
Xu
Xu
Xu
Xu
Xu
Xu
Xu
Xu
Xu
Xu
Xu
Xu
Xu
Xu
et
dT
dT
et
et
et
Xu
et
et
et
Xu
Xu
Xu
Xu
"}
(20,1,1) = {"
Xu
Xu
Xu
Xu
Xu
Xu
Xu
Xu
Xu
Xu
Xu
Xu
Xu
Xu
Xu
Xu
Xu
Xu
Xu
Xu
Xu
Xu
Xu
Xu
Xu
Xu
Xu
Xu
Xu
Xu
Xu
Xu
Xu
Xu
Xu
Xu
Xu
Xu
Xu
Xu
"}
(21,1,1) = {"
Xu
Xu
Xu
Xu
Xu
Xu
Xu
Xu
Xu
Xu
Xu
Xu
Xu
Xu
Xu
Xu
Xu
Xu
Xu
Xu
Xu
Xu
Xu
Xu
Xu
Xu
Xu
Xu
Xu
Xu
Xu
Xu
Xu
Xu
Xu
Xu
Xu
Xu
Xu
Xu
"}
(22,1,1) = {"
Xu
Xu
Xu
Xu
dB
Xu
Xu
Xu
Xu
Xu
Xu
Xu
Xu
Xu
Xu
Xu
Xu
Xu
Xu
Xu
Xu
Xu
Xu
Xu
Xu
Xu
Xu
Xu
Xu
Xu
Xu
Xu
Xu
Xu
Xu
Xu
Xu
Xu
Xu
Xu
"}
(23,1,1) = {"
Xu
Xu
dB
dB
dB
dB
dB
dB
Xu
Xu
Xu
Xu
Xu
Xu
Xu
Xu
Xu
Xu
Xu
Xu
Xu
Xu
Xu
Xu
Xu
Xu
Xu
Xu
Xu
Xu
Xu
Xu
Xu
Xu
Xu
Xu
Xu
Xu
Xu
Xu
"}
(24,1,1) = {"
dB
dB
dB
dB
dB
dB
dB
dB
dB
dB
dB
Jq
BX
Xu
Xu
Xu
Xu
Xu
Xu
Xu
Xu
Xu
Xu
Xu
Xu
Xu
Xu
Xu
Xu
Xu
Xu
Xu
Xu
Xu
et
et
et
et
BX
Xu
"}
(25,1,1) = {"
dB
dB
dB
dB
dB
dB
dB
dB
dB
dB
dB
dB
Xu
Xu
Xu
Xu
Xu
Xu
Xu
Xu
Xu
Xu
Xu
Xu
Xu
Xu
Xu
Xu
Xu
Xu
Xu
Xu
mh
mh
et
dB
kf
et
Xu
Xu
"}
(26,1,1) = {"
dB
dB
dB
dB
dB
dB
dB
dB
et
dB
dB
et
Xu
Xu
Xu
Xu
Xu
Xu
Xu
Xu
Xu
Xu
Xu
Xu
Xu
Xu
Xu
Xu
Xu
Xu
Xu
Xu
Xu
Xu
et
dB
Fz
kf
et
BX
"}
(27,1,1) = {"
dB
dB
dB
dB
dB
dB
dB
dB
as
Ho
Ho
mx
Xu
Xu
Xu
Xu
Xu
Xu
Xu
Xu
Xu
Xu
Xu
Xu
Xu
Xu
Xu
Xu
Xu
Xu
Xu
Xu
Xu
Xu
et
dB
ae
ae
et
Xu
"}
(28,1,1) = {"
dB
dB
dB
dB
dB
dB
dB
dB
dB
Ho
Ho
mx
Xu
Xu
Xu
Xu
Xu
Xu
Xu
Xu
Xu
Xu
Xu
Xu
Xu
Xu
Xu
Xu
Xu
Xu
Xu
Xu
mh
mh
et
dB
Ho
Ho
mx
Xu
"}
(29,1,1) = {"
dB
dB
dB
dB
dB
dB
dB
dB
et
dB
dB
et
Xu
Xu
Xu
Xu
Xu
Xu
Xu
Xu
Xu
Xu
Xu
Xu
DI
zG
mS
zG
DI
dB
dB
dB
dB
dB
Zn
dB
Ho
Ho
mx
Xu
"}
(30,1,1) = {"
dB
dB
dB
dB
dB
dB
dB
dB
dB
dB
dB
dB
BX
Xu
Xu
Xu
Xu
Xu
Xu
Xu
Xu
Xu
Xu
Xu
Jg
kB
dB
kB
Jg
dB
dB
dB
dB
dB
DI
dB
XA
XA
et
Xu
"}
(31,1,1) = {"
dB
dB
dB
dB
dB
dB
dB
dB
dB
dB
dB
Jq
Xu
Xu
Xu
Xu
Xu
Xu
Xu
Xu
Xu
Xu
Xu
Xu
et
yF
dB
Bx
et
dB
dB
dB
dB
dB
Zn
dB
Ho
Ho
mx
Xu
"}
(32,1,1) = {"
Xu
Xu
dB
dB
dB
dB
dB
dB
dB
Xu
Xu
Xu
Xu
Xu
Xu
Xu
Xu
Xu
Xu
Xu
Xu
Xu
Xu
Xu
et
et
Zn
et
et
et
et
et
Zn
et
et
dB
Ho
Ho
mx
Xu
"}
(33,1,1) = {"
Xu
Xu
Xu
Xu
dB
Xu
Xu
Xu
Xu
Xu
Xu
Xu
Xu
Xu
Xu
Xu
Xu
Xu
Xu
Xu
Xu
Xu
Xu
Xu
Xu
Xu
Xu
et
cg
EF
cF
UY
QU
CZ
et
dB
km
km
et
BX
"}
(34,1,1) = {"
Xu
Xu
Xu
Xu
Xu
Xu
Xu
Xu
Xu
Xu
Xu
Xu
Xu
et
HB
HB
et
Xu
Xu
Xu
Xu
Xu
Xu
Xu
Xu
Xu
Xu
Zn
dB
dB
dB
dB
dB
dB
et
dB
kf
kf
et
Xu
"}
(35,1,1) = {"
et
UI
UI
et
Xu
Xu
Xu
Xu
Xu
et
UI
UI
et
Xu
Xu
Xu
Xu
Xu
Xu
Xu
Xu
Xu
Xu
Xu
et
dT
dT
et
kf
kf
kf
Eq
EJ
EJ
et
dB
kf
et
BX
Xu
"}
(36,1,1) = {"
HB
Jq
Jq
UI
Xu
Xu
Xu
Xu
Xu
HB
Jq
Jq
UI
Xu
Xu
Xu
Xu
Xu
Xu
Xu
Xu
Xu
Xu
Xu
DI
dB
dB
et
et
et
et
et
et
et
et
et
et
et
Xu
Xu
"}
(37,1,1) = {"
HB
Jq
Jq
UI
Xu
Xu
Xu
Xu
Xu
HB
Jq
Jq
UI
Xu
Xu
Xu
Xu
Xu
Xu
Xu
Xu
Xu
Xu
Xu
et
dT
dT
et
Xu
Xu
Xu
Xu
Xu
Xu
Xu
Xu
Xu
Xu
Xu
Xu
"}
(38,1,1) = {"
et
HB
HB
et
Xu
Xu
Xu
Xu
Xu
et
HB
HB
et
Xu
Xu
Xu
Xu
Xu
Xu
Xu
Xu
Xu
Xu
Xu
Xu
Xu
Xu
Xu
Xu
Xu
Xu
Xu
Xu
Xu
Xu
Xu
Xu
Xu
Xu
Xu
"}
(39,1,1) = {"
Xu
Xu
Xu
Xu
Xu
Xu
Xu
Xu
Xu
Xu
Xu
Xu
Xu
Xu
Xu
Xu
Xu
Xu
Xu
Xu
Xu
Xu
Xu
Xu
Xu
Xu
Xu
Xu
Xu
Xu
Xu
Xu
Xu
Xu
Xu
Xu
Xu
Xu
Xu
Xu
"}
(40,1,1) = {"
Xu
Xu
Xu
HB
HB
Xu
Xu
Xu
Xu
Xu
Xu
Xu
Xu
Xu
Xu
Xu
Xu
Xu
Xu
Xu
Xu
Xu
Xu
Xu
Xu
Xu
Xu
Xu
Xu
Xu
Xu
Xu
Xu
Xu
Xu
Xu
Xu
Xu
Xu
Xu
"}
