//MAP CONVERTED BY dmm2tgm.py THIS HEADER COMMENT PREVENTS RECONVERSION, DO NOT REMOVE
"aA" = (
/obj/machinery/door/blast/regular,
/obj/structure/atmospheric_retention_field,
/turf/simulated/floor/plating/indoors,
/area/space)
"aU" = (
/obj/structure/handrail,
/turf/simulated/floor/plating/indoors,
/area/space)
"aZ" = (
/obj/structure/handrail,
/turf/space/basic,
/area/space)
"bF" = (
/obj/machinery/power/smes,
/turf/simulated/floor/plating/indoors,
/area/space)
"ch" = (
/obj/machinery/atmospherics/pipe/tank{
	dir = 4
	},
/turf/simulated/floor/plating/indoors,
/area/space)
"dl" = (
/obj/structure/handrail{
	dir = 8
	},
/turf/simulated/floor/plating/indoors,
/area/space)
"du" = (
/obj/machinery/door/airlock/glass/research,
/turf/simulated/floor/plating/indoors,
/area/space)
"dw" = (
/obj/machinery/power/apc/east_mount,
/obj/machinery/recharge_station,
/turf/simulated/floor/plating/indoors,
/area/space)
"eh" = (
/obj/machinery/telecomms/server,
/turf/simulated/floor/plating/indoors,
/area/space)
"eu" = (
/obj/structure/table/rack/shelf/steel,
/turf/simulated/floor/plating/indoors,
/area/space)
"fc" = (
/obj/structure/window/reinforced{
	dir = 8
	},
/obj/machinery/computer/shuttle_control{
	dir = 4
	},
/turf/simulated/floor/plating/indoors,
/area/space)
"fY" = (
/obj/structure/bed/chair/bay/comfy,
/turf/simulated/floor/plating/indoors,
/area/space)
"hA" = (
/obj/effect/decal/warning_stripes,
/obj/effect/decal/warning_stripes,
/turf/simulated/floor/plating/indoors,
/area/space)
"kn" = (
/obj/spawner/window/reinforced/full,
/obj/spawner/window/reinforced/full,
/turf/simulated/floor/plating/indoors,
/area/space)
"kR" = (
/obj/effect/decal/warning_stripes,
/turf/simulated/floor/plating/indoors,
/area/space)
"lE" = (
/obj/machinery/atmospherics/component/unary/engine/bigger,
/turf/space/basic,
/area/space)
"mY" = (
/obj/structure/closet/secure_closet/engineering_welding,
/turf/simulated/floor/plating/indoors,
/area/space)
"oj" = (
/obj/structure/closet/secure_closet/xenoarchaeologist,
/obj/machinery/power/apc/east_mount,
/turf/simulated/floor/plating/indoors,
/area/space)
"oy" = (
/obj/spawner/window/reinforced/full,
/turf/simulated/floor/plating/indoors,
/area/space)
"pj" = (
/obj/structure/closet/secure_closet/xenoarchaeologist,
/turf/simulated/floor/plating/indoors,
/area/space)
"rb" = (
/obj/structure/bed/chair/bay/comfy{
	dir = 1
	},
/obj/structure/window/reinforced{
	dir = 4
	},
/turf/simulated/floor/plating/indoors,
/area/space)
"rw" = (
/obj/structure/window/reinforced,
/obj/machinery/suit_storage_unit/exploration,
/turf/simulated/floor/plating/indoors,
/area/space)
"sl" = (
/obj/structure/table/rack/shelf,
/turf/simulated/floor/plating/indoors,
/area/space)
"uA" = (
/obj/machinery/atmospherics/pipe/tank/air{
	dir = 8
	},
/turf/simulated/floor/plating/indoors,
/area/space)
"vU" = (
/obj/structure/bed/chair/bay/comfy{
	dir = 8
	},
/turf/simulated/floor/plating/indoors,
/area/space)
"wr" = (
/obj/structure/window/reinforced{
	dir = 8
	},
/obj/structure/table/rack/shelf,
/turf/simulated/floor/plating/indoors,
/area/space)
"xj" = (
/obj/machinery/artifact_scanpad,
/turf/simulated/floor/plating/indoors,
/area/space)
"xv" = (
/obj/machinery/computer/rdconsole{
	dir = 4
	},
/turf/simulated/floor/plating/indoors,
/area/space)
"xK" = (
/obj/machinery/r_n_d/server,
/turf/simulated/floor/plating/indoors,
/area/space)
"zu" = (
/obj/structure/window/reinforced{
	dir = 4
	},
/obj/effect/decal/warning_stripes,
/turf/simulated/floor/plating/indoors,
/area/space)
"zV" = (
/obj/structure/handrail{
	dir = 1
	},
/turf/simulated/floor/plating/indoors,
/area/space)
"Ce" = (
/obj/structure/handrail{
	dir = 4
	},
/turf/simulated/floor/plating/indoors,
/area/space)
"CI" = (
/obj/machinery/suit_storage_unit/exploration,
/turf/simulated/floor/plating/indoors,
/area/space)
"CP" = (
/obj/machinery/computer/nanite_chamber{
	dir = 4
	},
/turf/simulated/floor/plating/indoors,
/area/space)
"DK" = (
/obj/structure/bed/chair/bay/comfy{
	dir = 1
	},
/obj/structure/window/reinforced{
	dir = 8
	},
/turf/simulated/floor/plating/indoors,
/area/space)
"DR" = (
/obj/structure/dispenser/oxygen{
	dir = 8
	},
/turf/simulated/floor/plating/indoors,
/area/space)
"DS" = (
/obj/structure/handrail,
/obj/machinery/power/apc/north_mount,
/turf/simulated/floor/plating/indoors,
/area/space)
"EC" = (
/obj/structure/window/reinforced{
	dir = 4
	},
/obj/structure/window/reinforced{
	dir = 8
	},
/obj/machinery/portable_atmospherics/canister/oxygen,
/turf/simulated/floor/plating,
/area/space)
"EG" = (
/obj/structure/window/reinforced{
	dir = 1
	},
/obj/structure/window/reinforced,
/obj/structure/window/reinforced{
	dir = 4
	},
/obj/machinery/door/window{
	dir = 8
	},
/turf/simulated/floor/plating/indoors,
/area/space)
"EQ" = (
/obj/machinery/mech_recharger,
/turf/simulated/floor/plating/indoors,
/area/space)
"EX" = (
/obj/structure/window/reinforced{
	dir = 8
	},
/obj/effect/decal/warning_stripes,
/turf/simulated/floor/plating/indoors,
/area/space)
"GQ" = (
/obj/machinery/artifact_harvester,
/obj/structure/window/reinforced{
	dir = 4
	},
/turf/simulated/floor/plating/indoors,
/area/space)
"Hs" = (
/obj/machinery/nanite_chamber,
/turf/simulated/floor/plating/indoors,
/area/space)
"HY" = (
/obj/structure/window/reinforced{
	dir = 8
	},
/obj/structure/table/reinforced,
/turf/simulated/floor/plating/indoors,
/area/space)
"Jr" = (
/obj/machinery/exonet_node,
/obj/machinery/power/apc/west_mount,
/turf/simulated/floor/plating/indoors,
/area/space)
"KS" = (
/obj/machinery/atmospherics/pipe/tank/phoron{
	dir = 8
	},
/turf/simulated/floor/plating/indoors,
/area/space)
"Lv" = (
/obj/effect/decal/warning_stripes,
/turf/space/basic,
/area/space)
"Mz" = (
/turf/space/basic,
/area/space)
"Ps" = (
/turf/simulated/wall/r_wall/prepainted/science,
/area/space)
"PP" = (
/obj/structure/handrail{
	dir = 1
	},
/turf/space/basic,
/area/space)
"Qc" = (
/obj/structure/table/reinforced,
/turf/simulated/floor/plating/indoors,
/area/space)
"QF" = (
/obj/machinery/r_n_d/circuit_imprinter,
/obj/structure/window/reinforced,
/turf/simulated/floor/plating/indoors,
/area/space)
"Rk" = (
/obj/machinery/atmospherics/component/binary/pump/fuel{
	dir = 4
	},
/turf/simulated/floor/plating/indoors,
/area/space)
"RH" = (
/obj/structure/closet/crate/freezer/rations,
/turf/simulated/floor/plating/indoors,
/area/space)
"RR" = (
/obj/machinery/artifact_analyser,
/obj/structure/window/reinforced{
	dir = 8
	},
/turf/simulated/floor/plating/indoors,
/area/space)
"RX" = (
/obj/machinery/r_n_d/protolathe,
/obj/structure/window/reinforced{
	dir = 1
	},
/turf/simulated/floor/plating/indoors,
/area/space)
"Wl" = (
/obj/machinery/door/airlock/external/glass,
/turf/simulated/floor/plating/indoors,
/area/space)
"WQ" = (
/turf/simulated/floor/plating/indoors,
/area/space)
"Yl" = (
/obj/structure/window/reinforced{
	dir = 4
	},
/obj/structure/window/reinforced{
	dir = 8
	},
/obj/machinery/portable_atmospherics/canister/air,
/turf/simulated/floor/plating,
/area/space)
"ZP" = (
/obj/structure/window/reinforced{
	dir = 8
	},
/obj/effect/decal/warning_stripes,
/obj/machinery/atmospherics/component/binary/pump/fuel{
	dir = 8
	},
/turf/simulated/floor/plating/indoors,
/area/space)

(1,1,1) = {"
Mz
Mz
Mz
Mz
Mz
Mz
Mz
Mz
Mz
Mz
Mz
Mz
Mz
Mz
Mz
Mz
Mz
Mz
Mz
Mz
Mz
Mz
Mz
Mz
Mz
Mz
Mz
Mz
Mz
Mz
"}
(2,1,1) = {"
Mz
Mz
Mz
Mz
Mz
Mz
Mz
Mz
Mz
Mz
Mz
Mz
Mz
Mz
Mz
Mz
Mz
Mz
Mz
Mz
Mz
Mz
Mz
Mz
Mz
Mz
Mz
Mz
Mz
Mz
"}
(3,1,1) = {"
Mz
Mz
Mz
Mz
Mz
Mz
Mz
Mz
Mz
Mz
Mz
Mz
Mz
Mz
Mz
Mz
Mz
Mz
Mz
Mz
Mz
Mz
Mz
Mz
Mz
Mz
Mz
Mz
Mz
Mz
"}
(4,1,1) = {"
Mz
Mz
Mz
Mz
Mz
Mz
Mz
Mz
Mz
Mz
Mz
Mz
Mz
Mz
Mz
Mz
Mz
Mz
Mz
Mz
Mz
Mz
Mz
Mz
Mz
Mz
Mz
Mz
Mz
Mz
"}
(5,1,1) = {"
Mz
Mz
Mz
Mz
Mz
Mz
Mz
Mz
Mz
Mz
Mz
Mz
Mz
Mz
Mz
Mz
Mz
Mz
Mz
Mz
Mz
Mz
Mz
Mz
Mz
Mz
Mz
Mz
Mz
Mz
"}
(6,1,1) = {"
Mz
Mz
Mz
Mz
Mz
Mz
Mz
Mz
Mz
Lv
Lv
Mz
Mz
Mz
Mz
Mz
Mz
Mz
Mz
Mz
Lv
Lv
Mz
Mz
Mz
Mz
Mz
Mz
Mz
Mz
"}
(7,1,1) = {"
Mz
Mz
Mz
Mz
Mz
Mz
Mz
Ps
oy
Ps
Ps
oy
oy
kn
Ps
Ps
aZ
Mz
Mz
PP
Ps
Ps
Ps
lE
Mz
Mz
Mz
Mz
Mz
Mz
"}
(8,1,1) = {"
Mz
Mz
Mz
Mz
Mz
Mz
oy
Qc
sl
Ps
mY
RX
xv
QF
DR
pj
Ps
Wl
Wl
Ps
Hs
CP
Ps
Mz
Mz
Mz
Mz
Mz
Mz
Mz
"}
(9,1,1) = {"
Mz
Mz
Mz
Mz
Mz
Ps
Qc
WQ
WQ
du
WQ
WQ
vU
WQ
WQ
pj
oy
aU
zV
Ps
WQ
hA
kR
Ps
lE
Mz
Mz
Mz
Mz
Mz
"}
(10,1,1) = {"
Mz
Mz
Mz
Mz
Mz
oy
fY
WQ
DK
oy
WQ
WQ
WQ
dl
WQ
oj
oy
aU
zV
Ps
WQ
zu
zu
Ps
Mz
Mz
Mz
Mz
Mz
Mz
"}
(11,1,1) = {"
Mz
Mz
Mz
Mz
Mz
oy
fY
WQ
rb
Ps
oy
oy
oy
Ps
du
Ps
Ps
Wl
Wl
Ps
aU
EQ
EQ
aA
Mz
Mz
Mz
Mz
Mz
Mz
"}
(12,1,1) = {"
Mz
Mz
Mz
Mz
Mz
Ps
RR
WQ
RH
Ps
HY
fc
wr
Ps
WQ
Ce
Ce
WQ
WQ
du
WQ
EQ
EQ
aA
Mz
Mz
Mz
Mz
Mz
Mz
"}
(13,1,1) = {"
Mz
Mz
Mz
Mz
Mz
oy
xj
WQ
WQ
oy
WQ
vU
WQ
du
WQ
WQ
WQ
WQ
kR
oy
WQ
EC
Yl
Ps
Mz
Mz
Mz
Mz
Mz
Mz
"}
(14,1,1) = {"
Mz
Mz
Mz
Mz
Mz
Ps
GQ
WQ
eu
Ps
CI
WQ
dw
Ps
CI
CI
rw
WQ
WQ
du
WQ
EQ
EQ
aA
Mz
Mz
Mz
Mz
Mz
Mz
"}
(15,1,1) = {"
Mz
Mz
Mz
Mz
Mz
oy
fY
WQ
DK
Ps
Ps
du
Ps
Ps
Ps
Ps
Ps
du
Ps
Ps
DS
EQ
EQ
aA
Mz
Mz
Mz
Mz
Mz
Mz
"}
(16,1,1) = {"
Mz
Mz
Mz
Mz
Mz
oy
fY
WQ
rb
Ps
ch
WQ
WQ
Ps
Jr
eh
bF
WQ
xK
Ps
Rk
ZP
EX
Ps
lE
Mz
Mz
Mz
Mz
Mz
"}
(17,1,1) = {"
Mz
Mz
Mz
Mz
Mz
Ps
Qc
WQ
WQ
du
WQ
WQ
WQ
du
WQ
WQ
WQ
WQ
WQ
du
WQ
kR
kR
Ps
Mz
Mz
Mz
Mz
Mz
Mz
"}
(18,1,1) = {"
Mz
Mz
Mz
Mz
Mz
Mz
oy
Qc
sl
Ps
uA
Ps
Wl
Ps
bF
EG
kR
kR
kR
Ps
KS
KS
Ps
lE
Mz
Mz
Mz
Mz
Mz
Mz
"}
(19,1,1) = {"
Mz
Mz
Mz
Mz
Mz
Mz
Mz
Ps
oy
Ps
Ps
Ps
zV
Ps
Ps
Ps
Ps
Ps
Ps
Ps
Ps
Ps
Ps
Mz
Mz
Mz
Mz
Mz
Mz
Mz
"}
(20,1,1) = {"
Mz
Mz
Mz
Mz
Mz
Mz
Mz
Mz
Mz
Lv
Lv
Ps
Wl
Ps
Mz
Mz
Mz
Mz
Mz
Mz
Lv
Lv
Mz
Mz
Mz
Mz
Mz
Mz
Mz
Mz
"}
(21,1,1) = {"
Mz
Mz
Mz
Mz
Mz
Mz
Mz
Mz
Mz
Mz
Mz
Mz
Mz
Mz
Mz
Mz
Mz
Mz
Mz
Mz
Mz
Mz
Mz
Mz
Mz
Mz
Mz
Mz
Mz
Mz
"}
(22,1,1) = {"
Mz
Mz
Mz
Mz
Mz
Mz
Mz
Mz
Mz
Mz
Mz
Mz
Mz
Mz
Mz
Mz
Mz
Mz
Mz
Mz
Mz
Mz
Mz
Mz
Mz
Mz
Mz
Mz
Mz
Mz
"}
(23,1,1) = {"
Mz
Mz
Mz
Mz
Mz
Mz
Mz
Mz
Mz
Mz
Mz
Mz
Mz
Mz
Mz
Mz
Mz
Mz
Mz
Mz
Mz
Mz
Mz
Mz
Mz
Mz
Mz
Mz
Mz
Mz
"}
(24,1,1) = {"
Mz
Mz
Mz
Mz
Mz
Mz
Mz
Mz
Mz
Mz
Mz
Mz
Mz
Mz
Mz
Mz
Mz
Mz
Mz
Mz
Mz
Mz
Mz
Mz
Mz
Mz
Mz
Mz
Mz
Mz
"}
(25,1,1) = {"
Mz
Mz
Mz
Mz
Mz
Mz
Mz
Mz
Mz
Mz
Mz
Mz
Mz
Mz
Mz
Mz
Mz
Mz
Mz
Mz
Mz
Mz
Mz
Mz
Mz
Mz
Mz
Mz
Mz
Mz
"}
