//MAP CONVERTED BY dmm2tgm.py THIS HEADER COMMENT PREVENTS RECONVERSION, DO NOT REMOVE
"aJ" = (
/obj/machinery/air_alarm{
	dir = 4
	},
/obj/machinery/radiocarbon_spectrometer,
/turf/simulated/floor/plating/outdoors,
/area/space)
"bv" = (
/obj/structure/table/rack/shelf,
/turf/simulated/floor/plating/indoors,
/area/space)
"bK" = (
/obj/spawner/window/low_wall/reinforced/full,
/turf/simulated/floor/plating/indoors,
/area/space)
"gs" = (
/obj/structure/window/reinforced{
	dir = 1
	},
/turf/simulated/floor/plating/outdoors,
/area/space)
"gC" = (
/obj/machinery/atmospherics/pipe/tank/phoron{
	dir = 4
	},
/turf/simulated/floor/plating/indoors,
/area/space)
"gN" = (
/obj/machinery/door/airlock/glass/research,
/turf/simulated/floor/plating/outdoors,
/area/space)
"iJ" = (
/turf/simulated/floor/plating,
/area/space)
"iW" = (
/obj/effect/decal/warning_stripes,
/obj/structure/window/reinforced{
	dir = 4
	},
/turf/simulated/floor/plating/indoors,
/area/space)
"kV" = (
/obj/spawner/window/low_wall/reinforced/full,
/turf/simulated/floor/plating/outdoors,
/area/space)
"lx" = (
/obj/structure/closet/secure_closet/engineering_electrical,
/obj/structure/window/reinforced,
/turf/simulated/floor/plating/indoors,
/area/space)
"mB" = (
/obj/spawner/window/reinforced/full,
/turf/simulated/floor/plating,
/area/space)
"nl" = (
/obj/effect/decal/warning_stripes,
/turf/simulated/floor/plating/indoors,
/area/space)
"nI" = (
/obj/machinery/power/emitter{
	dir = 4
	},
/obj/structure/window/reinforced{
	dir = 1
	},
/turf/simulated/floor/plating/outdoors,
/area/space)
"qS" = (
/obj/machinery/door/airlock/external/glass,
/turf/simulated/floor/plating/indoors,
/area/space)
"rh" = (
/turf/simulated/wall,
/area/space)
"sz" = (
/obj/machinery/door/airlock/glass/research,
/turf/space/basic,
/area/space)
"sB" = (
/obj/effect/decal/warning_stripes,
/turf/space/basic,
/area/space)
"tz" = (
/obj/machinery/door/blast/regular,
/obj/structure/atmospheric_retention_field,
/turf/simulated/floor/plating/indoors,
/area/space)
"vN" = (
/obj/structure/window/reinforced{
	dir = 1
	},
/obj/structure/window/reinforced,
/obj/structure/window/reinforced{
	dir = 4
	},
/obj/machinery/door/window{
	dir = 8
	},
/turf/simulated/floor/plating/indoors,
/area/space)
"wj" = (
/obj/machinery/power/apc/east_mount,
/turf/simulated/floor/plating/indoors,
/area/space)
"wk" = (
/obj/machinery/atmospherics/component/unary/engine/biggest{
	dir = 1
	},
/turf/space/basic,
/area/space)
"wL" = (
/obj/spawner/window/reinforced/full,
/turf/simulated/floor/plating/indoors,
/area/space)
"zh" = (
/obj/machinery/atmospherics/pipe/tank/phoron{
	dir = 8
	},
/turf/simulated/floor/plating/indoors,
/area/space)
"Ab" = (
/obj/machinery/atmospherics/pipe/tank/phoron{
	dir = 4
	},
/obj/machinery/atmospherics/pipe/tank/phoron{
	dir = 4
	},
/turf/simulated/floor/plating/indoors,
/area/space)
"Ap" = (
/obj/machinery/atmospherics/component/unary/engine/bigger,
/turf/space/basic,
/area/space)
"Av" = (
/turf/simulated/floor/plating/indoors,
/turf/simulated/wall/r_wall/prepainted/science,
/area/space)
"AY" = (
/obj/machinery/artifact_analyser,
/turf/simulated/floor/plating/outdoors,
/area/space)
"Bp" = (
/obj/machinery/atmospherics/component/unary/engine/bigger,
/turf/simulated/floor/plating/indoors,
/area/space)
"Df" = (
/obj/machinery/door/airlock/glass/research,
/turf/simulated/floor/plating/indoors,
/area/space)
"Dk" = (
/obj/machinery/atmospherics/component/binary/pump/fuel,
/turf/simulated/floor/plating/indoors,
/area/space)
"GB" = (
/turf/simulated/wall/r_wall/prepainted/science,
/area/space)
"IG" = (
/obj/machinery/power/smes,
/turf/simulated/floor/plating/indoors,
/area/space)
"JV" = (
/obj/structure/bed/chair/shuttle{
	dir = 1
	},
/turf/space/basic,
/area/space)
"Mv" = (
/obj/structure/table/reinforced,
/turf/simulated/floor/plating/outdoors,
/area/space)
"MN" = (
/obj/structure/table/reinforced,
/turf/space/basic,
/area/space)
"Om" = (
/obj/machinery/door/airlock/multi_tile/glass{
	dir = 1
	},
/turf/simulated/floor/plating/indoors,
/area/space)
"OB" = (
/obj/machinery/computer/shuttle_control{
	dir = 4
	},
/turf/simulated/floor/plating/indoors,
/area/space)
"OR" = (
/obj/structure/table/rack/shelf,
/obj/structure/window/reinforced{
	dir = 4
	},
/turf/simulated/floor/plating/indoors,
/area/space)
"Py" = (
/turf/simulated/floor/plating/outdoors,
/area/space)
"Qu" = (
/obj/structure/closet/secure_closet/engineering_welding,
/obj/structure/window/reinforced{
	dir = 1
	},
/turf/simulated/floor/plating/indoors,
/area/space)
"Te" = (
/obj/structure/anomaly_container,
/turf/space/basic,
/area/space)
"Ub" = (
/obj/structure/table/reinforced,
/turf/simulated/floor/plating/indoors,
/area/space)
"Uh" = (
/obj/machinery/door/airlock/external/glass,
/turf/simulated/floor/plating,
/area/space)
"UL" = (
/obj/machinery/computer/shuttle_control,
/turf/space/basic,
/area/space)
"UV" = (
/obj/effect/decal/warning_stripes,
/obj/structure/window/reinforced{
	dir = 1
	},
/turf/simulated/floor/plating/indoors,
/area/space)
"Vr" = (
/obj/machinery/mech_recharger,
/turf/simulated/floor/plating/indoors,
/area/space)
"WC" = (
/obj/machinery/artifact_scanpad,
/turf/simulated/floor/plating/outdoors,
/area/space)
"WT" = (
/turf/simulated/floor/plating/indoors,
/area/space)
"WY" = (
/obj/machinery/atmospherics/component/binary/pump/fuel{
	dir = 8
	},
/turf/simulated/floor/plating/indoors,
/area/space)
"XJ" = (
/obj/structure/table/rack/shelf,
/obj/structure/window/reinforced{
	dir = 4
	},
/obj/structure/window/reinforced{
	dir = 4
	},
/turf/simulated/floor/plating/indoors,
/area/space)
"Yx" = (
/turf/space/basic,
/area/space)
"YT" = (
/obj/machinery/artifact_harvester,
/obj/machinery/air_alarm{
	dir = 8
	},
/turf/simulated/floor/plating/outdoors,
/area/space)
"Zk" = (
/obj/machinery/door/window/brigdoor,
/turf/simulated/floor/plating/outdoors,
/area/space)

(1,1,1) = {"
rh
rh
rh
rh
WT
WT
rh
rh
rh
rh
Yx
Yx
Yx
Yx
Yx
Yx
Yx
Yx
Yx
Yx
Yx
Yx
Yx
Yx
Yx
Yx
Yx
Yx
Yx
Yx
Yx
Yx
Yx
Yx
Yx
Yx
Yx
Yx
Yx
Yx
"}
(2,1,1) = {"
rh
nI
aJ
Py
WT
WT
bK
bv
bv
rh
Yx
Yx
Yx
Yx
Yx
Yx
Yx
Yx
Yx
Yx
Yx
Yx
Yx
Yx
Yx
Yx
Yx
Yx
Yx
Yx
Yx
Yx
Yx
Yx
Yx
Yx
Yx
Yx
Yx
Yx
"}
(3,1,1) = {"
rh
Zk
Py
Py
WT
WT
Df
WT
WT
rh
Yx
Yx
Yx
Yx
Yx
GB
qS
qS
GB
GB
GB
Yx
GB
GB
GB
Yx
Yx
Yx
Yx
Yx
Yx
Yx
Yx
Yx
Yx
Yx
Yx
Yx
Yx
Yx
"}
(4,1,1) = {"
rh
gs
Mv
Py
WT
WT
bK
bv
bv
rh
Yx
Yx
Yx
Yx
Yx
wL
WT
WT
wL
WT
WT
GB
lx
WT
Qu
GB
Yx
Yx
Yx
Yx
Yx
Yx
Yx
Yx
Yx
Yx
Yx
Yx
Yx
Yx
"}
(5,1,1) = {"
rh
kV
kV
kV
WT
WT
rh
rh
GB
rh
Yx
Yx
Yx
Yx
Yx
GB
qS
qS
GB
WT
WT
Df
WT
WT
WT
WT
GB
Yx
Yx
Yx
WT
WT
WT
WT
WT
WT
Ap
Yx
Yx
Yx
"}
(6,1,1) = {"
rh
WC
Py
gN
WT
WT
Om
Te
Te
rh
Yx
Yx
Yx
Yx
Yx
Yx
Yx
Yx
Yx
Yx
Yx
GB
nl
nl
nl
vN
GB
Ap
Yx
Yx
WT
WT
WT
WT
WT
WT
Yx
Yx
Yx
Yx
"}
(7,1,1) = {"
rh
AY
YT
bK
WT
WT
WT
Te
Te
rh
Yx
Yx
Yx
Yx
Yx
WT
WT
WT
WT
WT
WT
WT
GB
GB
GB
GB
GB
WT
Yx
Yx
WT
WT
WT
WT
WT
WT
WT
Ap
Yx
Yx
"}
(8,1,1) = {"
rh
rh
rh
rh
WT
WT
rh
rh
rh
rh
Yx
Yx
Yx
Yx
Yx
WT
WT
WT
WT
WT
WT
WT
GB
nl
WT
Vr
Vr
tz
Yx
Yx
WT
WT
WT
GB
WT
WT
GB
Yx
Yx
Yx
"}
(9,1,1) = {"
Yx
Yx
Yx
Yx
Yx
Yx
Yx
Yx
Yx
Yx
Yx
Yx
Yx
Yx
Yx
Yx
Yx
Yx
Yx
Yx
WT
WT
GB
nl
WT
Vr
Vr
tz
Yx
Yx
WT
WT
WT
Om
Vr
Vr
tz
Yx
Yx
Yx
"}
(10,1,1) = {"
Yx
Yx
Yx
Yx
Yx
Yx
Yx
GB
OR
OR
XJ
GB
Yx
Yx
Yx
Yx
Yx
Yx
Yx
Yx
WT
WT
Df
WT
WT
UV
GB
GB
wk
Yx
WT
WT
WT
WT
Vr
Vr
tz
Yx
Yx
Yx
"}
(11,1,1) = {"
Yx
Yx
Yx
Yx
Yx
Yx
Yx
wL
OB
Ub
OB
wL
Yx
Yx
Yx
Yx
Yx
Yx
Yx
Yx
WT
WT
wL
nl
WT
nl
WT
Av
Yx
Yx
WT
WT
WT
GB
mB
mB
GB
Yx
Yx
Yx
"}
(12,1,1) = {"
Yx
Yx
Yx
Yx
Yx
Yx
Yx
sz
WT
wj
WT
sz
Yx
Yx
Yx
Yx
Yx
Yx
Yx
Yx
WT
WT
Df
WT
WT
iW
GB
Av
Yx
Yx
WT
WT
WT
Om
Vr
Vr
tz
Yx
Yx
Yx
"}
(13,1,1) = {"
Yx
Yx
Yx
Yx
Yx
Yx
Yx
GB
IG
GB
IG
GB
Yx
Yx
Yx
Yx
Yx
Yx
Yx
Yx
WT
WT
GB
nl
WT
Vr
Vr
tz
Yx
Yx
WT
WT
WT
WT
Vr
Vr
tz
Yx
Yx
Yx
"}
(14,1,1) = {"
Yx
Yx
Yx
Yx
Yx
Yx
Yx
GB
GB
bv
GB
GB
Yx
Yx
Yx
WT
WT
WT
WT
WT
WT
WT
GB
nl
WT
Vr
Vr
tz
Yx
Yx
WT
WT
WT
GB
WT
WT
GB
Ap
Yx
Yx
"}
(15,1,1) = {"
Yx
Yx
Yx
Yx
Yx
Yx
Yx
Yx
Yx
Yx
Yx
Yx
Yx
Yx
Yx
WT
WT
WT
WT
WT
WT
WT
GB
GB
GB
GB
GB
Bp
Yx
Yx
WT
WT
WT
WT
WT
WT
WT
Yx
Yx
Yx
"}
(16,1,1) = {"
Yx
Yx
Yx
Yx
Yx
sB
Yx
Yx
Yx
Yx
Yx
Yx
Yx
Yx
Yx
Yx
Yx
Yx
Yx
Yx
Yx
GB
WT
gC
Ab
WY
GB
Yx
Yx
Yx
WT
WT
WT
WT
WT
WT
Ap
Yx
Yx
Yx
"}
(17,1,1) = {"
Yx
Yx
Yx
Yx
Yx
Yx
UL
Yx
Yx
Yx
Yx
Yx
Yx
Yx
Yx
GB
qS
qS
GB
WT
WT
Df
Dk
WT
WT
WT
GB
Yx
Yx
Yx
WT
WT
WT
WT
WT
WT
Yx
Yx
Yx
Yx
"}
(18,1,1) = {"
Yx
Yx
Yx
Yx
Yx
Yx
MN
Yx
Yx
Yx
Yx
Yx
Yx
Yx
Yx
wL
WT
WT
wL
WT
WT
GB
WT
zh
zh
GB
Yx
Yx
Yx
Yx
Yx
Yx
Yx
Yx
Yx
Yx
Yx
Yx
Yx
Yx
"}
(19,1,1) = {"
Yx
Yx
Yx
Yx
Yx
Yx
UL
JV
Yx
Yx
Yx
Yx
Yx
Yx
Yx
GB
qS
qS
GB
GB
GB
Yx
GB
GB
GB
Yx
Yx
Yx
Yx
Yx
Yx
Yx
Yx
Yx
Yx
Yx
Yx
Yx
Yx
Yx
"}
(20,1,1) = {"
Yx
Yx
Yx
Yx
Yx
Yx
Yx
Yx
Yx
Yx
Yx
Yx
Yx
Yx
Yx
Yx
Yx
Yx
Yx
Yx
Yx
Yx
Yx
Yx
Yx
Yx
Yx
Yx
Yx
Yx
Yx
Yx
Yx
Yx
Yx
Yx
Yx
Yx
Yx
Yx
"}
(21,1,1) = {"
Yx
Yx
Yx
Yx
Yx
Yx
Yx
Yx
Yx
Yx
Yx
Yx
Yx
Yx
Yx
Yx
Yx
Yx
Yx
Yx
Yx
Yx
Yx
Yx
Yx
Yx
Yx
Yx
Yx
GB
mB
mB
GB
Yx
Yx
Yx
Yx
Yx
Yx
Yx
"}
(22,1,1) = {"
Yx
Yx
Yx
Yx
Yx
Yx
Yx
Yx
Yx
Yx
Yx
Yx
Yx
Yx
Yx
WT
Yx
Yx
Yx
Yx
Yx
Yx
Yx
Yx
GB
mB
mB
GB
Yx
mB
iJ
iJ
Uh
Yx
Yx
Yx
Yx
Yx
Yx
Yx
"}
(23,1,1) = {"
Yx
Yx
Yx
Yx
Yx
Yx
Yx
Yx
Yx
Yx
Yx
Yx
Yx
WT
WT
WT
WT
WT
WT
Yx
Yx
Yx
Yx
Yx
Yx
Yx
Yx
Yx
Yx
mB
iJ
iJ
Uh
Yx
Yx
rh
WT
WT
rh
Yx
"}
(24,1,1) = {"
Yx
Yx
Yx
Yx
Yx
Yx
Yx
Yx
Yx
Yx
Yx
WT
WT
WT
WT
WT
WT
WT
WT
WT
WT
WT
iJ
Ap
Yx
Yx
Yx
Yx
Yx
GB
Uh
Uh
GB
Yx
WT
WT
Vr
Vr
WT
WT
"}
(25,1,1) = {"
Yx
WT
WT
WT
WT
WT
WT
Ap
Yx
Yx
Yx
WT
WT
WT
WT
WT
WT
WT
WT
WT
WT
WT
WT
Yx
Yx
Yx
Yx
Yx
Yx
Yx
Yx
Yx
Yx
Yx
WT
WT
Vr
Vr
WT
WT
"}
(26,1,1) = {"
Yx
WT
WT
WT
WT
WT
WT
Yx
Yx
Yx
Yx
WT
WT
WT
WT
WT
WT
WT
WT
GB
WT
WT
GB
Yx
Yx
Yx
Yx
Yx
Yx
Yx
Yx
Yx
Yx
Yx
Yx
rh
WT
WT
rh
Yx
"}
(27,1,1) = {"
Yx
WT
WT
WT
WT
WT
WT
WT
Ap
Yx
Yx
WT
WT
WT
WT
WT
WT
WT
WT
Om
Vr
Vr
tz
Yx
Yx
Yx
Yx
Yx
Yx
Yx
Yx
Yx
Yx
Yx
Yx
Yx
Yx
Yx
Yx
Yx
"}
(28,1,1) = {"
Yx
WT
WT
WT
Yx
Yx
Yx
Yx
Yx
Yx
Yx
WT
WT
WT
WT
WT
WT
WT
WT
WT
Vr
Vr
tz
Yx
Yx
Yx
Yx
Yx
Yx
Yx
Yx
Yx
Yx
Yx
Yx
Yx
Yx
Yx
Yx
Yx
"}
(29,1,1) = {"
Yx
WT
WT
WT
Yx
Yx
Yx
Yx
Yx
Yx
Yx
WT
WT
WT
WT
WT
WT
WT
WT
GB
WT
WT
GB
Yx
Yx
Yx
Yx
Yx
Yx
Yx
Yx
Yx
Yx
Yx
Yx
Yx
Yx
Yx
Yx
Yx
"}
(30,1,1) = {"
Yx
WT
WT
WT
Yx
Yx
Yx
Yx
Yx
Yx
Yx
WT
WT
WT
WT
WT
WT
WT
WT
WT
WT
WT
WT
Ap
Yx
Yx
Yx
Yx
Yx
Yx
Yx
Yx
Yx
Yx
Yx
Yx
Yx
Yx
Yx
Yx
"}
(31,1,1) = {"
Yx
WT
WT
WT
Yx
Yx
Yx
Yx
Yx
Yx
Yx
WT
WT
WT
WT
WT
WT
WT
WT
WT
WT
WT
iJ
Yx
Yx
Yx
Yx
Yx
Yx
Yx
Yx
Yx
Yx
Yx
Yx
Yx
Yx
Yx
Yx
Yx
"}
(32,1,1) = {"
Yx
WT
WT
WT
Yx
Yx
Yx
Yx
Yx
Yx
Yx
Yx
Yx
WT
WT
WT
WT
WT
WT
WT
Yx
Yx
Yx
Yx
Yx
Yx
Yx
Yx
Yx
Yx
Yx
Yx
Yx
Yx
Yx
Yx
Yx
Yx
Yx
Yx
"}
(33,1,1) = {"
Yx
WT
WT
WT
Yx
Yx
Yx
Yx
Yx
Yx
Yx
Yx
Yx
Yx
Yx
WT
Yx
Yx
Yx
Yx
Yx
Yx
Yx
Yx
Yx
Yx
Yx
Yx
Yx
Yx
Yx
Yx
Yx
Yx
Yx
Yx
Yx
Yx
Yx
Yx
"}
(34,1,1) = {"
Yx
WT
WT
WT
Yx
Yx
Yx
Yx
Ap
Yx
Yx
Yx
Yx
Yx
Yx
Yx
Yx
Yx
Yx
Yx
Yx
Yx
Yx
Yx
Yx
Yx
Yx
Yx
Yx
Yx
Yx
Yx
Yx
Yx
Yx
Yx
Yx
Yx
Yx
Yx
"}
(35,1,1) = {"
Yx
WT
WT
WT
WT
WT
WT
WT
Yx
Yx
Yx
GB
Uh
Uh
GB
Yx
Yx
Yx
Yx
Yx
GB
Uh
Uh
GB
Yx
Yx
Yx
Yx
Yx
Yx
Yx
Yx
Yx
Yx
Yx
Yx
Yx
Yx
Yx
Yx
"}
(36,1,1) = {"
Yx
WT
WT
WT
WT
WT
WT
Ap
Yx
Yx
Yx
mB
iJ
iJ
Uh
Yx
Yx
Yx
Yx
Yx
mB
iJ
iJ
Uh
Yx
Yx
Yx
Yx
Yx
Yx
Yx
Yx
Yx
Yx
Yx
Yx
Yx
Yx
Yx
Yx
"}
(37,1,1) = {"
Yx
WT
WT
WT
WT
WT
WT
Yx
Yx
Yx
Yx
mB
iJ
iJ
Uh
Yx
Yx
Yx
Yx
Yx
mB
iJ
iJ
Uh
Yx
Yx
Yx
Yx
Yx
Yx
Yx
Yx
Yx
Yx
Yx
Yx
Yx
Yx
Yx
Yx
"}
(38,1,1) = {"
Yx
Yx
Yx
Yx
Yx
Yx
Yx
Yx
Yx
Yx
Yx
GB
mB
mB
GB
Yx
Yx
Yx
Yx
Yx
GB
mB
mB
GB
Yx
Yx
Yx
Yx
Yx
Yx
Yx
Yx
Yx
Yx
Yx
Yx
Yx
Yx
Yx
Yx
"}
(39,1,1) = {"
Yx
Yx
Yx
Yx
Yx
Yx
Yx
Yx
Yx
Yx
Yx
Yx
Yx
Yx
Yx
Yx
Yx
Yx
Yx
Yx
Yx
Yx
Yx
Yx
Yx
Yx
Yx
Yx
Yx
Yx
Yx
Yx
Yx
Yx
Yx
Yx
Yx
Yx
Yx
Yx
"}
(40,1,1) = {"
Yx
Yx
Yx
Yx
Yx
Yx
Yx
Yx
Yx
Yx
Yx
Yx
Yx
Yx
mB
mB
Yx
Yx
Yx
Yx
Yx
Yx
Yx
Yx
Yx
Yx
Yx
Yx
Yx
Yx
Yx
Yx
Yx
Yx
Yx
Yx
Yx
Yx
Yx
Yx
"}
