//MAP CONVERTED BY dmm2tgm.py THIS HEADER COMMENT PREVENTS RECONVERSION, DO NOT REMOVE
"ba" = (
/obj/machinery/atmospherics/pipe/tank/phoron{
	dir = 8
	},
/turf/simulated/floor/plating/indoors,
/area/space)
"bJ" = (
/obj/structure/table/reinforced,
/turf/simulated/floor/plating/outdoors,
/area/space)
"bK" = (
/obj/structure/table/rack/shelf,
/turf/simulated/floor/plating/indoors,
/area/space)
"bS" = (
/obj/machinery/door/airlock/glass/research,
/turf/simulated/floor/plating/indoors,
/area/space)
"cB" = (
/obj/structure/window/reinforced{
	dir = 4
	},
/obj/effect/decal/warning_stripes,
/turf/simulated/floor/plating/indoors,
/area/space)
"dE" = (
/turf/simulated/wall,
/area/space)
"dH" = (
/obj/machinery/door/airlock/external/glass,
/turf/simulated/floor/plating,
/area/space)
"ew" = (
/obj/machinery/mech_recharger,
/turf/simulated/floor/plating/indoors,
/area/space)
"gh" = (
/obj/machinery/power/apc/east_mount,
/obj/structure/table/rack/shelf,
/turf/simulated/floor/plating/indoors,
/area/space)
"go" = (
/obj/structure/table/reinforced,
/obj/structure/window/reinforced{
	dir = 8
	},
/turf/simulated/floor/plating/indoors,
/area/space)
"gA" = (
/obj/structure/window/reinforced{
	dir = 4
	},
/obj/structure/window/reinforced{
	dir = 8
	},
/turf/simulated/floor/plating,
/area/space)
"gH" = (
/obj/spawner/window/low_wall/reinforced/full,
/turf/simulated/floor/plating/indoors,
/area/space)
"hb" = (
/obj/spawner/window/reinforced/full,
/turf/simulated/floor/plating/indoors,
/area/space)
"hc" = (
/obj/spawner/window/reinforced/full,
/turf/space/basic,
/area/space)
"hk" = (
/obj/structure/closet/secure_closet/engineering_electrical,
/obj/structure/window/reinforced,
/obj/structure/window/reinforced{
	dir = 1
	},
/turf/simulated/floor/plating/indoors,
/area/space)
"jB" = (
/turf/simulated/floor/plating/indoors,
/area/space)
"kc" = (
/obj/spawner/window/low_wall/reinforced/full,
/turf/simulated/floor/plating/outdoors,
/area/space)
"kA" = (
/turf/simulated/floor/plating,
/area/space)
"kE" = (
/turf/simulated/floor/plating/indoors,
/turf/simulated/wall/r_wall/prepainted/science,
/area/space)
"lq" = (
/turf/simulated/wall/r_wall/prepainted/science,
/area/space)
"lr" = (
/obj/machinery/atmospherics/portables_connector{
	dir = 4
	},
/turf/simulated/floor/plating/indoors,
/area/space)
"lH" = (
/obj/machinery/door/airlock/multi_tile/glass{
	dir = 1
	},
/turf/simulated/floor/plating/indoors,
/area/space)
"nb" = (
/obj/machinery/air_alarm{
	dir = 4
	},
/obj/machinery/radiocarbon_spectrometer,
/turf/simulated/floor/plating/outdoors,
/area/space)
"nO" = (
/obj/machinery/power/apc/east_mount,
/turf/simulated/floor/plating/indoors,
/area/space)
"pi" = (
/obj/effect/decal/warning_stripes,
/turf/space/basic,
/area/space)
"pJ" = (
/obj/structure/table/rack/shelf,
/obj/structure/window/reinforced{
	dir = 4
	},
/obj/structure/window/reinforced{
	dir = 4
	},
/turf/simulated/floor/plating/indoors,
/area/space)
"sI" = (
/obj/effect/decal/warning_stripes,
/turf/simulated/floor/plating/indoors,
/area/space)
"sS" = (
/obj/structure/closet/secure_closet/engineering_welding,
/obj/structure/window/reinforced{
	dir = 1
	},
/turf/simulated/floor/plating/indoors,
/area/space)
"tu" = (
/obj/machinery/atmospherics/component/unary/engine/bigger,
/turf/simulated/floor/plating/indoors,
/area/space)
"tz" = (
/obj/structure/closet/secure_closet/engineering_electrical,
/obj/structure/window/reinforced,
/turf/simulated/floor/plating/indoors,
/area/space)
"uI" = (
/obj/structure/window/reinforced{
	dir = 1
	},
/turf/simulated/floor/plating/outdoors,
/area/space)
"vI" = (
/obj/machinery/atmospherics/component/binary/pump/fuel,
/turf/simulated/floor/plating/indoors,
/area/space)
"wf" = (
/obj/machinery/computer/shuttle_control,
/turf/space/basic,
/area/space)
"wr" = (
/obj/machinery/power/emitter{
	dir = 4
	},
/obj/structure/window/reinforced{
	dir = 1
	},
/turf/simulated/floor/plating/outdoors,
/area/space)
"wx" = (
/obj/machinery/power/smes,
/obj/structure/window/reinforced,
/turf/simulated/floor/plating/indoors,
/area/space)
"xj" = (
/obj/machinery/computer/shuttle_control{
	dir = 4
	},
/obj/structure/window/reinforced{
	dir = 8
	},
/turf/simulated/floor/plating/indoors,
/area/space)
"xs" = (
/obj/machinery/door/airlock/glass/research,
/turf/simulated/floor/plating/outdoors,
/area/space)
"xX" = (
/obj/structure/anomaly_container,
/turf/space/basic,
/area/space)
"yf" = (
/obj/structure/table/reinforced,
/turf/space/basic,
/area/space)
"yn" = (
/obj/machinery/atmospherics/pipe/tank/phoron{
	dir = 4
	},
/obj/machinery/atmospherics/pipe/tank/phoron{
	dir = 4
	},
/turf/simulated/floor/plating/indoors,
/area/space)
"yr" = (
/obj/effect/decal/warning_stripes,
/obj/structure/window/reinforced{
	dir = 4
	},
/turf/simulated/floor/plating/indoors,
/area/space)
"zb" = (
/obj/machinery/door/blast/regular,
/obj/structure/atmospheric_retention_field,
/turf/simulated/floor/plating/indoors,
/area/space)
"zQ" = (
/obj/effect/decal/warning_stripes,
/obj/effect/decal/warning_stripes,
/turf/simulated/floor/plating/indoors,
/area/space)
"Ae" = (
/obj/structure/window/reinforced{
	dir = 1
	},
/obj/structure/window/reinforced,
/obj/machinery/door/window{
	dir = 8
	},
/obj/structure/window/reinforced{
	dir = 4
	},
/turf/simulated/floor/plating/indoors,
/area/space)
"Aq" = (
/obj/machinery/atmospherics/pipe/tank/phoron{
	dir = 4
	},
/turf/simulated/floor/plating/indoors,
/area/space)
"Bc" = (
/obj/structure/bed/chair/shuttle{
	dir = 8
	},
/turf/simulated/floor/plating/indoors,
/area/space)
"Eq" = (
/obj/structure/closet/secure_closet/engineering_welding,
/obj/structure/window/reinforced{
	dir = 1
	},
/obj/structure/window/reinforced,
/turf/simulated/floor/plating/indoors,
/area/space)
"Fl" = (
/obj/effect/decal/warning_stripes,
/obj/structure/window/reinforced{
	dir = 1
	},
/turf/simulated/floor/plating/indoors,
/area/space)
"Hl" = (
/obj/machinery/atmospherics/component/unary/engine/bigger,
/turf/space/basic,
/area/space)
"HM" = (
/obj/machinery/computer/shuttle_control{
	dir = 4
	},
/turf/simulated/floor/plating/indoors,
/area/space)
"HU" = (
/obj/structure/table/reinforced,
/turf/simulated/floor/plating/indoors,
/area/space)
"II" = (
/obj/machinery/door/airlock/glass/research,
/turf/space/basic,
/area/space)
"Jk" = (
/obj/machinery/atmospherics/component/binary/pump/fuel{
	dir = 8
	},
/turf/simulated/floor/plating/indoors,
/area/space)
"Jp" = (
/obj/structure/window/reinforced{
	dir = 8
	},
/obj/effect/decal/warning_stripes,
/turf/simulated/floor/plating/indoors,
/area/space)
"Ku" = (
/obj/machinery/atmospherics/component/binary/pump/fuel{
	dir = 4
	},
/turf/simulated/floor/plating/indoors,
/area/space)
"LI" = (
/obj/structure/table/rack/shelf,
/obj/structure/window/reinforced{
	dir = 4
	},
/turf/simulated/floor/plating/indoors,
/area/space)
"Ng" = (
/obj/machinery/artifact_harvester,
/obj/machinery/air_alarm{
	dir = 8
	},
/turf/simulated/floor/plating/outdoors,
/area/space)
"Ob" = (
/obj/machinery/artifact_scanpad,
/turf/simulated/floor/plating/outdoors,
/area/space)
"OL" = (
/obj/machinery/artifact_analyser,
/turf/simulated/floor/plating/outdoors,
/area/space)
"Pj" = (
/turf/space/basic,
/area/space)
"QS" = (
/obj/machinery/door/window/brigdoor,
/turf/simulated/floor/plating/outdoors,
/area/space)
"Tp" = (
/obj/spawner/window/reinforced/full,
/turf/simulated/floor/plating,
/area/space)
"TR" = (
/obj/structure/bed/chair/shuttle{
	dir = 1
	},
/turf/space/basic,
/area/space)
"UX" = (
/obj/machinery/power/smes,
/turf/simulated/floor/plating/indoors,
/area/space)
"Vz" = (
/obj/machinery/atmospherics/component/unary/engine/biggest{
	dir = 1
	},
/turf/space/basic,
/area/space)
"WY" = (
/obj/machinery/door/airlock/external/glass,
/turf/simulated/floor/plating/indoors,
/area/space)
"YZ" = (
/obj/structure/window/reinforced{
	dir = 1
	},
/obj/structure/window/reinforced,
/obj/structure/window/reinforced{
	dir = 4
	},
/obj/machinery/door/window{
	dir = 8
	},
/turf/simulated/floor/plating/indoors,
/area/space)
"ZF" = (
/turf/simulated/floor/plating/outdoors,
/area/space)

(1,1,1) = {"
dE
dE
dE
dE
jB
jB
dE
dE
dE
dE
Pj
Pj
Pj
Pj
Pj
Pj
Pj
Pj
Pj
Pj
Pj
Pj
Pj
Pj
Pj
Pj
Pj
Pj
Pj
Pj
Pj
Pj
Pj
Pj
Pj
Pj
Pj
Pj
Pj
Pj
"}
(2,1,1) = {"
dE
wr
nb
ZF
jB
jB
gH
bK
bK
dE
Pj
Pj
Pj
Pj
Pj
Pj
Pj
Pj
Pj
Pj
Pj
Pj
Pj
Pj
Pj
Pj
Pj
Pj
Pj
Pj
Pj
Pj
Pj
Pj
Pj
Pj
Pj
Pj
Pj
Pj
"}
(3,1,1) = {"
dE
QS
ZF
ZF
jB
jB
bS
jB
jB
dE
Pj
Pj
Pj
Pj
Pj
Pj
Pj
Pj
Pj
Pj
Pj
Pj
Pj
Pj
Pj
Pj
lq
WY
WY
lq
lq
lq
Pj
lq
lq
lq
Pj
Pj
Pj
Pj
"}
(4,1,1) = {"
dE
uI
bJ
ZF
jB
jB
gH
bK
bK
dE
Pj
Pj
Pj
Pj
Pj
Pj
Pj
Pj
Pj
Pj
Pj
Pj
Pj
Pj
Pj
Pj
hb
jB
jB
hb
jB
jB
lq
tz
jB
sS
lq
Pj
Pj
Pj
"}
(5,1,1) = {"
dE
kc
kc
kc
jB
jB
dE
dE
lq
dE
Pj
Pj
Pj
Pj
Pj
Pj
Pj
Pj
Pj
Pj
Pj
Pj
Pj
Pj
Pj
Pj
lq
WY
WY
lq
jB
jB
bS
jB
jB
jB
jB
lq
Pj
Pj
"}
(6,1,1) = {"
dE
Ob
ZF
xs
jB
jB
lH
xX
xX
dE
Pj
Pj
Pj
Pj
Pj
lq
LI
LI
pJ
lq
Pj
Pj
Pj
Pj
Pj
Pj
Pj
Pj
Pj
Pj
Pj
Pj
lq
sI
sI
sI
YZ
lq
Hl
Pj
"}
(7,1,1) = {"
dE
OL
Ng
gH
jB
jB
jB
xX
xX
dE
Pj
Pj
Pj
Pj
Pj
hb
HM
HU
HM
hb
Pj
Pj
Pj
Pj
Pj
Pj
jB
jB
jB
jB
jB
jB
jB
lq
lq
lq
lq
lq
jB
Pj
"}
(8,1,1) = {"
dE
dE
dE
dE
jB
jB
dE
dE
dE
dE
Pj
Pj
Pj
Pj
Pj
II
jB
nO
jB
II
Pj
Pj
Pj
Pj
Pj
Pj
jB
jB
jB
jB
jB
jB
jB
lq
sI
jB
ew
ew
zb
Pj
"}
(9,1,1) = {"
Pj
Pj
Pj
Pj
Pj
Pj
Pj
Pj
Pj
Pj
Pj
Pj
Pj
Pj
Pj
lq
UX
lq
UX
lq
Pj
Pj
Pj
Pj
Pj
Pj
Pj
Pj
Pj
Pj
Pj
jB
jB
lq
sI
jB
ew
ew
zb
Pj
"}
(10,1,1) = {"
Pj
Pj
Pj
Pj
Pj
Pj
Pj
Pj
Pj
Pj
Pj
Pj
Pj
Pj
Pj
lq
lq
bK
lq
lq
Pj
Pj
Pj
Pj
Pj
Pj
Pj
Pj
Pj
Pj
Pj
jB
jB
bS
jB
jB
Fl
lq
lq
Vz
"}
(11,1,1) = {"
Pj
Pj
Pj
Pj
Pj
Pj
Pj
Pj
Pj
Pj
Pj
Pj
Pj
Pj
Pj
Pj
Pj
Pj
Pj
Pj
Pj
Pj
Pj
Pj
Pj
Pj
Pj
Pj
Pj
Pj
Pj
jB
jB
hb
sI
jB
sI
jB
kE
Pj
"}
(12,1,1) = {"
Pj
Pj
Pj
Pj
Pj
Pj
Pj
Pj
Pj
Pj
Pj
Pj
Pj
Pj
Pj
Pj
Pj
Pj
Pj
Pj
Pj
Pj
Pj
Pj
Pj
Pj
Pj
Pj
Pj
Pj
Pj
jB
jB
bS
jB
jB
yr
lq
kE
Pj
"}
(13,1,1) = {"
Pj
Pj
Pj
Pj
Pj
Pj
Pj
Pj
lq
Tp
Tp
lq
Pj
Pj
Pj
Pj
Pj
Pj
Pj
Pj
Pj
Pj
Pj
Pj
Pj
Pj
Pj
Pj
Pj
Pj
Pj
jB
jB
lq
sI
jB
ew
ew
zb
Pj
"}
(14,1,1) = {"
Pj
Pj
Pj
Pj
Pj
Pj
Pj
Pj
Tp
kA
kA
dH
Pj
Pj
Pj
Pj
Pj
Pj
Pj
Pj
Pj
Pj
Pj
Pj
Pj
Pj
jB
jB
jB
jB
jB
jB
jB
lq
sI
jB
ew
ew
zb
Pj
"}
(15,1,1) = {"
Pj
Pj
Pj
Pj
Pj
Pj
Pj
Pj
Tp
kA
kA
dH
Pj
Pj
Pj
Pj
Pj
Pj
Pj
Pj
Pj
Pj
Pj
Pj
Pj
Pj
jB
jB
jB
jB
jB
jB
jB
lq
lq
lq
lq
lq
tu
Pj
"}
(16,1,1) = {"
Pj
Pj
Pj
Pj
Pj
pi
Pj
Pj
lq
dH
dH
lq
Pj
Pj
Pj
Pj
Pj
Pj
Pj
Pj
Pj
Pj
Pj
Pj
Pj
Pj
Pj
Pj
Pj
Pj
Pj
Pj
lq
jB
Aq
yn
Jk
lq
Pj
Pj
"}
(17,1,1) = {"
Pj
Pj
Pj
Pj
Pj
Pj
wf
Pj
Pj
Pj
Pj
Pj
Pj
Pj
Pj
Pj
Pj
Pj
Pj
Pj
Pj
Pj
Pj
Pj
Pj
Pj
lq
WY
WY
lq
jB
jB
bS
vI
jB
jB
jB
lq
Pj
Pj
"}
(18,1,1) = {"
Pj
Pj
Pj
Pj
Pj
Pj
yf
Pj
Pj
Pj
Pj
Pj
Pj
Pj
Pj
Pj
Pj
Pj
Pj
Pj
Pj
Pj
Pj
Pj
Pj
Pj
hb
jB
jB
hb
jB
jB
lq
jB
ba
ba
lq
Pj
Pj
Pj
"}
(19,1,1) = {"
Pj
Pj
Pj
Pj
Pj
Pj
wf
TR
Pj
Pj
Pj
Pj
Pj
Pj
Pj
Pj
Pj
Pj
Pj
Pj
Pj
Pj
Pj
Pj
Pj
Pj
lq
WY
WY
lq
lq
lq
Pj
lq
lq
lq
Pj
Pj
Pj
Pj
"}
(20,1,1) = {"
Pj
Pj
Pj
Pj
Pj
Pj
Pj
Pj
Pj
Pj
Pj
Pj
Pj
Pj
Pj
Pj
Pj
Pj
Pj
Pj
Pj
Pj
Pj
Pj
Pj
Pj
Pj
Pj
Pj
Pj
Pj
Pj
Pj
Pj
Pj
Pj
Pj
Pj
Pj
Pj
"}
(21,1,1) = {"
Pj
Pj
Pj
Pj
Pj
Pj
Pj
Pj
Pj
Pj
Pj
Pj
Pj
Pj
Pj
Pj
Pj
Pj
Pj
Pj
Pj
Pj
Pj
Pj
Pj
Pj
Pj
Pj
Pj
Pj
Pj
Pj
Pj
Pj
Pj
Pj
Pj
Pj
Pj
Pj
"}
(22,1,1) = {"
Pj
Pj
Pj
Pj
jB
Pj
Pj
Pj
Pj
Pj
Pj
Pj
Pj
Pj
Pj
Pj
Pj
Pj
Pj
Pj
Pj
Pj
Pj
Pj
Pj
Pj
Pj
Pj
Pj
Pj
Pj
Pj
Pj
Pj
Pj
Pj
Pj
Pj
Pj
Pj
"}
(23,1,1) = {"
Pj
Pj
jB
jB
jB
jB
jB
jB
Pj
Pj
Pj
Pj
Pj
Pj
Pj
Pj
Pj
Pj
Pj
Pj
Pj
Pj
Pj
Pj
Pj
Pj
Pj
Pj
Pj
Pj
Pj
Pj
Pj
Pj
Pj
Pj
Pj
Pj
Pj
Pj
"}
(24,1,1) = {"
jB
jB
jB
jB
jB
jB
jB
jB
jB
jB
jB
kA
Hl
Pj
Pj
Pj
Pj
Pj
Pj
Pj
Pj
Pj
Pj
Pj
Pj
Pj
Pj
Pj
Pj
Pj
Pj
Pj
Pj
Pj
lq
lq
lq
lq
Hl
Pj
"}
(25,1,1) = {"
jB
jB
jB
jB
jB
jB
jB
jB
jB
jB
jB
jB
Pj
Pj
Pj
Pj
Pj
Pj
Pj
Pj
Pj
Pj
Pj
Pj
Pj
Pj
Pj
Pj
Pj
Pj
Pj
lq
WY
WY
lq
jB
sI
lq
Pj
Pj
"}
(26,1,1) = {"
jB
jB
jB
jB
jB
jB
jB
jB
lq
jB
jB
lq
Pj
Pj
Pj
Pj
Pj
Pj
Pj
Pj
Pj
Pj
Pj
Pj
Pj
Pj
Pj
Pj
Pj
Pj
Pj
hc
jB
jB
lq
jB
zQ
sI
lq
Hl
"}
(27,1,1) = {"
jB
jB
jB
jB
jB
jB
jB
jB
lH
ew
ew
zb
Pj
Pj
Pj
Pj
Pj
Pj
Pj
Pj
Pj
Pj
Pj
Pj
Pj
Pj
Pj
Pj
Pj
Pj
Pj
hc
jB
jB
lq
jB
cB
cB
lq
Pj
"}
(28,1,1) = {"
jB
jB
jB
jB
jB
jB
jB
jB
jB
ew
ew
zb
Pj
Pj
Pj
Pj
Pj
Pj
Pj
Pj
Pj
Pj
Pj
Pj
Pj
Pj
Pj
Pj
Pj
Pj
Pj
lq
WY
WY
lq
jB
ew
ew
zb
Pj
"}
(29,1,1) = {"
jB
jB
jB
jB
jB
jB
jB
jB
lq
jB
jB
lq
Pj
Pj
Pj
Pj
Pj
Pj
Pj
Pj
Pj
Pj
Pj
Pj
hb
xj
go
xj
hb
jB
jB
jB
jB
jB
bS
jB
ew
ew
zb
Pj
"}
(30,1,1) = {"
jB
jB
jB
jB
jB
jB
jB
jB
jB
jB
jB
jB
Hl
Pj
Pj
Pj
Pj
Pj
Pj
Pj
Pj
Pj
Pj
Pj
II
Bc
jB
Bc
II
jB
jB
jB
jB
jB
hb
jB
gA
gA
lq
Pj
"}
(31,1,1) = {"
jB
jB
jB
jB
jB
jB
jB
jB
jB
jB
jB
kA
Pj
Pj
Pj
Pj
Pj
Pj
Pj
Pj
Pj
Pj
Pj
Pj
lq
wx
jB
gh
lq
jB
jB
jB
jB
jB
bS
jB
ew
ew
zb
Pj
"}
(32,1,1) = {"
Pj
Pj
jB
jB
jB
jB
jB
jB
jB
Pj
Pj
Pj
Pj
Pj
Pj
Pj
Pj
Pj
Pj
Pj
Pj
Pj
Pj
Pj
lq
lq
bS
lq
lq
lq
lq
lq
bS
lq
lq
jB
ew
ew
zb
Pj
"}
(33,1,1) = {"
Pj
Pj
Pj
Pj
jB
Pj
Pj
Pj
Pj
Pj
Pj
Pj
Pj
Pj
Pj
Pj
Pj
Pj
Pj
Pj
Pj
Pj
Pj
Pj
Pj
Pj
Pj
lq
hk
UX
Eq
lr
Ku
Jk
lq
jB
Jp
Jp
lq
Hl
"}
(34,1,1) = {"
Pj
Pj
Pj
Pj
Pj
Pj
Pj
Pj
Pj
Pj
Pj
Pj
Pj
lq
Tp
Tp
lq
Pj
Pj
Pj
Pj
Pj
Pj
Pj
Pj
Pj
Pj
bS
jB
jB
jB
jB
jB
jB
lq
jB
sI
sI
lq
Pj
"}
(35,1,1) = {"
lq
dH
dH
lq
Pj
Pj
Pj
Pj
Pj
lq
dH
dH
lq
Pj
Pj
Pj
Pj
Pj
Pj
Pj
Pj
Pj
Pj
Pj
lq
WY
WY
lq
sI
sI
sI
Ae
ba
ba
lq
jB
sI
lq
Hl
Pj
"}
(36,1,1) = {"
Tp
kA
kA
dH
Pj
Pj
Pj
Pj
Pj
Tp
kA
kA
dH
Pj
Pj
Pj
Pj
Pj
Pj
Pj
Pj
Pj
Pj
Pj
hb
jB
jB
lq
lq
lq
lq
lq
lq
lq
lq
lq
lq
lq
Pj
Pj
"}
(37,1,1) = {"
Tp
kA
kA
dH
Pj
Pj
Pj
Pj
Pj
Tp
kA
kA
dH
Pj
Pj
Pj
Pj
Pj
Pj
Pj
Pj
Pj
Pj
Pj
lq
WY
WY
lq
Pj
Pj
Pj
Pj
Pj
Pj
Pj
Pj
Pj
Pj
Pj
Pj
"}
(38,1,1) = {"
lq
Tp
Tp
lq
Pj
Pj
Pj
Pj
Pj
lq
Tp
Tp
lq
Pj
Pj
Pj
Pj
Pj
Pj
Pj
Pj
Pj
Pj
Pj
Pj
Pj
Pj
Pj
Pj
Pj
Pj
Pj
Pj
Pj
Pj
Pj
Pj
Pj
Pj
Pj
"}
(39,1,1) = {"
Pj
Pj
Pj
Pj
Pj
Pj
Pj
Pj
Pj
Pj
Pj
Pj
Pj
Pj
Pj
Pj
Pj
Pj
Pj
Pj
Pj
Pj
Pj
Pj
Pj
Pj
Pj
Pj
Pj
Pj
Pj
Pj
Pj
Pj
Pj
Pj
Pj
Pj
Pj
Pj
"}
(40,1,1) = {"
Pj
Pj
Pj
Tp
Tp
Pj
Pj
Pj
Pj
Pj
Pj
Pj
Pj
Pj
Pj
Pj
Pj
Pj
Pj
Pj
Pj
Pj
Pj
Pj
Pj
Pj
Pj
Pj
Pj
Pj
Pj
Pj
Pj
Pj
Pj
Pj
Pj
Pj
Pj
Pj
"}
