//MAP CONVERTED BY dmm2tgm.py THIS HEADER COMMENT PREVENTS RECONVERSION, DO NOT REMOVE
"cC" = (
/obj/machinery/atmospherics/component/unary/engine/biggest{
	dir = 1
	},
/turf/space/basic,
/area/space)
"eJ" = (
/turf/simulated/floor/plating,
/area/space)
"eO" = (
/obj/effect/decal/warning_stripes,
/turf/simulated/floor/plating/indoors,
/area/space)
"fC" = (
/obj/structure/table/rack/shelf,
/obj/structure/window/reinforced{
	dir = 4
	},
/obj/structure/window/reinforced{
	dir = 4
	},
/turf/simulated/floor/plating/indoors,
/area/space)
"fK" = (
/obj/machinery/power/emitter{
	dir = 4
	},
/obj/structure/window/reinforced{
	dir = 1
	},
/turf/simulated/floor/plating/outdoors,
/area/space)
"gl" = (
/obj/structure/closet/secure_closet/engineering_electrical,
/obj/structure/window/reinforced,
/obj/structure/window/reinforced{
	dir = 1
	},
/turf/simulated/floor/plating/indoors,
/area/space)
"gm" = (
/obj/machinery/atmospherics/component/binary/pump/fuel,
/turf/simulated/floor/plating/indoors,
/area/space)
"hq" = (
/obj/effect/decal/warning_stripes,
/obj/effect/decal/warning_stripes,
/turf/simulated/floor/plating/indoors,
/area/space)
"hL" = (
/obj/machinery/door/blast/regular,
/obj/structure/atmospheric_retention_field,
/turf/simulated/floor/plating/indoors,
/area/space)
"kv" = (
/obj/machinery/computer/shuttle_control{
	dir = 4
	},
/obj/structure/window/reinforced{
	dir = 8
	},
/turf/simulated/floor/plating/indoors,
/area/space)
"nP" = (
/obj/effect/decal/warning_stripes,
/obj/structure/window/reinforced{
	dir = 1
	},
/turf/simulated/floor/plating/indoors,
/area/space)
"oa" = (
/obj/machinery/power/apc/east_mount,
/turf/simulated/floor/plating/indoors,
/area/space)
"pl" = (
/obj/structure/table/reinforced,
/turf/simulated/floor/plating/indoors,
/area/space)
"sp" = (
/obj/machinery/mech_recharger,
/turf/simulated/floor/plating/indoors,
/area/space)
"sz" = (
/obj/machinery/computer/shuttle_control,
/turf/space/basic,
/area/space)
"tv" = (
/obj/spawner/window/low_wall/reinforced/full,
/turf/simulated/floor/plating/outdoors,
/area/space)
"ud" = (
/obj/machinery/power/smes,
/obj/structure/window/reinforced,
/turf/simulated/floor/plating/indoors,
/area/space)
"uS" = (
/obj/structure/closet/secure_closet/engineering_welding,
/obj/structure/window/reinforced{
	dir = 1
	},
/obj/structure/window/reinforced,
/turf/simulated/floor/plating/indoors,
/area/space)
"ve" = (
/obj/effect/decal/warning_stripes,
/obj/structure/window/reinforced{
	dir = 4
	},
/turf/simulated/floor/plating/indoors,
/area/space)
"vu" = (
/obj/machinery/artifact_scanpad,
/turf/simulated/floor/plating/outdoors,
/area/space)
"vE" = (
/obj/machinery/air_alarm{
	dir = 4
	},
/obj/machinery/radiocarbon_spectrometer,
/turf/simulated/floor/plating/outdoors,
/area/space)
"xn" = (
/obj/machinery/power/apc/east_mount,
/obj/structure/table/rack/shelf,
/turf/simulated/floor/plating/indoors,
/area/space)
"yi" = (
/obj/machinery/atmospherics/pipe/tank/phoron{
	dir = 8
	},
/turf/simulated/floor/plating/indoors,
/area/space)
"yX" = (
/obj/machinery/atmospherics/portables_connector{
	dir = 4
	},
/turf/simulated/floor/plating/indoors,
/area/space)
"zG" = (
/turf/simulated/floor/plating/indoors,
/area/space)
"zI" = (
/obj/spawner/window/reinforced/full,
/turf/simulated/floor/plating,
/area/space)
"zV" = (
/obj/machinery/artifact_analyser,
/turf/simulated/floor/plating/outdoors,
/area/space)
"Ao" = (
/obj/machinery/door/airlock/external/glass,
/turf/simulated/floor/plating,
/area/space)
"Ap" = (
/obj/machinery/artifact_harvester,
/obj/machinery/air_alarm{
	dir = 8
	},
/turf/simulated/floor/plating/outdoors,
/area/space)
"Au" = (
/obj/structure/window/reinforced{
	dir = 8
	},
/obj/effect/decal/warning_stripes,
/turf/simulated/floor/plating/indoors,
/area/space)
"AT" = (
/turf/space/basic,
/area/space)
"Bd" = (
/obj/effect/decal/warning_stripes,
/turf/space/basic,
/area/space)
"BP" = (
/obj/spawner/window/low_wall/reinforced/full,
/turf/simulated/floor/plating/indoors,
/area/space)
"CN" = (
/obj/structure/table/reinforced,
/turf/simulated/floor/plating/outdoors,
/area/space)
"Fp" = (
/obj/machinery/door/airlock/external/glass,
/turf/simulated/floor/plating/indoors,
/area/space)
"FD" = (
/obj/structure/table/reinforced,
/turf/space/basic,
/area/space)
"Gc" = (
/obj/machinery/atmospherics/component/unary/engine/bigger,
/turf/simulated/floor/plating/indoors,
/area/space)
"GD" = (
/obj/machinery/atmospherics/component/binary/pump/fuel{
	dir = 4
	},
/turf/simulated/floor/plating/indoors,
/area/space)
"Hx" = (
/obj/structure/bed/chair/shuttle{
	dir = 1
	},
/turf/space/basic,
/area/space)
"HH" = (
/obj/structure/window/reinforced{
	dir = 4
	},
/obj/structure/window/reinforced{
	dir = 8
	},
/turf/simulated/floor/plating,
/area/space)
"Ii" = (
/obj/structure/window/reinforced{
	dir = 1
	},
/obj/structure/window/reinforced,
/obj/structure/window/reinforced{
	dir = 4
	},
/obj/machinery/door/window{
	dir = 8
	},
/turf/simulated/floor/plating/indoors,
/area/space)
"Jq" = (
/obj/structure/closet/secure_closet/engineering_welding,
/obj/structure/window/reinforced{
	dir = 1
	},
/turf/simulated/floor/plating/indoors,
/area/space)
"JI" = (
/obj/spawner/window/reinforced/full,
/turf/simulated/floor/plating/indoors,
/area/space)
"Kd" = (
/obj/structure/table/rack/shelf,
/turf/simulated/floor/plating/indoors,
/area/space)
"KY" = (
/obj/machinery/door/airlock/multi_tile/glass{
	dir = 1
	},
/turf/simulated/floor/plating/indoors,
/area/space)
"Lq" = (
/obj/machinery/door/airlock/glass/research,
/turf/simulated/floor/plating/outdoors,
/area/space)
"MA" = (
/turf/simulated/wall/r_wall/prepainted/science,
/area/space)
"MU" = (
/obj/structure/table/reinforced,
/obj/structure/window/reinforced{
	dir = 8
	},
/turf/simulated/floor/plating/indoors,
/area/space)
"MZ" = (
/obj/structure/anomaly_container,
/turf/space/basic,
/area/space)
"NU" = (
/turf/simulated/floor/plating/outdoors,
/area/space)
"Om" = (
/obj/machinery/power/smes,
/turf/simulated/floor/plating/indoors,
/area/space)
"Pz" = (
/obj/machinery/door/window/brigdoor,
/turf/simulated/floor/plating/outdoors,
/area/space)
"Qb" = (
/obj/machinery/door/airlock/external/glass,
/turf/space/basic,
/area/space)
"Qo" = (
/obj/structure/bed/chair/shuttle{
	dir = 8
	},
/turf/simulated/floor/plating/indoors,
/area/space)
"RJ" = (
/obj/machinery/door/airlock/glass/research,
/turf/simulated/floor/plating/indoors,
/area/space)
"Sd" = (
/turf/simulated/wall,
/area/space)
"Sj" = (
/obj/machinery/atmospherics/component/unary/engine/bigger,
/turf/space/basic,
/area/space)
"SP" = (
/obj/structure/window/reinforced{
	dir = 1
	},
/obj/structure/window/reinforced,
/obj/machinery/door/window{
	dir = 8
	},
/obj/structure/window/reinforced{
	dir = 4
	},
/turf/simulated/floor/plating/indoors,
/area/space)
"Ta" = (
/obj/structure/window/reinforced{
	dir = 4
	},
/obj/effect/decal/warning_stripes,
/turf/simulated/floor/plating/indoors,
/area/space)
"TT" = (
/turf/simulated/floor/plating/indoors,
/turf/simulated/wall/r_wall/prepainted/science,
/area/space)
"VX" = (
/obj/structure/table/rack/shelf,
/obj/structure/window/reinforced{
	dir = 4
	},
/turf/simulated/floor/plating/indoors,
/area/space)
"Yi" = (
/obj/structure/window/reinforced{
	dir = 1
	},
/turf/simulated/floor/plating/outdoors,
/area/space)
"Yj" = (
/obj/machinery/atmospherics/pipe/tank/phoron{
	dir = 4
	},
/obj/machinery/atmospherics/pipe/tank/phoron{
	dir = 4
	},
/turf/simulated/floor/plating/indoors,
/area/space)
"Yu" = (
/obj/machinery/atmospherics/component/binary/pump/fuel{
	dir = 8
	},
/turf/simulated/floor/plating/indoors,
/area/space)
"YS" = (
/obj/machinery/atmospherics/pipe/tank/phoron{
	dir = 4
	},
/turf/simulated/floor/plating/indoors,
/area/space)
"YV" = (
/obj/structure/closet/secure_closet/engineering_electrical,
/obj/structure/window/reinforced,
/turf/simulated/floor/plating/indoors,
/area/space)
"Zt" = (
/obj/machinery/door/airlock/glass/research,
/turf/space/basic,
/area/space)
"ZE" = (
/obj/machinery/computer/shuttle_control{
	dir = 4
	},
/turf/simulated/floor/plating/indoors,
/area/space)

(1,1,1) = {"
Sd
Sd
Sd
Sd
zG
zG
Sd
Sd
Sd
Sd
AT
AT
AT
AT
AT
AT
AT
AT
AT
AT
AT
AT
AT
AT
AT
AT
AT
AT
AT
AT
AT
AT
AT
AT
AT
AT
AT
AT
AT
AT
"}
(2,1,1) = {"
Sd
fK
vE
NU
zG
zG
BP
Kd
Kd
Sd
AT
AT
AT
AT
AT
AT
AT
AT
AT
AT
AT
AT
AT
AT
AT
AT
AT
AT
AT
AT
AT
AT
AT
AT
AT
AT
AT
AT
AT
AT
"}
(3,1,1) = {"
Sd
Pz
NU
NU
zG
zG
RJ
zG
zG
Sd
AT
AT
AT
AT
AT
AT
AT
AT
AT
AT
AT
AT
AT
AT
AT
AT
MA
Fp
Fp
MA
MA
MA
AT
MA
MA
MA
AT
AT
AT
AT
"}
(4,1,1) = {"
Sd
Yi
CN
NU
zG
zG
BP
Kd
Kd
Sd
AT
AT
AT
AT
AT
AT
AT
AT
AT
AT
AT
AT
AT
AT
AT
AT
JI
zG
zG
JI
zG
zG
MA
YV
zG
Jq
MA
AT
AT
AT
"}
(5,1,1) = {"
Sd
tv
tv
tv
zG
zG
Sd
Sd
MA
Sd
AT
AT
AT
AT
AT
AT
AT
AT
AT
AT
AT
AT
AT
AT
AT
AT
MA
Fp
Fp
MA
zG
zG
RJ
zG
zG
zG
zG
MA
AT
AT
"}
(6,1,1) = {"
Sd
vu
NU
Lq
zG
zG
KY
MZ
MZ
Sd
AT
AT
AT
AT
AT
MA
VX
VX
fC
MA
AT
AT
AT
AT
AT
AT
AT
AT
AT
AT
AT
AT
MA
eO
eO
eO
Ii
MA
Sj
AT
"}
(7,1,1) = {"
Sd
zV
Ap
BP
zG
zG
zG
MZ
MZ
Sd
AT
AT
AT
AT
AT
JI
ZE
pl
ZE
JI
AT
AT
AT
AT
AT
AT
zG
zG
zG
zG
zG
zG
zG
MA
MA
MA
MA
MA
zG
AT
"}
(8,1,1) = {"
Sd
Sd
Sd
Sd
zG
zG
Sd
Sd
Sd
Sd
AT
AT
AT
AT
AT
Zt
zG
oa
zG
Zt
AT
AT
AT
AT
AT
AT
zG
zG
zG
zG
zG
zG
zG
MA
eO
zG
sp
sp
hL
AT
"}
(9,1,1) = {"
AT
AT
AT
AT
AT
AT
AT
AT
AT
AT
AT
AT
AT
AT
AT
MA
Om
MA
Om
MA
AT
AT
AT
AT
AT
AT
AT
AT
AT
AT
AT
zG
zG
MA
eO
zG
sp
sp
hL
AT
"}
(10,1,1) = {"
AT
AT
AT
AT
AT
AT
AT
AT
AT
AT
AT
AT
AT
AT
AT
MA
MA
Kd
MA
MA
AT
AT
AT
AT
AT
AT
AT
AT
AT
AT
AT
zG
zG
RJ
zG
zG
nP
MA
MA
cC
"}
(11,1,1) = {"
AT
AT
AT
AT
AT
AT
AT
AT
AT
AT
AT
AT
AT
AT
AT
AT
AT
AT
AT
AT
AT
AT
AT
AT
AT
AT
AT
AT
AT
AT
AT
zG
zG
JI
eO
zG
eO
zG
TT
AT
"}
(12,1,1) = {"
AT
AT
AT
AT
AT
AT
AT
AT
AT
AT
AT
AT
AT
AT
AT
AT
AT
AT
AT
AT
Qb
Qb
AT
AT
AT
AT
AT
AT
AT
AT
AT
zG
zG
RJ
zG
zG
ve
MA
TT
AT
"}
(13,1,1) = {"
AT
AT
AT
AT
AT
AT
AT
AT
MA
zI
zI
MA
AT
AT
AT
AT
AT
AT
AT
AT
AT
AT
AT
AT
AT
AT
AT
AT
AT
AT
AT
zG
zG
MA
eO
zG
sp
sp
hL
AT
"}
(14,1,1) = {"
AT
AT
AT
AT
AT
AT
AT
AT
zI
eJ
eJ
Ao
AT
AT
AT
AT
AT
AT
AT
AT
AT
AT
AT
AT
AT
AT
zG
zG
zG
zG
zG
zG
zG
MA
eO
zG
sp
sp
hL
AT
"}
(15,1,1) = {"
AT
AT
AT
AT
AT
AT
AT
AT
zI
eJ
eJ
Ao
AT
AT
AT
AT
AT
AT
AT
AT
Qb
Qb
AT
AT
AT
AT
zG
zG
zG
zG
zG
zG
zG
MA
MA
MA
MA
MA
Gc
AT
"}
(16,1,1) = {"
AT
AT
AT
AT
AT
Bd
AT
AT
MA
Ao
Ao
MA
AT
AT
AT
AT
AT
AT
AT
AT
AT
AT
AT
AT
AT
AT
AT
AT
AT
AT
AT
AT
MA
zG
YS
Yj
Yu
MA
AT
AT
"}
(17,1,1) = {"
AT
AT
AT
AT
AT
AT
sz
AT
AT
AT
AT
AT
AT
AT
AT
AT
AT
AT
AT
AT
AT
AT
AT
AT
AT
AT
MA
Fp
Fp
MA
zG
zG
RJ
gm
zG
zG
zG
MA
AT
AT
"}
(18,1,1) = {"
AT
AT
AT
AT
AT
AT
FD
AT
AT
AT
AT
AT
AT
AT
AT
AT
AT
AT
AT
AT
AT
AT
AT
AT
AT
AT
JI
zG
zG
JI
zG
zG
MA
zG
yi
yi
MA
AT
AT
AT
"}
(19,1,1) = {"
AT
AT
AT
AT
AT
AT
sz
Hx
AT
AT
AT
AT
AT
AT
AT
AT
AT
AT
AT
AT
AT
AT
AT
AT
AT
AT
MA
Fp
Fp
MA
MA
MA
AT
MA
MA
MA
AT
AT
AT
AT
"}
(20,1,1) = {"
AT
AT
AT
AT
AT
AT
AT
AT
AT
AT
AT
AT
AT
AT
AT
AT
AT
AT
AT
AT
AT
AT
AT
AT
AT
AT
AT
AT
AT
AT
AT
AT
AT
AT
AT
AT
AT
AT
AT
AT
"}
(21,1,1) = {"
AT
AT
AT
AT
AT
AT
AT
AT
AT
AT
AT
AT
AT
AT
AT
AT
AT
AT
AT
AT
AT
AT
AT
AT
AT
AT
AT
AT
AT
AT
AT
AT
AT
AT
AT
AT
AT
AT
AT
AT
"}
(22,1,1) = {"
AT
AT
AT
AT
zG
AT
AT
AT
AT
AT
AT
AT
AT
AT
AT
AT
AT
AT
AT
AT
AT
AT
AT
AT
AT
AT
AT
AT
AT
AT
AT
AT
AT
AT
AT
AT
AT
AT
AT
AT
"}
(23,1,1) = {"
AT
AT
zG
zG
zG
zG
zG
zG
AT
AT
AT
AT
AT
AT
AT
AT
AT
AT
AT
AT
AT
AT
AT
AT
AT
AT
AT
AT
AT
AT
AT
AT
AT
AT
AT
AT
AT
AT
AT
AT
"}
(24,1,1) = {"
zG
zG
zG
zG
zG
zG
zG
zG
zG
zG
zG
eJ
Sj
AT
AT
AT
AT
AT
AT
AT
AT
AT
AT
AT
AT
AT
AT
AT
AT
AT
AT
AT
AT
AT
MA
MA
MA
MA
Sj
AT
"}
(25,1,1) = {"
zG
zG
zG
zG
zG
zG
zG
zG
zG
zG
zG
zG
AT
AT
AT
AT
AT
AT
AT
AT
AT
AT
AT
AT
AT
AT
AT
AT
AT
AT
AT
AT
AT
AT
MA
zG
eO
MA
AT
AT
"}
(26,1,1) = {"
zG
zG
zG
zG
zG
zG
zG
zG
MA
zG
zG
MA
AT
AT
AT
AT
AT
AT
AT
AT
AT
AT
AT
AT
AT
AT
AT
AT
AT
AT
AT
AT
AT
AT
MA
zG
hq
eO
MA
Sj
"}
(27,1,1) = {"
zG
zG
zG
zG
zG
zG
zG
zG
KY
sp
sp
hL
AT
AT
AT
AT
AT
AT
AT
AT
AT
AT
AT
AT
AT
AT
AT
AT
AT
AT
AT
AT
AT
AT
MA
zG
Ta
Ta
MA
AT
"}
(28,1,1) = {"
zG
zG
zG
zG
zG
zG
zG
zG
zG
sp
sp
hL
AT
AT
AT
AT
AT
AT
AT
AT
AT
AT
AT
AT
AT
AT
AT
AT
AT
AT
AT
AT
AT
AT
MA
zG
sp
sp
hL
AT
"}
(29,1,1) = {"
zG
zG
zG
zG
zG
zG
zG
zG
MA
zG
zG
MA
AT
AT
AT
AT
AT
AT
AT
AT
AT
AT
AT
AT
JI
kv
MU
kv
JI
zG
zG
zG
zG
zG
RJ
zG
sp
sp
hL
AT
"}
(30,1,1) = {"
zG
zG
zG
zG
zG
zG
zG
zG
zG
zG
zG
zG
Sj
AT
AT
AT
AT
AT
AT
AT
AT
AT
AT
AT
Zt
Qo
zG
Qo
Zt
zG
zG
zG
zG
zG
JI
zG
HH
HH
MA
AT
"}
(31,1,1) = {"
zG
zG
zG
zG
zG
zG
zG
zG
zG
zG
zG
eJ
AT
AT
AT
AT
AT
AT
AT
AT
AT
AT
AT
AT
MA
ud
zG
xn
MA
zG
zG
zG
zG
zG
RJ
zG
sp
sp
hL
AT
"}
(32,1,1) = {"
AT
AT
zG
zG
zG
zG
zG
zG
zG
AT
AT
AT
AT
AT
AT
AT
AT
AT
AT
AT
AT
AT
AT
AT
MA
MA
Zt
MA
MA
MA
MA
MA
RJ
MA
MA
zG
sp
sp
hL
AT
"}
(33,1,1) = {"
AT
AT
AT
AT
zG
AT
AT
AT
AT
AT
AT
AT
AT
AT
AT
AT
AT
AT
AT
AT
AT
AT
AT
AT
AT
AT
AT
MA
gl
Om
uS
yX
GD
Yu
MA
zG
Au
Au
MA
Sj
"}
(34,1,1) = {"
AT
AT
AT
AT
AT
AT
AT
AT
AT
AT
AT
AT
AT
MA
zI
zI
MA
AT
AT
AT
AT
AT
AT
AT
AT
AT
AT
RJ
zG
zG
zG
zG
zG
zG
MA
zG
eO
eO
MA
AT
"}
(35,1,1) = {"
MA
Ao
Ao
MA
AT
AT
AT
AT
AT
MA
Ao
Ao
MA
AT
AT
AT
AT
AT
AT
AT
AT
AT
AT
AT
MA
Fp
Fp
MA
eO
eO
eO
SP
yi
yi
MA
zG
eO
MA
Sj
AT
"}
(36,1,1) = {"
zI
eJ
eJ
Ao
AT
AT
AT
AT
AT
zI
eJ
eJ
Ao
AT
AT
AT
AT
AT
AT
AT
AT
AT
AT
AT
JI
zG
zG
MA
MA
MA
MA
MA
MA
MA
MA
MA
MA
MA
AT
AT
"}
(37,1,1) = {"
zI
eJ
eJ
Ao
AT
AT
AT
AT
AT
zI
eJ
eJ
Ao
AT
AT
AT
AT
AT
AT
AT
AT
AT
AT
AT
MA
Fp
Fp
MA
AT
AT
AT
AT
AT
AT
AT
AT
AT
AT
AT
AT
"}
(38,1,1) = {"
MA
zI
zI
MA
AT
AT
AT
AT
AT
MA
zI
zI
MA
AT
AT
AT
AT
AT
AT
AT
AT
AT
AT
AT
AT
AT
AT
AT
AT
AT
AT
AT
AT
AT
AT
AT
AT
AT
AT
AT
"}
(39,1,1) = {"
AT
AT
AT
AT
AT
AT
AT
AT
AT
AT
AT
AT
AT
AT
AT
AT
AT
AT
AT
AT
AT
AT
AT
AT
AT
AT
AT
AT
AT
AT
AT
AT
AT
AT
AT
AT
AT
AT
AT
AT
"}
(40,1,1) = {"
AT
AT
AT
zI
zI
AT
AT
AT
AT
AT
AT
AT
AT
AT
AT
AT
AT
AT
AT
AT
AT
AT
AT
AT
AT
AT
AT
AT
AT
AT
AT
AT
AT
AT
AT
AT
AT
AT
AT
AT
"}
