//MAP CONVERTED BY dmm2tgm.py THIS HEADER COMMENT PREVENTS RECONVERSION, DO NOT REMOVE
"aU" = (
/obj/structure/closet/secure_closet/engineering_welding,
/obj/structure/window/reinforced{
	dir = 1
	},
/turf/simulated/floor/plating/indoors,
/area/space)
"bR" = (
/obj/machinery/door/airlock/glass/research,
/turf/simulated/floor/plating/indoors,
/area/space)
"ee" = (
/obj/machinery/artifact_analyser,
/turf/simulated/floor/plating/outdoors,
/area/space)
"ew" = (
/obj/machinery/atmospherics/component/unary/engine/bigger,
/turf/simulated/floor/plating/indoors,
/area/space)
"eS" = (
/obj/structure/table/rack/shelf,
/obj/structure/window/reinforced{
	dir = 4
	},
/obj/structure/window/reinforced{
	dir = 4
	},
/turf/simulated/floor/plating/indoors,
/area/space)
"ff" = (
/obj/machinery/door/airlock/multi_tile/glass{
	dir = 1
	},
/turf/simulated/floor/plating/indoors,
/area/space)
"gx" = (
/obj/machinery/artifact_scanpad,
/turf/simulated/floor/plating/outdoors,
/area/space)
"gW" = (
/obj/machinery/atmospherics/component/binary/pump/fuel{
	dir = 8
	},
/turf/simulated/floor/plating/indoors,
/area/space)
"iF" = (
/obj/effect/decal/warning_stripes,
/obj/effect/decal/warning_stripes,
/turf/simulated/floor/plating/indoors,
/area/space)
"iT" = (
/turf/simulated/floor/plating/indoors,
/area/space)
"jC" = (
/turf/simulated/wall/r_wall/prepainted/science,
/area/space)
"ls" = (
/obj/structure/anomaly_container,
/turf/space/basic,
/area/space)
"mA" = (
/obj/machinery/door/airlock/glass/research,
/turf/simulated/floor/plating/outdoors,
/area/space)
"nA" = (
/obj/machinery/mech_recharger,
/turf/simulated/floor/plating/indoors,
/area/space)
"pz" = (
/obj/machinery/power/emitter{
	dir = 4
	},
/obj/structure/window/reinforced{
	dir = 1
	},
/turf/simulated/floor/plating/outdoors,
/area/space)
"qv" = (
/obj/effect/decal/warning_stripes,
/obj/structure/window/reinforced{
	dir = 4
	},
/turf/simulated/floor/plating/indoors,
/area/space)
"qK" = (
/obj/effect/decal/warning_stripes,
/turf/simulated/floor/plating/indoors,
/area/space)
"rD" = (
/obj/structure/window/reinforced{
	dir = 1
	},
/obj/structure/window/reinforced,
/obj/structure/window/reinforced{
	dir = 4
	},
/obj/machinery/door/window{
	dir = 8
	},
/turf/simulated/floor/plating/indoors,
/area/space)
"to" = (
/obj/machinery/air_alarm{
	dir = 4
	},
/obj/machinery/radiocarbon_spectrometer,
/turf/simulated/floor/plating/outdoors,
/area/space)
"tR" = (
/turf/simulated/wall,
/area/space)
"tS" = (
/obj/structure/table/rack/shelf,
/turf/simulated/floor/plating/indoors,
/area/space)
"vR" = (
/obj/spawner/window/reinforced/full,
/turf/simulated/floor/plating/indoors,
/area/space)
"vX" = (
/obj/effect/decal/warning_stripes,
/turf/space/basic,
/area/space)
"wa" = (
/obj/machinery/atmospherics/component/binary/pump/fuel,
/turf/simulated/floor/plating/indoors,
/area/space)
"wY" = (
/obj/machinery/door/airlock/external/glass,
/turf/simulated/floor/plating/indoors,
/area/space)
"yu" = (
/obj/machinery/atmospherics/component/binary/pump/fuel{
	dir = 4
	},
/turf/simulated/floor/plating/indoors,
/area/space)
"AC" = (
/obj/machinery/atmospherics/component/unary/engine/bigger,
/turf/space/basic,
/area/space)
"AT" = (
/obj/structure/table/rack/shelf,
/obj/structure/window/reinforced{
	dir = 4
	},
/turf/simulated/floor/plating/indoors,
/area/space)
"AV" = (
/obj/structure/window/reinforced{
	dir = 4
	},
/obj/effect/decal/warning_stripes,
/turf/simulated/floor/plating/indoors,
/area/space)
"Do" = (
/turf/simulated/floor/plating,
/area/space)
"ET" = (
/obj/machinery/computer/shuttle_control{
	dir = 4
	},
/turf/simulated/floor/plating/indoors,
/area/space)
"Fj" = (
/obj/structure/bed/chair/shuttle{
	dir = 1
	},
/turf/space/basic,
/area/space)
"FJ" = (
/obj/spawner/window/low_wall/reinforced/full,
/turf/simulated/floor/plating/indoors,
/area/space)
"Gg" = (
/turf/simulated/floor/plating/outdoors,
/area/space)
"GX" = (
/obj/structure/window/reinforced{
	dir = 4
	},
/obj/structure/window/reinforced{
	dir = 8
	},
/turf/simulated/floor/plating,
/area/space)
"HG" = (
/obj/structure/window/reinforced{
	dir = 1
	},
/turf/simulated/floor/plating/outdoors,
/area/space)
"HI" = (
/obj/machinery/atmospherics/pipe/tank/phoron{
	dir = 4
	},
/obj/machinery/atmospherics/pipe/tank/phoron{
	dir = 4
	},
/turf/simulated/floor/plating/indoors,
/area/space)
"HN" = (
/obj/machinery/door/airlock/glass/research,
/turf/space/basic,
/area/space)
"Iv" = (
/obj/machinery/power/apc/east_mount,
/turf/simulated/floor/plating/indoors,
/area/space)
"ID" = (
/obj/machinery/door/window/brigdoor,
/turf/simulated/floor/plating/outdoors,
/area/space)
"IG" = (
/turf/simulated/floor/plating/indoors,
/turf/simulated/wall/r_wall/prepainted/science,
/area/space)
"Jw" = (
/obj/effect/decal/warning_stripes,
/obj/structure/window/reinforced{
	dir = 1
	},
/turf/simulated/floor/plating/indoors,
/area/space)
"JQ" = (
/obj/structure/window/reinforced{
	dir = 1
	},
/obj/structure/window/reinforced,
/obj/machinery/door/window{
	dir = 4
	},
/obj/structure/window/reinforced{
	dir = 8
	},
/turf/simulated/floor/plating/indoors,
/area/space)
"Lx" = (
/obj/machinery/atmospherics/pipe/tank/phoron{
	dir = 4
	},
/turf/simulated/floor/plating/indoors,
/area/space)
"LZ" = (
/obj/structure/window/reinforced{
	dir = 8
	},
/obj/effect/decal/warning_stripes,
/turf/simulated/floor/plating/indoors,
/area/space)
"MK" = (
/obj/machinery/door/blast/regular,
/obj/structure/atmospheric_retention_field,
/turf/simulated/floor/plating/indoors,
/area/space)
"MX" = (
/obj/machinery/atmospherics/component/unary/engine/biggest{
	dir = 1
	},
/turf/space/basic,
/area/space)
"NE" = (
/obj/machinery/door/airlock/external/glass,
/turf/simulated/floor/plating,
/area/space)
"Oc" = (
/obj/structure/table/reinforced,
/turf/space/basic,
/area/space)
"Ol" = (
/obj/structure/table/reinforced,
/turf/simulated/floor/plating/indoors,
/area/space)
"Ox" = (
/obj/spawner/window/reinforced/full,
/turf/simulated/floor/plating,
/area/space)
"QK" = (
/obj/structure/table/reinforced,
/turf/simulated/floor/plating/outdoors,
/area/space)
"TK" = (
/obj/structure/closet/secure_closet/engineering_electrical,
/obj/structure/window/reinforced,
/turf/simulated/floor/plating/indoors,
/area/space)
"TX" = (
/turf/space/basic,
/area/space)
"Uy" = (
/obj/machinery/atmospherics/portables_connector{
	dir = 4
	},
/turf/simulated/floor/plating/indoors,
/area/space)
"UT" = (
/obj/machinery/power/smes,
/turf/simulated/floor/plating/indoors,
/area/space)
"VL" = (
/obj/machinery/artifact_harvester,
/obj/machinery/air_alarm{
	dir = 8
	},
/turf/simulated/floor/plating/outdoors,
/area/space)
"Ws" = (
/obj/machinery/computer/shuttle_control,
/turf/space/basic,
/area/space)
"YD" = (
/obj/machinery/atmospherics/pipe/tank/phoron{
	dir = 8
	},
/turf/simulated/floor/plating/indoors,
/area/space)
"Zd" = (
/obj/spawner/window/low_wall/reinforced/full,
/turf/simulated/floor/plating/outdoors,
/area/space)

(1,1,1) = {"
tR
tR
tR
tR
iT
iT
tR
tR
tR
tR
TX
TX
TX
TX
TX
TX
TX
TX
TX
TX
TX
TX
TX
TX
TX
TX
TX
TX
TX
TX
TX
TX
TX
TX
TX
TX
TX
TX
TX
TX
"}
(2,1,1) = {"
tR
pz
to
Gg
iT
iT
FJ
tS
tS
tR
TX
TX
TX
TX
TX
TX
TX
TX
TX
TX
TX
TX
TX
TX
TX
TX
TX
TX
TX
TX
TX
TX
TX
TX
TX
TX
TX
TX
TX
TX
"}
(3,1,1) = {"
tR
ID
Gg
Gg
iT
iT
bR
iT
iT
tR
TX
TX
TX
TX
TX
TX
TX
TX
TX
TX
TX
TX
TX
TX
TX
TX
jC
wY
wY
jC
jC
jC
TX
jC
jC
jC
TX
TX
TX
TX
"}
(4,1,1) = {"
tR
HG
QK
Gg
iT
iT
FJ
tS
tS
tR
TX
TX
TX
TX
TX
TX
TX
TX
TX
TX
TX
TX
TX
TX
TX
TX
vR
iT
iT
vR
iT
iT
jC
TK
iT
aU
jC
TX
TX
TX
"}
(5,1,1) = {"
tR
Zd
Zd
Zd
iT
iT
tR
tR
jC
tR
TX
TX
TX
TX
TX
TX
TX
TX
TX
TX
TX
TX
TX
TX
TX
TX
jC
wY
wY
jC
iT
iT
bR
iT
iT
iT
iT
jC
TX
TX
"}
(6,1,1) = {"
tR
gx
Gg
mA
iT
iT
ff
ls
ls
tR
TX
TX
TX
TX
TX
jC
AT
AT
eS
jC
TX
TX
TX
TX
TX
TX
TX
TX
TX
TX
TX
TX
jC
qK
qK
qK
rD
jC
AC
TX
"}
(7,1,1) = {"
tR
ee
VL
FJ
iT
iT
iT
ls
ls
tR
TX
TX
TX
TX
TX
vR
ET
Ol
ET
vR
TX
TX
TX
TX
TX
TX
iT
iT
iT
iT
iT
iT
iT
jC
jC
jC
jC
jC
iT
TX
"}
(8,1,1) = {"
tR
tR
tR
tR
iT
iT
tR
tR
tR
tR
TX
TX
TX
TX
TX
HN
iT
Iv
iT
HN
TX
TX
TX
TX
TX
TX
iT
iT
iT
iT
iT
iT
iT
jC
qK
iT
nA
nA
MK
TX
"}
(9,1,1) = {"
TX
TX
TX
TX
TX
TX
TX
TX
TX
TX
TX
TX
TX
TX
TX
jC
UT
jC
UT
jC
TX
TX
TX
TX
TX
TX
TX
TX
TX
TX
TX
iT
iT
jC
qK
iT
nA
nA
MK
TX
"}
(10,1,1) = {"
TX
TX
TX
TX
TX
TX
TX
TX
TX
TX
TX
TX
TX
TX
TX
jC
jC
tS
jC
jC
TX
TX
TX
TX
TX
TX
TX
TX
TX
TX
TX
iT
iT
bR
iT
iT
Jw
jC
jC
MX
"}
(11,1,1) = {"
TX
TX
TX
TX
TX
TX
TX
TX
TX
TX
TX
TX
TX
TX
TX
TX
TX
TX
TX
TX
TX
TX
TX
TX
TX
TX
TX
TX
TX
TX
TX
iT
iT
vR
qK
iT
qK
iT
IG
TX
"}
(12,1,1) = {"
TX
TX
TX
TX
TX
TX
TX
TX
TX
TX
TX
TX
TX
TX
TX
TX
TX
TX
TX
TX
TX
TX
TX
TX
TX
TX
TX
TX
TX
TX
TX
iT
iT
bR
iT
iT
qv
jC
IG
TX
"}
(13,1,1) = {"
TX
TX
TX
TX
TX
TX
TX
TX
TX
TX
TX
TX
TX
TX
TX
TX
TX
TX
TX
TX
TX
TX
TX
TX
TX
TX
TX
TX
TX
TX
TX
iT
iT
jC
qK
iT
nA
nA
MK
TX
"}
(14,1,1) = {"
TX
TX
TX
TX
TX
TX
TX
TX
TX
TX
TX
TX
TX
TX
TX
TX
TX
TX
TX
TX
TX
TX
TX
TX
TX
TX
iT
iT
iT
iT
iT
iT
iT
jC
qK
iT
nA
nA
MK
TX
"}
(15,1,1) = {"
TX
TX
TX
TX
TX
TX
TX
TX
TX
TX
TX
TX
TX
TX
TX
TX
TX
TX
TX
TX
TX
TX
TX
TX
TX
TX
iT
iT
iT
iT
iT
iT
iT
jC
jC
jC
jC
jC
ew
TX
"}
(16,1,1) = {"
TX
TX
TX
TX
TX
vX
TX
TX
TX
TX
TX
TX
TX
TX
TX
TX
TX
TX
TX
TX
TX
TX
TX
TX
TX
TX
TX
TX
TX
TX
TX
TX
jC
iT
Lx
HI
gW
jC
TX
TX
"}
(17,1,1) = {"
TX
TX
TX
TX
TX
TX
Ws
TX
TX
TX
TX
TX
TX
TX
jC
Ox
Ox
jC
TX
TX
TX
TX
TX
TX
TX
TX
jC
wY
wY
jC
iT
iT
bR
wa
iT
iT
iT
jC
TX
TX
"}
(18,1,1) = {"
TX
TX
TX
TX
TX
TX
Oc
TX
TX
TX
TX
TX
TX
TX
Ox
Do
Do
NE
TX
TX
TX
TX
TX
TX
TX
TX
vR
iT
iT
vR
iT
iT
jC
iT
YD
YD
jC
TX
TX
TX
"}
(19,1,1) = {"
TX
TX
TX
TX
TX
TX
Ws
Fj
TX
TX
TX
TX
TX
TX
Ox
Do
Do
NE
TX
TX
TX
TX
TX
TX
TX
TX
jC
wY
wY
jC
jC
jC
TX
jC
jC
jC
TX
TX
TX
TX
"}
(20,1,1) = {"
TX
TX
TX
TX
TX
TX
TX
TX
TX
TX
TX
TX
TX
TX
jC
NE
NE
jC
TX
TX
TX
TX
TX
TX
TX
TX
TX
TX
TX
TX
TX
TX
TX
TX
TX
TX
TX
TX
TX
TX
"}
(21,1,1) = {"
TX
TX
TX
TX
TX
TX
TX
TX
TX
TX
TX
TX
TX
TX
TX
TX
TX
TX
TX
TX
TX
TX
TX
TX
TX
TX
TX
TX
TX
TX
TX
TX
TX
TX
TX
TX
TX
TX
TX
TX
"}
(22,1,1) = {"
TX
TX
TX
TX
iT
TX
TX
TX
TX
TX
TX
TX
TX
TX
TX
TX
TX
TX
TX
TX
TX
TX
TX
TX
TX
TX
TX
TX
TX
TX
TX
TX
TX
TX
TX
TX
TX
TX
TX
TX
"}
(23,1,1) = {"
TX
TX
iT
iT
iT
iT
iT
iT
TX
TX
TX
TX
TX
TX
TX
TX
TX
TX
TX
TX
TX
TX
TX
TX
TX
TX
TX
TX
TX
TX
TX
TX
TX
TX
TX
TX
TX
TX
TX
TX
"}
(24,1,1) = {"
iT
iT
iT
iT
iT
iT
iT
iT
iT
iT
iT
Do
AC
TX
TX
TX
TX
TX
TX
jC
AT
AT
eS
jC
TX
TX
TX
TX
TX
jC
jC
jC
jC
jC
jC
jC
jC
jC
AC
TX
"}
(25,1,1) = {"
iT
iT
iT
iT
iT
iT
iT
iT
iT
iT
iT
iT
TX
TX
TX
TX
TX
TX
TX
vR
ET
Ol
ET
vR
TX
TX
TX
TX
TX
jC
qK
qK
qK
JQ
jC
iT
qK
jC
TX
TX
"}
(26,1,1) = {"
iT
iT
iT
iT
iT
iT
iT
iT
jC
iT
iT
jC
TX
TX
TX
TX
TX
TX
TX
HN
iT
Iv
iT
HN
TX
TX
TX
TX
TX
jC
iT
iT
iT
iT
jC
iT
iF
qK
jC
AC
"}
(27,1,1) = {"
iT
iT
iT
iT
iT
iT
iT
iT
ff
nA
nA
MK
TX
TX
TX
TX
TX
TX
TX
jC
UT
jC
UT
jC
TX
TX
TX
TX
TX
jC
qK
TK
iT
aU
jC
iT
AV
AV
jC
TX
"}
(28,1,1) = {"
iT
iT
iT
iT
iT
iT
iT
iT
iT
nA
nA
MK
TX
TX
TX
TX
TX
TX
TX
jC
jC
tS
jC
jC
TX
TX
TX
TX
TX
jC
jC
jC
bR
jC
jC
iT
nA
nA
MK
TX
"}
(29,1,1) = {"
iT
iT
iT
iT
iT
iT
iT
iT
jC
iT
iT
jC
TX
TX
TX
TX
TX
TX
TX
TX
TX
TX
TX
TX
TX
TX
TX
TX
TX
iT
iT
iT
iT
iT
bR
iT
nA
nA
MK
TX
"}
(30,1,1) = {"
iT
iT
iT
iT
iT
iT
iT
iT
iT
iT
iT
iT
AC
TX
TX
TX
TX
TX
TX
TX
TX
TX
TX
TX
TX
TX
TX
TX
TX
iT
iT
iT
iT
iT
vR
iT
GX
GX
jC
TX
"}
(31,1,1) = {"
iT
iT
iT
iT
iT
iT
iT
iT
iT
iT
iT
Do
TX
TX
TX
TX
TX
TX
TX
TX
TX
TX
TX
TX
TX
TX
TX
TX
TX
iT
iT
iT
iT
iT
bR
iT
nA
nA
MK
TX
"}
(32,1,1) = {"
TX
TX
iT
iT
iT
iT
iT
iT
iT
TX
TX
TX
TX
TX
TX
TX
TX
TX
TX
TX
TX
TX
TX
TX
TX
TX
TX
TX
TX
TX
jC
jC
bR
jC
jC
iT
nA
nA
MK
TX
"}
(33,1,1) = {"
TX
TX
TX
TX
iT
TX
TX
TX
TX
TX
TX
TX
TX
TX
TX
TX
TX
TX
TX
TX
TX
TX
TX
TX
TX
TX
TX
TX
TX
TX
jC
Uy
yu
gW
jC
iT
LZ
LZ
jC
AC
"}
(34,1,1) = {"
TX
TX
TX
TX
TX
TX
TX
TX
TX
TX
TX
TX
TX
jC
Ox
Ox
jC
TX
TX
TX
TX
TX
TX
TX
TX
TX
TX
TX
TX
TX
jC
iT
iT
iT
jC
iT
qK
qK
jC
TX
"}
(35,1,1) = {"
jC
NE
NE
jC
TX
TX
TX
TX
TX
jC
NE
NE
jC
TX
TX
TX
TX
TX
TX
TX
TX
TX
TX
TX
TX
TX
TX
TX
TX
TX
jC
iT
YD
YD
jC
iT
qK
jC
AC
TX
"}
(36,1,1) = {"
Ox
Do
Do
NE
TX
TX
TX
TX
TX
Ox
Do
Do
NE
TX
TX
TX
TX
TX
TX
TX
TX
TX
TX
TX
TX
TX
TX
TX
TX
TX
jC
jC
jC
jC
jC
jC
jC
jC
TX
TX
"}
(37,1,1) = {"
Ox
Do
Do
NE
TX
TX
TX
TX
TX
Ox
Do
Do
NE
TX
TX
TX
TX
TX
TX
TX
TX
TX
TX
TX
TX
TX
TX
TX
TX
TX
TX
TX
TX
TX
TX
TX
TX
TX
TX
TX
"}
(38,1,1) = {"
jC
Ox
Ox
jC
TX
TX
TX
TX
TX
jC
Ox
Ox
jC
TX
TX
TX
TX
TX
TX
TX
TX
TX
TX
TX
TX
TX
TX
TX
TX
TX
TX
TX
TX
TX
TX
TX
TX
TX
TX
TX
"}
(39,1,1) = {"
TX
TX
TX
TX
TX
TX
TX
TX
TX
TX
TX
TX
TX
TX
TX
TX
TX
TX
TX
TX
TX
TX
TX
TX
TX
TX
TX
TX
TX
TX
TX
TX
TX
TX
TX
TX
TX
TX
TX
TX
"}
(40,1,1) = {"
TX
TX
TX
Ox
Ox
TX
TX
TX
TX
TX
TX
TX
TX
TX
TX
TX
TX
TX
TX
TX
TX
TX
TX
TX
TX
TX
TX
TX
TX
TX
TX
TX
TX
TX
TX
TX
TX
TX
TX
TX
"}
