//MAP CONVERTED BY dmm2tgm.py THIS HEADER COMMENT PREVENTS RECONVERSION, DO NOT REMOVE
"av" = (
/obj/spawner/window/reinforced/full,
/turf/simulated/floor/plating/indoors,
/area/space)
"bl" = (
/obj/structure/window/reinforced{
	dir = 4
	},
/obj/structure/window/reinforced{
	dir = 8
	},
/turf/simulated/floor/plating,
/area/space)
"bx" = (
/turf/simulated/wall,
/area/space)
"ck" = (
/turf/simulated/floor/plating,
/area/space)
"fj" = (
/turf/simulated/floor/plating/indoors,
/turf/simulated/wall/r_wall/prepainted/science,
/area/space)
"fX" = (
/obj/structure/closet/secure_closet/engineering_welding,
/obj/structure/window/reinforced{
	dir = 1
	},
/turf/simulated/floor/plating/indoors,
/area/space)
"hC" = (
/obj/effect/decal/warning_stripes,
/obj/effect/decal/warning_stripes,
/turf/simulated/floor/plating/indoors,
/area/space)
"hX" = (
/obj/structure/window/reinforced{
	dir = 8
	},
/obj/effect/decal/warning_stripes,
/turf/simulated/floor/plating/indoors,
/area/space)
"iF" = (
/obj/machinery/atmospherics/pipe/tank/phoron{
	dir = 4
	},
/turf/simulated/floor/plating/indoors,
/area/space)
"ju" = (
/obj/structure/table/reinforced,
/turf/space/basic,
/area/space)
"jS" = (
/obj/machinery/mech_recharger,
/turf/simulated/floor/plating/indoors,
/area/space)
"nE" = (
/obj/machinery/door/airlock/glass/research,
/turf/simulated/floor/plating/indoors,
/area/space)
"nR" = (
/obj/machinery/computer/shuttle_control,
/turf/space/basic,
/area/space)
"oO" = (
/obj/machinery/power/emitter{
	dir = 4
	},
/obj/structure/window/reinforced{
	dir = 1
	},
/turf/simulated/floor/plating/outdoors,
/area/space)
"qk" = (
/obj/structure/table/rack/shelf,
/turf/simulated/floor/plating/indoors,
/area/space)
"qQ" = (
/obj/effect/decal/warning_stripes,
/turf/simulated/floor/plating/indoors,
/area/space)
"sL" = (
/obj/structure/bed/chair/shuttle{
	dir = 1
	},
/turf/space/basic,
/area/space)
"sT" = (
/obj/machinery/door/airlock/multi_tile/glass{
	dir = 1
	},
/turf/simulated/floor/plating/indoors,
/area/space)
"tr" = (
/obj/machinery/door/airlock/glass/research,
/turf/simulated/floor/plating/outdoors,
/area/space)
"uG" = (
/obj/machinery/door/airlock/external/glass,
/turf/simulated/floor/plating/indoors,
/area/space)
"va" = (
/obj/machinery/atmospherics/pipe/tank/phoron{
	dir = 4
	},
/obj/machinery/atmospherics/pipe/tank/phoron{
	dir = 4
	},
/turf/simulated/floor/plating/indoors,
/area/space)
"vs" = (
/obj/structure/window/reinforced{
	dir = 4
	},
/obj/effect/decal/warning_stripes,
/turf/simulated/floor/plating/indoors,
/area/space)
"vO" = (
/obj/structure/table/rack/shelf,
/obj/structure/window/reinforced{
	dir = 4
	},
/turf/simulated/floor/plating/indoors,
/area/space)
"wy" = (
/obj/machinery/door/blast/regular,
/obj/structure/atmospheric_retention_field,
/turf/simulated/floor/plating/indoors,
/area/space)
"yZ" = (
/obj/machinery/atmospherics/component/unary/engine/biggest{
	dir = 1
	},
/turf/space/basic,
/area/space)
"zg" = (
/obj/structure/anomaly_container,
/turf/space/basic,
/area/space)
"zX" = (
/obj/structure/table/reinforced,
/turf/simulated/floor/plating/indoors,
/area/space)
"Bd" = (
/obj/machinery/atmospherics/pipe/tank/phoron{
	dir = 8
	},
/turf/simulated/floor/plating/indoors,
/area/space)
"BR" = (
/obj/machinery/door/airlock/external/glass,
/turf/simulated/floor/plating,
/area/space)
"CG" = (
/obj/machinery/atmospherics/component/binary/pump/fuel,
/turf/simulated/floor/plating/indoors,
/area/space)
"CJ" = (
/obj/structure/closet/secure_closet/engineering_welding,
/obj/structure/window/reinforced{
	dir = 1
	},
/obj/structure/window/reinforced,
/turf/simulated/floor/plating/indoors,
/area/space)
"Dd" = (
/obj/structure/closet/secure_closet/engineering_electrical,
/obj/structure/window/reinforced,
/turf/simulated/floor/plating/indoors,
/area/space)
"Dy" = (
/turf/space/basic,
/area/space)
"DV" = (
/turf/simulated/wall/r_wall/prepainted/science,
/area/space)
"EI" = (
/obj/machinery/atmospherics/component/binary/pump/fuel{
	dir = 4
	},
/turf/simulated/floor/plating/indoors,
/area/space)
"EL" = (
/obj/structure/closet/secure_closet/engineering_electrical,
/obj/structure/window/reinforced,
/obj/structure/window/reinforced{
	dir = 1
	},
/turf/simulated/floor/plating/indoors,
/area/space)
"Gy" = (
/obj/structure/window/reinforced{
	dir = 1
	},
/turf/simulated/floor/plating/outdoors,
/area/space)
"GY" = (
/turf/simulated/floor/plating/indoors,
/area/space)
"HU" = (
/obj/machinery/artifact_harvester,
/obj/machinery/air_alarm{
	dir = 8
	},
/turf/simulated/floor/plating/outdoors,
/area/space)
"Jz" = (
/obj/machinery/power/apc/east_mount,
/turf/simulated/floor/plating/indoors,
/area/space)
"JR" = (
/obj/structure/table/rack/shelf,
/obj/structure/window/reinforced{
	dir = 4
	},
/obj/structure/window/reinforced{
	dir = 4
	},
/turf/simulated/floor/plating/indoors,
/area/space)
"Ky" = (
/obj/machinery/door/window/brigdoor,
/turf/simulated/floor/plating/outdoors,
/area/space)
"KB" = (
/obj/structure/table/reinforced,
/turf/simulated/floor/plating/outdoors,
/area/space)
"Lo" = (
/obj/machinery/door/airlock/glass/research,
/turf/space/basic,
/area/space)
"LD" = (
/obj/machinery/atmospherics/component/unary/engine/bigger,
/turf/simulated/floor/plating/indoors,
/area/space)
"Ml" = (
/obj/spawner/window/reinforced/full,
/turf/simulated/floor/plating,
/area/space)
"MK" = (
/obj/machinery/power/smes,
/turf/simulated/floor/plating/indoors,
/area/space)
"Nh" = (
/obj/machinery/computer/shuttle_control{
	dir = 4
	},
/obj/structure/window/reinforced{
	dir = 8
	},
/turf/simulated/floor/plating/indoors,
/area/space)
"NN" = (
/obj/machinery/artifact_scanpad,
/turf/simulated/floor/plating/outdoors,
/area/space)
"OK" = (
/obj/machinery/door/airlock/external/glass,
/turf/space/basic,
/area/space)
"PA" = (
/obj/machinery/computer/shuttle_control{
	dir = 4
	},
/turf/simulated/floor/plating/indoors,
/area/space)
"PJ" = (
/obj/machinery/artifact_analyser,
/turf/simulated/floor/plating/outdoors,
/area/space)
"PN" = (
/obj/effect/decal/warning_stripes,
/turf/space/basic,
/area/space)
"QF" = (
/obj/machinery/atmospherics/component/binary/pump/fuel{
	dir = 8
	},
/turf/simulated/floor/plating/indoors,
/area/space)
"Rb" = (
/obj/structure/window/reinforced{
	dir = 1
	},
/obj/structure/window/reinforced,
/obj/structure/window/reinforced{
	dir = 4
	},
/obj/machinery/door/window{
	dir = 8
	},
/turf/simulated/floor/plating/indoors,
/area/space)
"RM" = (
/obj/structure/window/reinforced{
	dir = 1
	},
/obj/structure/window/reinforced,
/obj/machinery/door/window{
	dir = 4
	},
/obj/structure/window/reinforced{
	dir = 8
	},
/turf/simulated/floor/plating/indoors,
/area/space)
"SE" = (
/obj/spawner/window/low_wall/reinforced/full,
/turf/simulated/floor/plating/indoors,
/area/space)
"SS" = (
/obj/machinery/atmospherics/component/unary/engine/bigger,
/turf/space/basic,
/area/space)
"Tb" = (
/obj/spawner/window/low_wall/reinforced/full,
/turf/simulated/floor/plating/outdoors,
/area/space)
"Td" = (
/obj/structure/table/reinforced,
/obj/structure/window/reinforced{
	dir = 8
	},
/turf/simulated/floor/plating/indoors,
/area/space)
"Uw" = (
/turf/simulated/floor/plating/outdoors,
/area/space)
"Vb" = (
/obj/effect/decal/warning_stripes,
/obj/structure/window/reinforced{
	dir = 4
	},
/turf/simulated/floor/plating/indoors,
/area/space)
"Ve" = (
/obj/machinery/atmospherics/portables_connector{
	dir = 4
	},
/turf/simulated/floor/plating/indoors,
/area/space)
"VC" = (
/obj/machinery/air_alarm{
	dir = 4
	},
/obj/machinery/radiocarbon_spectrometer,
/turf/simulated/floor/plating/outdoors,
/area/space)
"Zu" = (
/obj/effect/decal/warning_stripes,
/obj/structure/window/reinforced{
	dir = 1
	},
/turf/simulated/floor/plating/indoors,
/area/space)

(1,1,1) = {"
bx
bx
bx
bx
GY
GY
bx
bx
bx
bx
Dy
Dy
Dy
Dy
Dy
Dy
Dy
Dy
Dy
Dy
Dy
Dy
Dy
Dy
Dy
Dy
Dy
Dy
Dy
Dy
Dy
Dy
Dy
Dy
Dy
Dy
Dy
Dy
Dy
Dy
"}
(2,1,1) = {"
bx
oO
VC
Uw
GY
GY
SE
qk
qk
bx
Dy
Dy
Dy
Dy
Dy
Dy
Dy
Dy
Dy
Dy
Dy
Dy
Dy
Dy
Dy
Dy
Dy
Dy
Dy
Dy
Dy
Dy
Dy
Dy
Dy
Dy
Dy
Dy
Dy
Dy
"}
(3,1,1) = {"
bx
Ky
Uw
Uw
GY
GY
nE
GY
GY
bx
Dy
Dy
Dy
Dy
Dy
Dy
Dy
Dy
Dy
Dy
Dy
Dy
Dy
Dy
Dy
Dy
DV
uG
uG
DV
DV
DV
Dy
DV
DV
DV
Dy
Dy
Dy
Dy
"}
(4,1,1) = {"
bx
Gy
KB
Uw
GY
GY
SE
qk
qk
bx
Dy
Dy
Dy
Dy
Dy
Dy
Dy
Dy
Dy
Dy
Dy
Dy
Dy
Dy
Dy
Dy
av
GY
GY
av
GY
GY
DV
Dd
GY
fX
DV
Dy
Dy
Dy
"}
(5,1,1) = {"
bx
Tb
Tb
Tb
GY
GY
bx
bx
DV
bx
Dy
Dy
Dy
Dy
Dy
Dy
Dy
Dy
Dy
Dy
Dy
Dy
Dy
Dy
Dy
Dy
DV
uG
uG
DV
GY
GY
nE
GY
GY
GY
GY
DV
Dy
Dy
"}
(6,1,1) = {"
bx
NN
Uw
tr
GY
GY
sT
zg
zg
bx
Dy
Dy
Dy
Dy
Dy
DV
vO
vO
JR
DV
Dy
Dy
Dy
Dy
Dy
Dy
Dy
Dy
Dy
Dy
Dy
Dy
DV
qQ
qQ
qQ
Rb
DV
SS
Dy
"}
(7,1,1) = {"
bx
PJ
HU
SE
GY
GY
GY
zg
zg
bx
Dy
Dy
Dy
Dy
Dy
av
PA
zX
PA
av
Dy
Dy
Dy
Dy
Dy
Dy
GY
GY
GY
GY
GY
GY
GY
DV
DV
DV
DV
DV
GY
Dy
"}
(8,1,1) = {"
bx
bx
bx
bx
GY
GY
bx
bx
bx
bx
Dy
Dy
Dy
Dy
Dy
Lo
GY
Jz
GY
Lo
Dy
Dy
Dy
Dy
Dy
Dy
GY
GY
GY
GY
GY
GY
GY
DV
qQ
GY
jS
jS
wy
Dy
"}
(9,1,1) = {"
Dy
Dy
Dy
Dy
Dy
Dy
Dy
Dy
Dy
Dy
Dy
Dy
Dy
Dy
Dy
DV
MK
DV
MK
DV
Dy
Dy
Dy
Dy
Dy
Dy
Dy
Dy
Dy
Dy
Dy
GY
GY
DV
qQ
GY
jS
jS
wy
Dy
"}
(10,1,1) = {"
Dy
Dy
Dy
Dy
Dy
Dy
Dy
Dy
Dy
Dy
Dy
Dy
Dy
Dy
Dy
DV
DV
qk
DV
DV
Dy
Dy
Dy
Dy
Dy
Dy
Dy
Dy
Dy
Dy
Dy
GY
GY
nE
GY
GY
Zu
DV
DV
yZ
"}
(11,1,1) = {"
Dy
Dy
Dy
Dy
Dy
Dy
Dy
Dy
Dy
Dy
Dy
Dy
Dy
Dy
Dy
Dy
Dy
Dy
Dy
Dy
Dy
Dy
Dy
Dy
Dy
Dy
Dy
Dy
Dy
Dy
Dy
GY
GY
av
qQ
GY
qQ
GY
fj
Dy
"}
(12,1,1) = {"
Dy
Dy
Dy
Dy
Dy
Dy
Dy
Dy
Dy
Dy
Dy
Dy
Dy
Dy
Dy
Dy
Dy
Dy
Dy
Dy
Dy
Dy
Dy
Dy
Dy
Dy
Dy
Dy
Dy
Dy
Dy
GY
GY
nE
GY
GY
Vb
DV
fj
Dy
"}
(13,1,1) = {"
Dy
Dy
Dy
Dy
Dy
Dy
Dy
Dy
DV
Ml
Ml
DV
Dy
Dy
Dy
Dy
Dy
Dy
Dy
Dy
Dy
Dy
Dy
Dy
Dy
Dy
Dy
Dy
Dy
Dy
Dy
GY
GY
DV
qQ
GY
jS
jS
wy
Dy
"}
(14,1,1) = {"
Dy
Dy
Dy
Dy
Dy
Dy
Dy
Dy
Ml
ck
ck
BR
Dy
Dy
Dy
Dy
Dy
Dy
Dy
Dy
Dy
Dy
Dy
Dy
Dy
Dy
GY
GY
GY
GY
GY
GY
GY
DV
qQ
GY
jS
jS
wy
Dy
"}
(15,1,1) = {"
Dy
Dy
Dy
Dy
Dy
Dy
Dy
Dy
Ml
ck
ck
BR
Dy
Dy
Dy
Dy
Dy
Dy
Dy
Dy
Dy
Dy
Dy
Dy
Dy
Dy
GY
GY
GY
GY
GY
GY
GY
DV
DV
DV
DV
DV
LD
Dy
"}
(16,1,1) = {"
Dy
Dy
Dy
Dy
Dy
PN
Dy
Dy
DV
BR
BR
DV
Dy
Dy
Dy
Dy
Dy
Dy
Dy
Dy
Dy
Dy
Dy
Dy
Dy
Dy
Dy
Dy
Dy
Dy
Dy
Dy
DV
GY
iF
va
QF
DV
Dy
Dy
"}
(17,1,1) = {"
Dy
Dy
Dy
Dy
Dy
Dy
nR
Dy
Dy
Dy
Dy
Dy
Dy
Dy
Dy
Dy
Dy
Dy
Dy
Dy
Dy
Dy
Dy
Dy
Dy
Dy
DV
uG
uG
DV
GY
GY
nE
CG
GY
GY
GY
DV
Dy
Dy
"}
(18,1,1) = {"
Dy
Dy
Dy
Dy
Dy
Dy
ju
Dy
Dy
Dy
Dy
Dy
Dy
Dy
Dy
Dy
Dy
Dy
Dy
Dy
Dy
Dy
Dy
Dy
Dy
Dy
av
GY
GY
av
GY
GY
DV
GY
Bd
Bd
DV
Dy
Dy
Dy
"}
(19,1,1) = {"
Dy
Dy
Dy
Dy
Dy
Dy
nR
sL
Dy
Dy
Dy
Dy
Dy
Dy
Dy
Dy
Dy
Dy
Dy
Dy
Dy
Dy
Dy
Dy
Dy
Dy
DV
uG
uG
DV
DV
DV
Dy
DV
DV
DV
Dy
Dy
Dy
Dy
"}
(20,1,1) = {"
Dy
Dy
Dy
Dy
Dy
Dy
Dy
Dy
Dy
Dy
Dy
Dy
Dy
Dy
Dy
Dy
Dy
Dy
Dy
Dy
Dy
Dy
Dy
Dy
Dy
Dy
Dy
Dy
Dy
Dy
Dy
Dy
Dy
Dy
Dy
Dy
Dy
Dy
Dy
Dy
"}
(21,1,1) = {"
Dy
Dy
Dy
Dy
Dy
Dy
Dy
Dy
Dy
Dy
Dy
Dy
Dy
Dy
Dy
Dy
Dy
Dy
Dy
Dy
Dy
Dy
Dy
Dy
Dy
Dy
Dy
Dy
Dy
Dy
Dy
Dy
Dy
Dy
Dy
Dy
Dy
Dy
Dy
Dy
"}
(22,1,1) = {"
Dy
Dy
Dy
Dy
GY
Dy
Dy
Dy
Dy
Dy
Dy
Dy
Dy
Dy
Dy
Dy
Dy
Dy
Dy
Dy
Dy
Dy
Dy
Dy
Dy
Dy
Dy
Dy
Dy
Dy
Dy
Dy
Dy
Dy
Dy
Dy
Dy
Dy
Dy
Dy
"}
(23,1,1) = {"
Dy
Dy
GY
GY
GY
GY
GY
GY
Dy
Dy
Dy
Dy
Dy
Dy
Dy
Dy
Dy
Dy
Dy
Dy
Dy
Dy
Dy
Dy
Dy
Dy
Dy
OK
OK
Dy
Dy
Dy
Dy
Dy
Dy
Dy
Dy
Dy
Dy
Dy
"}
(24,1,1) = {"
GY
GY
GY
GY
GY
GY
GY
GY
GY
GY
GY
ck
SS
Dy
Dy
Dy
Dy
Dy
Dy
Dy
Dy
Dy
Dy
Dy
Dy
Dy
Dy
Dy
Dy
Dy
Dy
Dy
Dy
Dy
DV
DV
DV
DV
SS
Dy
"}
(25,1,1) = {"
GY
GY
GY
GY
GY
GY
GY
GY
GY
GY
GY
GY
Dy
Dy
Dy
Dy
Dy
Dy
Dy
Dy
Dy
Dy
Dy
Dy
Dy
Dy
Dy
Dy
Dy
Dy
Dy
Dy
Dy
Dy
DV
GY
qQ
DV
Dy
Dy
"}
(26,1,1) = {"
GY
GY
GY
GY
GY
GY
GY
GY
DV
GY
GY
DV
Dy
Dy
Dy
Dy
Dy
Dy
Dy
Dy
Dy
Dy
Dy
Dy
Dy
Dy
Dy
OK
OK
Dy
Dy
Dy
Dy
Dy
DV
GY
hC
qQ
DV
SS
"}
(27,1,1) = {"
GY
GY
GY
GY
GY
GY
GY
GY
sT
jS
jS
wy
Dy
Dy
Dy
Dy
Dy
Dy
Dy
Dy
Dy
Dy
Dy
Dy
Dy
Dy
Dy
Dy
Dy
Dy
Dy
Dy
Dy
Dy
DV
GY
vs
vs
DV
Dy
"}
(28,1,1) = {"
GY
GY
GY
GY
GY
GY
GY
GY
GY
jS
jS
wy
Dy
Dy
Dy
Dy
Dy
Dy
Dy
Dy
Dy
Dy
Dy
Dy
Dy
Dy
Dy
Dy
Dy
Dy
Dy
Dy
Dy
Dy
DV
GY
jS
jS
wy
Dy
"}
(29,1,1) = {"
GY
GY
GY
GY
GY
GY
GY
GY
DV
GY
GY
DV
Dy
Dy
Dy
Dy
Dy
Dy
Dy
Dy
Dy
Dy
av
Nh
Td
Nh
av
Dy
Dy
GY
GY
GY
GY
GY
nE
GY
jS
jS
wy
Dy
"}
(30,1,1) = {"
GY
GY
GY
GY
GY
GY
GY
GY
GY
GY
GY
GY
SS
Dy
Dy
Dy
Dy
Dy
Dy
Dy
Dy
Dy
Lo
GY
Jz
GY
Lo
Dy
Dy
GY
GY
GY
GY
GY
av
GY
bl
bl
DV
Dy
"}
(31,1,1) = {"
GY
GY
GY
GY
GY
GY
GY
GY
GY
GY
GY
ck
Dy
Dy
Dy
Dy
Dy
Dy
Dy
Dy
Dy
Dy
DV
MK
DV
MK
DV
Dy
Dy
GY
GY
GY
GY
GY
nE
GY
jS
jS
wy
Dy
"}
(32,1,1) = {"
Dy
Dy
GY
GY
GY
GY
GY
GY
GY
Dy
Dy
Dy
Dy
Dy
Dy
Dy
Dy
Dy
Dy
Dy
Dy
Dy
Dy
Dy
Dy
Dy
DV
DV
DV
DV
DV
DV
nE
DV
DV
GY
jS
jS
wy
Dy
"}
(33,1,1) = {"
Dy
Dy
Dy
Dy
GY
Dy
Dy
Dy
Dy
Dy
Dy
Dy
Dy
Dy
Dy
Dy
Dy
Dy
Dy
Dy
Dy
Dy
Dy
Dy
Dy
Dy
DV
qQ
EL
GY
CJ
Ve
EI
QF
DV
GY
hX
hX
DV
SS
"}
(34,1,1) = {"
Dy
Dy
Dy
Dy
Dy
Dy
Dy
Dy
Dy
Dy
Dy
Dy
Dy
DV
Ml
Ml
DV
Dy
Dy
Dy
Dy
Dy
Dy
Dy
Dy
Dy
DV
GY
GY
GY
GY
GY
GY
GY
DV
GY
qQ
qQ
DV
Dy
"}
(35,1,1) = {"
DV
BR
BR
DV
Dy
Dy
Dy
Dy
Dy
DV
BR
BR
DV
Dy
Dy
Dy
Dy
Dy
Dy
Dy
Dy
Dy
Dy
Dy
Dy
Dy
DV
qQ
qQ
qQ
RM
GY
Bd
Bd
DV
GY
qQ
DV
SS
Dy
"}
(36,1,1) = {"
Ml
ck
ck
BR
Dy
Dy
Dy
Dy
Dy
Ml
ck
ck
BR
Dy
Dy
Dy
Dy
Dy
Dy
Dy
Dy
Dy
Dy
Dy
Dy
Dy
DV
DV
DV
DV
DV
DV
DV
DV
DV
DV
DV
DV
Dy
Dy
"}
(37,1,1) = {"
Ml
ck
ck
BR
Dy
Dy
Dy
Dy
Dy
Ml
ck
ck
BR
Dy
Dy
Dy
Dy
Dy
Dy
Dy
Dy
Dy
Dy
Dy
Dy
Dy
Dy
Dy
Dy
Dy
Dy
Dy
Dy
Dy
Dy
Dy
Dy
Dy
Dy
Dy
"}
(38,1,1) = {"
DV
Ml
Ml
DV
Dy
Dy
Dy
Dy
Dy
DV
Ml
Ml
DV
Dy
Dy
Dy
Dy
Dy
Dy
Dy
Dy
Dy
Dy
Dy
Dy
Dy
Dy
Dy
Dy
Dy
Dy
Dy
Dy
Dy
Dy
Dy
Dy
Dy
Dy
Dy
"}
(39,1,1) = {"
Dy
Dy
Dy
Dy
Dy
Dy
Dy
Dy
Dy
Dy
Dy
Dy
Dy
Dy
Dy
Dy
Dy
Dy
Dy
Dy
Dy
Dy
Dy
Dy
Dy
Dy
Dy
Dy
Dy
Dy
Dy
Dy
Dy
Dy
Dy
Dy
Dy
Dy
Dy
Dy
"}
(40,1,1) = {"
Dy
Dy
Dy
Ml
Ml
Dy
Dy
Dy
Dy
Dy
Dy
Dy
Dy
Dy
Dy
Dy
Dy
Dy
Dy
Dy
Dy
Dy
Dy
Dy
Dy
Dy
Dy
Dy
Dy
Dy
Dy
Dy
Dy
Dy
Dy
Dy
Dy
Dy
Dy
Dy
"}
