"ap" = (/obj/machinery/artifact_harvester,/obj/machinery/light,/turf/simulated/shuttle/floor/purple,/area/submap/HeadscientistHQ)
"aq" = (/obj/random/trash,/turf/simulated/floor/outdoors/dirt,/area/template_noop)
"ar" = (/obj/structure/sign/warning/secure_area/armory,/turf/simulated/shuttle/wall/voidcraft/red,/area/submap/HeadscientistHQ)
"ay" = (/mob/living/simple_mob/humanoid/merc/ranged/ionrifle,/turf/simulated/floor/outdoors/dirt,/area/template_noop)
"aE" = (/obj/machinery/power/solar_control,/obj/structure/cable/green{d2 = 4; icon_state = "0-4"},/turf/simulated/floor/outdoors/dirt,/area/template_noop)
"aM" = (/obj/structure/fence/corner{dir = 8},/turf/simulated/floor/outdoors/dirt,/area/template_noop)
"aP" = (/mob/living/simple_mob/humanoid/merc/ranged/garand,/turf/simulated/shuttle/floor,/area/submap/HeadscientistHQ)
"aY" = (/obj/machinery/power/solar,/obj/structure/cable/green{d2 = 8; icon_state = "0-8"},/turf/simulated/floor/plating,/area/template_noop)
"ba" = (/obj/machinery/deployable/barrier,/obj/machinery/deployable/barrier,/turf/simulated/shuttle/floor/red,/area/submap/HeadscientistHQ)
"bF" = (/obj/structure/bed/chair/shuttle{dir = 1},/obj/effect/floor_decal/borderfloorblack,/turf/simulated/shuttle/floor,/area/submap/HeadscientistHQ)
"bX" = (/obj/structure/sign/department/rnd,/turf/simulated/shuttle/wall/voidcraft/red,/area/submap/HeadscientistHQ)
"cb" = (/mob/living/simple_mob/humanoid/merc/ranged/smg,/obj/effect/decal/cleanable/blood,/turf/simulated/shuttle/floor,/area/submap/HeadscientistHQ)
"cp" = (/obj/structure/sign/atmos/phoron,/turf/simulated/shuttle/wall/voidcraft/red,/area/submap/HeadscientistHQ)
"cs" = (/obj/machinery/door/airlock/external/glass/bolted,/obj/effect/decal/cleanable/blood,/obj/structure/fans/tiny,/turf/unsimulated/shuttle/floor,/area/submap/HeadscientistHQ)
"cI" = (/obj/effect/decal/cleanable/dirt,/obj/effect/decal/cleanable/dirt,/obj/structure/table/steel_reinforced,/turf/simulated/shuttle/floor/yellow,/area/submap/HeadscientistHQ)
"cN" = (/obj/effect/decal/cleanable/dirt,/turf/simulated/shuttle/floor/red,/area/submap/HeadscientistHQ)
"dB" = (/obj/machinery/r_n_d/destructive_analyzer,/obj/machinery/light{dir = 1},/turf/simulated/shuttle/floor/purple,/area/submap/HeadscientistHQ)
"en" = (/obj/structure/table/rack/shelf,/obj/item/rig/merc,/turf/simulated/shuttle/floor/red,/area/submap/HeadscientistHQ)
"ep" = (/obj/structure/girder,/obj/effect/decal/cleanable/dirt,/turf/simulated/shuttle/plating,/area/submap/HeadscientistHQ)
"fd" = (/obj/structure/fence/corner{dir = 5},/turf/simulated/floor/outdoors/dirt,/area/template_noop)
"fJ" = (/obj/effect/decal/cleanable/dirt,/obj/structure/table/steel_reinforced,/turf/simulated/shuttle/floor,/area/submap/HeadscientistHQ)
"fV" = (/obj/structure/cable/green{d1 = 1; d2 = 8; icon_state = "1-8"},/obj/structure/cable/green{d1 = 1; d2 = 2; icon_state = "1-2"},/turf/simulated/floor/outdoors/dirt,/area/template_noop)
"gk" = (/obj/machinery/computer/ship/helm,/obj/effect/decal/cleanable/dirt,/turf/simulated/shuttle/floor/yellow,/area/submap/HeadscientistHQ)
"gQ" = (/obj/structure/fence,/turf/simulated/floor/outdoors/dirt,/area/template_noop)
"gV" = (/obj/effect/decal/cleanable/dirt,/obj/effect/decal/cleanable/dirt,/obj/effect/decal/cleanable/dirt,/obj/structure/bed/chair/shuttle{dir = 1},/turf/simulated/shuttle/floor,/area/submap/HeadscientistHQ)
"hf" = (/obj/effect/decal/cleanable/dirt,/obj/effect/decal/cleanable/dirt,/turf/simulated/shuttle/floor/yellow,/area/submap/HeadscientistHQ)
"hn" = (/obj/effect/floor_decal/borderfloorblack{dir = 1},/obj/machinery/light{dir = 1},/turf/simulated/shuttle/floor,/area/submap/HeadscientistHQ)
"hY" = (/obj/effect/floor_decal/borderfloorblack/corner{dir = 4},/turf/simulated/shuttle/floor,/area/submap/HeadscientistHQ)
"im" = (/obj/effect/wingrille_spawn/reinforced,/turf/simulated/shuttle/floor/yellow,/area/submap/HeadscientistHQ)
"ix" = (/obj/machinery/autolathe,/turf/simulated/shuttle/floor/purple,/area/submap/HeadscientistHQ)
"jq" = (/obj/effect/decal/cleanable/dirt,/obj/random/trash,/turf/simulated/shuttle/floor,/area/submap/HeadscientistHQ)
"jt" = (/turf/simulated/shuttle/floor/red,/area/submap/HeadscientistHQ)
"jB" = (/obj/machinery/power/port_gen/pacman,/turf/simulated/shuttle/floor/black,/area/submap/HeadscientistHQ)
"jG" = (/obj/machinery/r_n_d/protolathe,/turf/simulated/shuttle/floor/purple,/area/submap/HeadscientistHQ)
"kr" = (/obj/structure/table/sandbags,/turf/simulated/floor/outdoors/dirt,/area/template_noop)
"kD" = (/obj/machinery/papershredder,/turf/simulated/shuttle/floor/red,/area/submap/HeadscientistHQ)
"kI" = (/obj/structure/anomaly_container,/turf/simulated/shuttle/floor/purple,/area/submap/HeadscientistHQ)
"kL" = (/obj/machinery/mech_recharger,/obj/machinery/power/terminal{dir = 1},/turf/simulated/shuttle/floor/purple,/area/submap/HeadscientistHQ)
"kW" = (/obj/random/trash_pile,/turf/simulated/shuttle/floor/purple,/area/submap/HeadscientistHQ)
"la" = (/obj/machinery/light,/turf/simulated/shuttle/floor/purple,/area/submap/HeadscientistHQ)
"ld" = (/obj/effect/decal/cleanable/dirt,/obj/effect/floor_decal/borderfloorblack,/obj/machinery/light,/turf/simulated/shuttle/floor,/area/submap/HeadscientistHQ)
"lu" = (/obj/structure/cryofeed{dir = 2},/turf/simulated/shuttle/floor,/area/submap/HeadscientistHQ)
"ly" = (/obj/machinery/power/solar,/obj/structure/cable/green{d2 = 4; icon_state = "0-4"},/turf/simulated/floor/plating,/area/template_noop)
"lL" = (/obj/machinery/door/blast/regular,/obj/effect/wingrille_spawn/reinforced,/turf/simulated/shuttle/floor/yellow,/area/submap/HeadscientistHQ)
"lP" = (/obj/item/mecha_parts/mecha_equipment/weapon/energy/medigun,/turf/simulated/shuttle/floor/red,/area/submap/HeadscientistHQ)
"mb" = (/obj/item/inducer/sci,/turf/simulated/floor/plating,/area/template_noop)
"mX" = (/obj/machinery/cryopod{dir = 2},/turf/simulated/shuttle/floor,/area/submap/HeadscientistHQ)
"nd" = (/obj/effect/floor_decal/borderfloorblack,/turf/simulated/shuttle/floor,/area/submap/HeadscientistHQ)
"nh" = (/obj/machinery/pros_fabricator,/turf/simulated/shuttle/floor/purple,/area/submap/HeadscientistHQ)
"nA" = (/mob/living/simple_mob/humanoid/merc/ranged/space/suppressor,/obj/structure/bed/chair/comfy/teal{dir = 8},/obj/effect/decal/cleanable/blood,/turf/simulated/shuttle/floor/yellow,/area/submap/HeadscientistHQ)
"nZ" = (/obj/structure/fence/corner,/turf/simulated/floor/outdoors/dirt,/area/template_noop)
"on" = (/obj/structure/table/rack/shelf,/obj/item/gun/energy/lasercannon,/turf/simulated/shuttle/floor/red,/area/submap/HeadscientistHQ)
"oy" = (/obj/structure/cable/green{d1 = 2; d2 = 4; icon_state = "2-4"},/obj/structure/cable/green{d1 = 2; d2 = 8; icon_state = "2-8"},/turf/simulated/floor/plating,/area/template_noop)
"oL" = (/obj/effect/decal/remains,/turf/template_noop,/area/template_noop)
"oU" = (/obj/machinery/light,/turf/simulated/shuttle/floor/yellow,/area/submap/HeadscientistHQ)
"pb" = (/obj/structure/stasis_cage,/turf/simulated/shuttle/floor/red,/area/submap/HeadscientistHQ)
"pX" = (/turf/simulated/floor/plating,/area/template_noop)
"rm" = (/obj/structure/cable/green{d1 = 2; d2 = 4; icon_state = "2-4"},/turf/simulated/floor/plating,/area/template_noop)
"rY" = (/obj/structure/cable/green{d1 = 2; d2 = 4; icon_state = "2-4"},/obj/structure/cable/green{d1 = 2; d2 = 8; icon_state = "2-8"},/obj/structure/cable/green{d1 = 1; d2 = 2; icon_state = "1-2"},/turf/simulated/floor/plating,/area/template_noop)
"sc" = (/obj/machinery/light{dir = 1},/turf/simulated/shuttle/floor/red,/area/submap/HeadscientistHQ)
"sz" = (/obj/structure/fence/corner{dir = 1},/turf/simulated/floor/outdoors/dirt,/area/template_noop)
"sV" = (/obj/effect/decal/cleanable/dirt,/turf/simulated/shuttle/wall/voidcraft/red,/area/submap/HeadscientistHQ)
"tD" = (/obj/effect/decal/cleanable/dirt,/mob/living/simple_mob/mechanical/cyber_horror/plasma_cyber_horror,/turf/simulated/shuttle/floor/purple,/area/submap/HeadscientistHQ)
"tN" = (/mob/living/simple_mob/humanoid/merc/melee/sword,/obj/effect/decal/cleanable/blood/oil,/turf/simulated/floor/outdoors/dirt,/area/template_noop)
"tU" = (/obj/structure/cable/green{d1 = 2; d2 = 4; icon_state = "2-4"},/obj/structure/cable/green{d1 = 1; d2 = 2; icon_state = "1-2"},/turf/simulated/floor/plating,/area/template_noop)
"un" = (/obj/random/trash_pile,/turf/simulated/shuttle/floor/red,/area/submap/HeadscientistHQ)
"uq" = (/obj/item/grenade/spawnergrenade/manhacks/mercenary,/turf/simulated/shuttle/floor/red,/area/submap/HeadscientistHQ)
"uz" = (/obj/machinery/giga_drill,/turf/simulated/shuttle/floor/purple,/area/submap/HeadscientistHQ)
"uA" = (/obj/structure/table/rack/shelf,/obj/item/gun/energy/sniperrifle/locked,/turf/simulated/shuttle/floor/red,/area/submap/HeadscientistHQ)
"uG" = (/obj/effect/decal/remains/robot,/turf/simulated/floor/outdoors/dirt,/area/template_noop)
"va" = (/mob/living/simple_mob/humanoid/merc/ranged/space/shotgun,/obj/effect/decal/cleanable/blood/oil,/turf/simulated/floor/outdoors/dirt,/area/template_noop)
"ve" = (/obj/effect/decal/cleanable/dirt,/turf/simulated/shuttle/floor,/area/submap/HeadscientistHQ)
"vh" = (/obj/effect/decal/cleanable/dirt,/obj/random/trash,/obj/effect/decal/cleanable/dirt,/turf/simulated/shuttle/floor/yellow,/area/submap/HeadscientistHQ)
"vk" = (/mob/living/simple_mob/humanoid/merc/ranged/grenadier/poi,/obj/effect/decal/cleanable/blood,/turf/simulated/floor/outdoors/dirt,/area/template_noop)
"ws" = (/obj/machinery/computer/ship/engines,/obj/effect/decal/cleanable/dirt,/turf/simulated/shuttle/floor/yellow,/area/submap/HeadscientistHQ)
"wz" = (/obj/machinery/r_n_d/server,/turf/simulated/shuttle/floor/purple,/area/submap/HeadscientistHQ)
"wS" = (/obj/random/trash_pile,/turf/simulated/floor/outdoors/dirt,/area/template_noop)
"xA" = (/obj/item/mecha_parts/mecha_equipment/repair_droid,/turf/template_noop,/area/template_noop)
"xT" = (/obj/machinery/door/airlock/glass_science,/turf/simulated/shuttle/floor/white,/area/submap/HeadscientistHQ)
"yf" = (/obj/effect/decal/cleanable/dirt,/obj/effect/decal/cleanable/dirt,/turf/simulated/shuttle/floor,/area/submap/HeadscientistHQ)
"yo" = (/turf/simulated/shuttle/floor/yellow,/area/submap/HeadscientistHQ)
"yP" = (/obj/effect/decal/cleanable/dirt,/obj/structure/bed/chair/shuttle,/turf/simulated/shuttle/floor,/area/submap/HeadscientistHQ)
"yR" = (/obj/structure/cable/green{d1 = 1; d2 = 8; icon_state = "1-8"},/turf/simulated/floor/outdoors/dirt,/area/template_noop)
"zD" = (/mob/living/simple_mob/humanoid/merc/ranged/space,/obj/effect/decal/cleanable/blood,/turf/simulated/floor/outdoors/dirt,/area/template_noop)
"zG" = (/mob/living/simple_mob/humanoid/merc/ranged/garand,/obj/effect/decal/cleanable/dirt,/turf/simulated/shuttle/floor/purple,/area/submap/HeadscientistHQ)
"zK" = (/obj/structure/cable/green{d1 = 1; d2 = 4; icon_state = "1-4"},/turf/simulated/floor/plating,/area/template_noop)
"zZ" = (/obj/structure/bed/chair/shuttle,/turf/simulated/shuttle/floor,/area/submap/HeadscientistHQ)
"Aj" = (/obj/machinery/light,/turf/simulated/shuttle/floor/red,/area/submap/HeadscientistHQ)
"An" = (/obj/machinery/optable,/obj/effect/decal/warning_stripes,/turf/simulated/shuttle/floor/purple,/area/submap/HeadscientistHQ)
"At" = (/obj/effect/decal/cleanable/dirt,/mob/living/simple_mob/humanoid/merc/ranged,/turf/simulated/shuttle/floor,/area/submap/HeadscientistHQ)
"Az" = (/obj/effect/decal/cleanable/dirt,/obj/machinery/light,/turf/simulated/shuttle/floor,/area/submap/HeadscientistHQ)
"AW" = (/obj/machinery/power/smes/buildable/point_of_interest,/turf/simulated/shuttle/floor/black,/area/submap/HeadscientistHQ)
"Bs" = (/obj/machinery/mech_recharger,/obj/machinery/power/terminal,/turf/simulated/shuttle/floor/red,/area/submap/HeadscientistHQ)
"By" = (/obj/effect/decal/cleanable/dirt,/mob/living/simple_mob/mechanical/viscerator/mercenary,/turf/simulated/shuttle/floor/red,/area/submap/HeadscientistHQ)
"Bz" = (/obj/effect/floor_decal/borderfloorblack{dir = 1},/turf/simulated/shuttle/floor,/area/submap/HeadscientistHQ)
"BD" = (/obj/structure/stasis_cage,/obj/effect/decal/cleanable/dirt,/turf/simulated/shuttle/floor/red,/area/submap/HeadscientistHQ)
"Cg" = (/obj/machinery/shipsensors,/turf/simulated/floor/plating,/area/submap/HeadscientistHQ)
"CM" = (/obj/machinery/computer/cryopod/travel,/turf/simulated/shuttle/wall/voidcraft/red,/area/submap/HeadscientistHQ)
"Di" = (/obj/structure/cable/green{d1 = 1; d2 = 8; icon_state = "1-8"},/turf/simulated/floor/plating,/area/template_noop)
"Dj" = (/obj/machinery/artifact_scanpad,/turf/simulated/shuttle/floor/purple,/area/submap/HeadscientistHQ)
"Dm" = (/obj/machinery/partslathe,/turf/simulated/shuttle/floor/purple,/area/submap/HeadscientistHQ)
"Dn" = (/obj/effect/floor_decal/borderfloorblack,/obj/effect/floor_decal/borderfloorblack{dir = 6},/obj/machinery/light,/turf/simulated/shuttle/floor,/area/submap/HeadscientistHQ)
"DW" = (/obj/machinery/light{dir = 1},/turf/simulated/shuttle/floor,/area/submap/HeadscientistHQ)
"Ek" = (/obj/machinery/mecha_part_fabricator,/turf/simulated/shuttle/floor/purple,/area/submap/HeadscientistHQ)
"EF" = (/obj/machinery/blackbox_recorder,/turf/simulated/shuttle/floor/purple,/area/submap/HeadscientistHQ)
"EO" = (/obj/random/trash,/turf/simulated/shuttle/floor,/area/submap/HeadscientistHQ)
"Fi" = (/obj/effect/decal/cleanable/dirt,/turf/simulated/shuttle/floor/yellow,/area/submap/HeadscientistHQ)
"Fm" = (/obj/structure/cryofeed{dir = 1},/turf/simulated/shuttle/floor,/area/submap/HeadscientistHQ)
"Fs" = (/obj/machinery/door/airlock/glass_command,/turf/simulated/shuttle/floor/yellow,/area/submap/HeadscientistHQ)
"FA" = (/obj/structure/shuttle/engine/heater{dir = 4},/obj/structure/shuttle/engine/router,/turf/simulated/shuttle/plating,/area/submap/HeadscientistHQ)
"FF" = (/obj/machinery/cryopod{dir = 1},/obj/effect/decal/cleanable/dirt,/turf/simulated/shuttle/floor,/area/submap/HeadscientistHQ)
"FK" = (/obj/structure/sign/warning/secure_area,/turf/simulated/shuttle/wall/voidcraft/red,/area/submap/HeadscientistHQ)
"FP" = (/obj/structure/bed/chair/shuttle{dir = 1},/obj/effect/decal/cleanable/dirt,/obj/effect/floor_decal/borderfloorblack,/turf/simulated/shuttle/floor,/area/submap/HeadscientistHQ)
"FT" = (/obj/machinery/artifact_analyser,/turf/simulated/shuttle/floor/purple,/area/submap/HeadscientistHQ)
"FW" = (/obj/structure/cable/green{d1 = 1; d2 = 2; icon_state = "1-2"},/turf/simulated/floor/outdoors/dirt,/area/template_noop)
"Gr" = (/obj/machinery/media/jukebox,/obj/machinery/light{dir = 1},/turf/simulated/shuttle/floor/red,/area/submap/HeadscientistHQ)
"Gs" = (/mob/living/simple_mob/humanoid/merc/ranged/space,/obj/effect/decal/cleanable/dirt,/turf/simulated/shuttle/floor/red,/area/submap/HeadscientistHQ)
"Hb" = (/turf/simulated/mineral/cave,/area/template_noop)
"Hl" = (/obj/effect/decal/cleanable/dirt,/obj/effect/decal/cleanable/dirt,/turf/simulated/shuttle/floor/red,/area/submap/HeadscientistHQ)
"Hz" = (/obj/machinery/computer/rdconsole,/turf/simulated/shuttle/floor/purple,/area/submap/HeadscientistHQ)
"IL" = (/obj/structure/fence{dir = 8},/turf/simulated/floor/outdoors/dirt,/area/template_noop)
"IS" = (/obj/structure/bed/chair/shuttle,/obj/effect/floor_decal/borderfloorblack{dir = 1},/turf/simulated/shuttle/floor,/area/submap/HeadscientistHQ)
"JO" = (/obj/machinery/power/smes/buildable/point_of_interest{inputting = 1000},/turf/simulated/shuttle/floor/black,/area/submap/HeadscientistHQ)
"Ki" = (/obj/effect/floor_decal/borderfloorblack{dir = 1},/obj/effect/floor_decal/borderfloorblack{dir = 5},/obj/machinery/light{dir = 1},/obj/item/stack/material/phoron,/obj/item/stack/material/phoron,/obj/item/stack/material/phoron,/obj/item/stack/material/phoron,/obj/item/stack/material/phoron,/obj/item/stack/material/phoron,/obj/item/stack/material/phoron,/obj/item/stack/material/phoron,/obj/item/stack/material/phoron,/obj/item/stack/material/phoron,/obj/item/stack/material/phoron,/obj/item/stack/material/phoron,/obj/item/stack/material/phoron,/obj/item/stack/material/phoron,/obj/item/stack/material/phoron,/obj/item/stack/material/phoron,/obj/item/stack/material/phoron,/obj/item/stack/material/phoron,/obj/item/stack/material/phoron,/obj/item/stack/material/phoron,/obj/item/stack/material/phoron,/obj/item/stack/material/phoron,/obj/structure/closet/crate/secure/phoron,/turf/simulated/shuttle/floor,/area/submap/HeadscientistHQ)
"Kl" = (/obj/machinery/cryopod{dir = 1},/turf/simulated/shuttle/floor,/area/submap/HeadscientistHQ)
"Kp" = (/obj/machinery/recharger/wallcharger{pixel_y = -28},/turf/simulated/shuttle/floor/red,/area/submap/HeadscientistHQ)
"KK" = (/obj/effect/floor_decal/borderfloorblack/corner,/turf/simulated/shuttle/floor,/area/submap/HeadscientistHQ)
"Ln" = (/obj/effect/decal/cleanable/dirt,/obj/machinery/light{dir = 1},/turf/simulated/shuttle/floor/yellow,/area/submap/HeadscientistHQ)
"Lo" = (/obj/structure/bed/chair/shuttle{dir = 1},/turf/simulated/shuttle/floor,/area/submap/HeadscientistHQ)
"Lu" = (/obj/effect/decal/remains/robot,/turf/template_noop,/area/template_noop)
"LC" = (/obj/effect/decal/mecha_wreckage/durand,/turf/simulated/floor/outdoors/dirt,/area/template_noop)
"LV" = (/obj/machinery/ion_engine{dir = 8},/turf/simulated/shuttle/plating,/area/template_noop)
"LY" = (/mob/living/simple_mob/humanoid/merc/ranged,/turf/simulated/floor/outdoors/dirt,/area/template_noop)
"ND" = (/obj/machinery/computer/shuttle_control,/turf/simulated/shuttle/floor/yellow,/area/submap/HeadscientistHQ)
"OR" = (/obj/structure/table/rack/shelf,/turf/simulated/shuttle/floor/purple,/area/submap/HeadscientistHQ)
"OX" = (/obj/effect/decal/cleanable/dirt,/obj/structure/bed/chair/shuttle{dir = 1},/turf/simulated/shuttle/floor,/area/submap/HeadscientistHQ)
"Pd" = (/mob/living/simple_mob/mechanical/viscerator/mercenary,/turf/template_noop,/area/template_noop)
"Pe" = (/obj/structure/table/steel_reinforced,/turf/simulated/shuttle/floor/yellow,/area/submap/HeadscientistHQ)
"PO" = (/mob/living/simple_mob/mechanical/viscerator/mercenary,/obj/effect/decal/cleanable/dirt,/turf/simulated/shuttle/floor/red,/area/submap/HeadscientistHQ)
"Qz" = (/obj/machinery/light{dir = 1},/turf/simulated/shuttle/floor/purple,/area/submap/HeadscientistHQ)
"Rn" = (/mob/living/simple_mob/mechanical/viscerator/mercenary,/turf/simulated/floor/outdoors/dirt,/area/template_noop)
"RC" = (/obj/machinery/door/airlock/glass,/turf/simulated/shuttle/floor,/area/submap/HeadscientistHQ)
"RG" = (/obj/machinery/r_n_d/circuit_imprinter,/turf/simulated/shuttle/floor/purple,/area/submap/HeadscientistHQ)
"RN" = (/mob/living/simple_mob/humanoid/merc/ranged,/obj/effect/decal/cleanable/dirt,/turf/simulated/shuttle/floor/red,/area/submap/HeadscientistHQ)
"Sm" = (/obj/structure/table/steel_reinforced,/obj/machinery/recharger,/obj/structure/reagent_dispensers/acid{pixel_y = 28},/turf/simulated/shuttle/floor/purple,/area/submap/HeadscientistHQ)
"Tj" = (/turf/simulated/shuttle/floor,/area/submap/HeadscientistHQ)
"Tv" = (/obj/structure/table/steel_reinforced,/obj/item/reagent_containers/glass/beaker,/turf/simulated/shuttle/floor/purple,/area/submap/HeadscientistHQ)
"Tw" = (/obj/machinery/door/airlock/glass_security,/turf/simulated/shuttle/floor/black,/area/submap/HeadscientistHQ)
"Ty" = (/obj/effect/decal/cleanable/dirt,/obj/machinery/recharger/wallcharger{pixel_y = -28},/turf/simulated/shuttle/floor/red,/area/submap/HeadscientistHQ)
"Ux" = (/obj/machinery/computer/ship/sensors,/turf/simulated/shuttle/floor/yellow,/area/submap/HeadscientistHQ)
"UI" = (/obj/structure/table/steel_reinforced,/obj/machinery/cell_charger,/turf/simulated/shuttle/floor/purple,/area/submap/HeadscientistHQ)
"UP" = (/mob/living/simple_mob/humanoid/merc/ranged/deagle,/turf/simulated/shuttle/floor,/area/submap/HeadscientistHQ)
"UV" = (/turf/simulated/shuttle/floor/purple,/area/submap/HeadscientistHQ)
"Vq" = (/obj/structure/cable/green{d1 = 4; d2 = 8; icon_state = "4-8"},/turf/simulated/floor/outdoors/dirt,/area/template_noop)
"Vz" = (/obj/item/mecha_parts/mecha_equipment/weapon/energy/burstlaser,/obj/effect/decal/cleanable/dirt,/turf/simulated/shuttle/floor/red,/area/submap/HeadscientistHQ)
"VJ" = (/obj/effect/decal/cleanable/dirt,/obj/structure/reagent_dispensers/peppertank{pixel_y = -28},/turf/simulated/shuttle/floor/red,/area/submap/HeadscientistHQ)
"VN" = (/obj/structure/girder,/turf/simulated/shuttle/plating,/area/submap/HeadscientistHQ)
"VZ" = (/obj/machinery/door/airlock/external/glass/bolted,/obj/structure/fans/tiny,/turf/unsimulated/shuttle/floor,/area/submap/HeadscientistHQ)
"Wb" = (/obj/structure/fence/door/opened,/obj/structure/cable/green{d1 = 1; d2 = 2; icon_state = "1-2"},/turf/simulated/floor/outdoors/dirt,/area/template_noop)
"Wq" = (/obj/effect/decal/cleanable/dirt,/obj/effect/decal/cleanable/dirt,/turf/simulated/shuttle/floor/purple,/area/submap/HeadscientistHQ)
"WI" = (/obj/structure/table/steel_reinforced,/turf/simulated/shuttle/floor,/area/submap/HeadscientistHQ)
"WP" = (/turf/template_noop,/area/template_noop)
"Xa" = (/mob/living/simple_mob/mechanical/viscerator/mercenary,/turf/simulated/shuttle/floor/red,/area/submap/HeadscientistHQ)
"Xc" = (/obj/structure/bed/chair/shuttle,/obj/effect/decal/cleanable/dirt,/obj/effect/floor_decal/borderfloorblack{dir = 1},/turf/simulated/shuttle/floor,/area/submap/HeadscientistHQ)
"Xf" = (/obj/effect/decal/cleanable/dirt,/turf/simulated/shuttle/floor/purple,/area/submap/HeadscientistHQ)
"Xl" = (/obj/machinery/flasher/portable,/turf/simulated/shuttle/floor/red,/area/submap/HeadscientistHQ)
"Xv" = (/obj/effect/decal/cleanable/dirt,/obj/structure/table/steel_reinforced,/turf/simulated/shuttle/floor/yellow,/area/submap/HeadscientistHQ)
"Yi" = (/turf/simulated/floor/outdoors/dirt,/area/template_noop)
"YH" = (/turf/simulated/shuttle/wall/voidcraft/red,/area/submap/HeadscientistHQ)
"Zh" = (/obj/machinery/deployable/barrier,/turf/simulated/shuttle/floor/red,/area/submap/HeadscientistHQ)
"Zw" = (/obj/machinery/light,/mob/living/simple_mob/humanoid/merc/ranged,/turf/simulated/shuttle/floor,/area/submap/HeadscientistHQ)
"ZT" = (/obj/structure/table/steel_reinforced,/turf/simulated/shuttle/floor/purple,/area/submap/HeadscientistHQ)

(1,1,1) = {"
WPWPWPWPWPWPWPWPWPWPWPWPWPWPWPWPWPWPWPWPWPWPWPWPWPWPWPWPWPWPWPWPWPWPWPWPWPWPWPWPWPWPYiYiYiYiYiYiYiYiYiYiYiWPWP
WPWPWPWPWPWPWPWPWPWPWPWPWPWPWPWPWPWPWPWPWPWPWPWPWPWPWPWPWPWPWPWPWPWPWPWPWPWPWPWPWPYiYiaMILILILILILILILfdYiYiWP
WPWPWPWPWPWPWPWPWPWPWPWPWPWPWPWPWPWPWPWPWPWPWPWPWPWPWPWPWPWPWPWPWPWPWPWPWPWPWPWPYiYiYigQpXpXpXpXpXpXmbgQYiYiWP
WPWPWPWPWPWPWPWPWPWPWPWPWPWPWPWPWPWPWPWPWPWPWPWPWPWPWPWPWPWPWPWPWPWPWPWPWPWPWPWPYiYiYigQpXlyoyaYrmaYpXgQYiYiWP
WPWPWPWPWPWPWPWPWPWPWPWPWPWPWPWPWPWPWPWPWPWPWPWPWPHbHbWPWPWPWPWPWPWPWPWPWPWPWPWPYiYiYigQpXlyrYaYtUaYpXgQYiYiWP
WPWPWPWPWPWPWPWPWPHbHbHbWPWPWPWPWPWPWPWPWPWPHbHbHbHbHbWPWPHbHbHbWPWPWPWPWPWPWPWPYiYiYigQpXlyrYaYtUaYpXgQYiYiYi
WPWPWPHbHbHbWPWPWPHbHbHbWPWPWPWPWPWPWPWPWPWPWPHbHbHbWPWPWPWPWPHbWPWPWPWPWPWPYiYiYiYiYigQpXlyrYaYtUaYpXgQYiYiYi
WPWPWPHbHbHbWPWPWPHbHbWPWPWPWPWPWPYiWPWPWPWPWPWPWPHbWPWPWPWPWPWPWPWPWPWPWPWPYiYiYiYiYigQpXlyrYaYtUaYpXgQYiYiYi
WPWPWPHbHbHbWPWPWPWPWPWPWPWPWPWPWPYiYiuGYiYiYiYiYiYiYiYiYiYiYiYiYiYiYiYiRnvaYiYiYiYiYigQpXlyrYaYtUaYpXgQYiYiYi
WPWPHbHbHbHbWPWPWPWPWPWPWPwSWPWPWPYiYiYiYiYiRnYiYiYiYiYiYiYiYiYiYiYiYiYiYiYiYiYiYiYiYigQpXlyrYaYtUaYpXgQYiYiYi
WPWPHbHbHbHbWPWPWPWPWPWPWPYiYiYiYiYiYiYiYiYiYiYiYiYiYiYiYiYiYiYiYiYiYiYiYiYiYiYiYiYiYigQpXlyrYaYtUaYpXgQYiYiYi
WPWPHbHbHbHbWPWPWPWPWPWPWPYiYiYiYiYiYiYiYiYiYHYHYHYHYHYHYHYHYHYHYHYHYHYHYHYHYHYHYiYiYigQpXpXzKoyDipXpXgQYiYiYi
WPWPHbHbHbWPWPWPWPWPWPuGYiYiYiYiRnYiYiYiYiYHYHDmnhEkHzdBRGjGSmTvUIZTkLQzkWkIYHFALVYiYiszILILILWbILILILnZYiYiYi
WPHbHbHbHbWPWPWPWPWPWPYiYiYiYiYiYiYiYHYHYHYHixUVUVUVUVUVUVUVUVXfXfXfUVUVUVkIYHFALVYiYiYiYiYiaEfVYiYiwSYiYiYiYi
WPWPWPWPWPWPWPWPWPYiYiYiRnYiYiYiYiYHYHEFUVUVUVUVXfXfWqtDUVAnUVXfzGXfUVUVUVkIYHFALVYiYiYiYiYiYiFWYiYiYiYiYiYiYi
WPWPHbWPWPWPYiYiYiYiYiYiYiYiYiYiYHYHwzXfXfUVUVUVORORORlaXfXfUVUVuzDjFTapYHYHYHYHYiYiYiYiYiYiYiFWYiYiYiYiwSYiYi
WPWPWPWPWPYiYiYiYiYiYiYHYHYHYHYHYHYHYHYHYHYHYHYHYHYHYHYHepbXxTxTYHYHYHcpYHYHYHCgYiYiYiYiYiYiYiFWYiYiYiYiYiYiWP
WPWPWPWPYiYiYHYHYHYHYHYHFmYHFmYHFmCMWIWIYHISISISXcIShnBzBzBzBzBzBzBzBzKijBjBYHYiYiYiYiRnYiYiYiFWYiYiYiYiYiYiWP
WPWPWPWPYiYilLPePePeLnYHmXDWmXTjmXDWveTjYHvefJWIWITjTjveveveTjTjTjTjTjhYBzBzFKYiYiYiYiYiYiYiYiFWYiYiYiYiYiYiWP
WPWPYiYiYiYilLwsFihfyoimTjveveTjTjTjcbTjYHTjveyfveveyfgVOXOXLoLoOXveTjTjTjTjVZYiYiYiRnYiYiYiYiFWYiYiYiYiYiYiWP
WPWPYiYiYiYilLNDnAgkFiFsTjTjTjTjTjveTjTjRCTjTjyfjqvevesVsVsVsVsVYHEOTjTjTjUPVZYiYiYiYiYizDYiYiFWYiYiWPWPWPHbWP
WPWPYiYiYiYilLUxvhhfFiimTjjqveveveTjTjTjVNTjTjAtveveveyPyPyPyPyPzZveTjTjTjTjcsYiYiYiYiYiYiYiYiFWYiYiWPWPWPWPWP
WPWPWPWPYiYilLXvcIcIoUYHKlZwKlveFFAzaPTjVNTjWIWIWITjTjTjvevejqveTjTjTjKKndndFKVqVqVqVqVqVqVqVqyRYiWPWPHbHbHbWP
WPWPWPWPYiYiYHYHYHYHYHYHluYHluYHlusVWIWIYHbFbFbFFPbFldndndndndndndndndDnJOAWYHYiYiYiYiYiYiWPWPWPWPWPWPHbHbWPWP
WPHbWPWPWPYiYiYiYiYiYiYHYHYHYHYHYHYHYHYHYHYHYHYHYHYHYHYHYHarTwTwYHYHYHYHYHYHYHYiYiYiYiayYiWPWPWPWPWPHbHbHbWPWP
WPHbHbWPWPYiYiwSwSYiYiYiYiYiYiYiYHYHjtjtjtenonuAuqjtjtGrkDcNcNcNBDpbjtscYHYHYHYHYiYiYiYiYiWPWPWPWPWPHbHbHbHbWP
WPWPWPWPWPYiYiYiYiYiYiYiYiYiYiRnYiYHYHjtjtjtjtXacNRNBycNcNHlBycNGsHljtjtjtXaYHFALVYiWPWPWPWPWPWPWPHbHbHbHbWPWP
WPWPWPWPWPkrkrYiYiYiYiYiYiYiYiYiYiYiYHYHYHYHjtjtBycNcNjtXaHlcNVzcNPOjtjtjtjtYHFALVYiWPWPWPWPWPWPWPWPHbHbHbWPWP
WPWPWPWPWPkrYiYiYiLYYiYiYiYiYiYiYiYiYiYiYiYHYHXlXlbaZhAjjtlPcNVJTyKpBsAjununYHFALVYiWPWPWPWPWPWPWPWPWPHbWPWPWP
WPWPWPWPWPkrYiYiYiYiYiYiYiYiRnYiYiYiYiYiYiYiYHYHYHYHYHYHYHYHYHYHYHYHYHYHYHYHYHYHYiYiWPWPWPWPWPWPWPLuWPWPWPWPWP
WPWPWPWPWPkrYiYiYiYiYiYiYiaqYiYiYiYiYiYiYiYiLCYiYiYiYiYiYiYiYiYiYiYiYiYiYiYiYiYiYiYiWPWPWPWPWPWPWPWPWPWPWPWPWP
WPWPWPWPWPkrYiYiYiYiYiYiYiYiYiYiYiYiYiYiYiYiYiYiYiYiYiYiYiYiYiYiYiYiYiYiYiYiYiYiYiYiWPWPWPWPWPWPWPWPHbWPWPWPWP
WPWPWPWPWPkrYiYiYiYiYitNYiYiYiYiYiYiYiYiYiYiYiYiYiYiYiYiYiYiYiYiYiYiYiYiYiYiYiYiYiYiWPWPWPHbWPWPWPWPWPWPWPWPWP
WPHbHbWPWPkrkrYiYiYiYiYiYiYiYiYiYiYiYiYiYiYiYiwSYiYiYiYiYiYiYiYiYiYiYiYiYiYiayYiYiWPHbHbHbHbWPWPWPWPWPWPWPWPWP
WPHbHbWPWPWPWPWPWPWPWPWPoLWPWPWPYiYiYiYiYiYiYiYiYiYiYiYiYiYiYiYiYiYiYiYiYiYiYiWPWPWPHbHbHbWPWPWPWPWPWPWPWPWPWP
WPHbHbHbWPWPWPWPWPWPWPWPWPWPWPWPYiYiYiYiYiYiYiYiWPYiYiYiYiYiYiYiYiYiYiYiRnWPWPWPWPWPWPWPWPWPWPWPWPWPWPWPWPWPWP
HbHbHbHbWPWPWPWPWPWPWPWPWPWPWPWPWPWPPdWPWPWPWPWPWPYiYiYiRnYiYiYiYiYiWPWPWPWPWPWPWPWPWPWPWPWPWPWPWPWPWPWPWPWPWP
WPHbHbHbWPWPWPWPWPHbWPHbHbWPWPWPWPWPWPWPWPWPWPWPYiYiYiYivkYiYiYiYiYiWPWPWPWPWPWPWPWPWPWPWPWPWPWPWPWPWPWPWPWPWP
WPHbHbWPWPWPWPWPHbHbHbHbHbHbWPWPWPWPWPWPWPWPWPWPWPYiYikrYiYiYikrYiWPWPWPWPWPWPWPWPWPWPWPWPWPWPWPWPWPWPWPWPWPWP
WPHbHbWPWPWPWPWPHbHbHbHbHbHbHbWPWPWPWPWPWPWPWPWPWPYiYikrkrkrkrkrYiWPoLWPWPWPxAHbWPWPWPWPWPWPWPWPWPWPWPWPWPWPWP
WPWPWPWPWPWPWPHbHbHbHbHbHbHbWPWPWPWPWPWPWPWPWPWPWPWPWPWPWPWPWPWPWPWPWPWPWPHbHbHbHbHbWPWPWPWPWPWPWPWPWPWPWPWPWP
WPWPWPWPWPWPWPWPHbHbHbHbWPWPWPWPWPWPWPWPWPWPWPWPWPWPWPWPWPWPWPWPWPWPWPWPWPWPHbHbHbWPWPWPWPWPWPWPWPWPWPWPWPWPWP
WPWPWPWPWPWPWPWPWPWPWPWPWPWPWPWPWPWPWPWPWPWPWPWPoLoLWPWPWPWPWPWPWPWPWPWPWPWPHbHbHbWPWPWPWPWPWPWPWPWPWPWPWPWPWP
WPWPWPWPWPWPWPWPWPWPWPWPWPWPWPWPWPWPWPHbHbHbWPHbWPWPWPWPWPWPWPWPWPWPWPWPWPWPHbHbHbWPWPWPWPWPWPWPWPWPWPWPWPWPWP
WPWPWPWPWPWPWPWPWPWPWPWPWPWPWPWPWPWPWPHbHbHbHbHbHbHbHbWPWPWPWPWPWPWPWPWPWPWPHbHbWPWPWPWPWPWPWPWPWPWPWPWPWPWPWP
WPWPWPWPWPWPWPWPWPWPWPWPWPWPWPWPWPWPWPHbHbHbHbHbHbHbHbHbHbWPWPWPWPWPWPWPWPWPWPWPWPWPWPWPWPWPWPWPWPWPWPWPWPWPWP
WPWPWPWPWPWPWPWPWPWPWPWPWPWPWPWPWPWPWPWPHbHbHbHbHbHbHbHbWPWPWPWPWPWPWPWPWPoLWPWPWPWPWPWPWPWPWPWPWPWPWPWPWPWPWP
WPWPWPWPWPWPWPWPWPWPWPWPWPWPWPWPWPWPWPWPWPWPHbHbHbHbHbWPWPWPWPWPWPWPWPWPWPWPWPWPWPWPWPWPWPWPWPWPWPWPWPWPWPWPWP
WPWPWPWPWPWPWPWPWPWPWPWPWPWPWPWPWPWPWPWPWPWPWPWPHbWPWPWPWPWPWPWPWPWPWPWPWPWPWPWPWPWPWPWPWPWPWPWPWPWPWPWPWPWPWP
"}
