"a" = (/turf/simulated/floor/outdoors/snow/frozen_world,/area/triumph_away/frozen_planet/ruins)
"f" = (/obj/random/triumph/uncertain,/turf/simulated/floor/outdoors/snow/frozen_world,/area/triumph_away/frozen_planet/ruins)
"m" = (/obj/structure/flora/tree/pine,/turf/simulated/floor/outdoors/snow/frozen_world,/area/triumph_away/frozen_planet/ruins)
"r" = (/obj/structure/closet/crate/secure/loot,/turf/simulated/floor/outdoors/snow/frozen_world,/area/triumph_away/frozen_planet/ruins)
"v" = (/turf/simulated/floor/old_tile/green/frozen_world{color = "#63A83A"; icon = 'icons/turf/flooring/tiles_vr.dmi'; icon_state = "tile_full"},/area/triumph_away/frozen_planet/ruins)
"x" = (/turf/simulated/wall/frozen_world,/area/triumph_away/frozen_planet/ruins)
"E" = (/turf/simulated/floor/frozen_world,/area/triumph_away/frozen_planet/ruins)
"G" = (/obj/item/reagent_containers/food/snacks/pizza/margfrozen,/obj/structure/table,/turf/simulated/floor/frozen_world,/area/triumph_away/frozen_planet/ruins)
"K" = (/obj/random/mob/robotic/hivebot{mob_faction = "frozen"},/turf/simulated/floor/frozen_world,/area/triumph_away/frozen_planet/ruins)
"W" = (/obj/structure/flora/tree/pine/xmas,/turf/simulated/floor/outdoors/snow/frozen_world,/area/triumph_away/frozen_planet/ruins)

(1,1,1) = {"
aaamaaaaamaa
maaaaaaaaaaa
aaaamaWaaama
aamaaaaaaaaa
aaxEaEaaExEa
aaEfvaaGrEaa
aavaavEEaaEa
aEaExaaxKaEa
aaaaaamaaama
aaaaaaaaaaaa
amamaaaaamaa
aaaaamaaaaaa
"}
