"a" = (/turf/space,/area/space)
"b" = (/obj/item/ammo_casing/spent{dir = 8; pixel_x = 9; pixel_y = -9},/turf/simulated/floor/tiled/kafel_full/red,/area/space)
"e" = (/obj/item/ammo_casing/spent{dir = 8; pixel_x = 9; pixel_y = -9},/obj/item/ammo_casing/spent{dir = 9; pixel_x = -13; pixel_y = 3},/turf/simulated/floor/tiled/dark,/area/space)
"g" = (/obj/item/ammo_casing/spent{dir = 9; pixel_x = -13; pixel_y = 3},/turf/simulated/shuttle/floor/red,/area/space)
"m" = (/obj/effect/landmark/corpse/syndicatesoldier,/turf/simulated/floor/tiled/dark,/area/space)
"n" = (/obj/structure/bed/chair/office/dark{dir = 8},/obj/effect/gibspawner/human,/turf/simulated/shuttle/floor/red,/area/space)
"p" = (/obj/item/ammo_casing/spent{dir = 8; pixel_x = -7; pixel_y = -7},/turf/simulated/floor/tiled/kafel_full/red,/area/space)
"r" = (/obj/structure/table/steel_reinforced,/turf/simulated/shuttle/floor/black,/area/space)
"v" = (/turf/simulated/shuttle/floor/red,/area/space)
"A" = (/obj/item/ammo_casing/spent{dir = 8},/turf/simulated/shuttle/floor/red,/area/space)
"B" = (/turf/simulated/floor/tiled/kafel_full/red,/area/space)
"C" = (/turf/simulated/shuttle/floor/black,/area/space)
"E" = (/turf/simulated/shuttle/wall/dark/hard_corner,/area/space)
"F" = (/turf/simulated/floor/tiled/dark,/area/space)
"I" = (/turf/simulated/shuttle/floor/voidcraft/dark,/area/space)
"J" = (/obj/structure/table/steel_reinforced,/obj/machinery/computer/pod/old/syndicate,/turf/simulated/shuttle/floor/black,/area/space)
"K" = (/turf/simulated/shuttle/wall/dark,/area/space)
"M" = (/obj/structure/bed/chair/office/dark{dir = 8},/obj/effect/landmark/mobcorpse/syndicatesoldier,/turf/simulated/shuttle/floor/black,/area/space)
"O" = (/obj/item/radio/beacon/syndicate,/turf/simulated/shuttle/floor/black,/area/space)
"T" = (/obj/effect/gibspawner/human,/turf/simulated/floor/tiled/kafel_full/red,/area/space)
"U" = (/obj/item/ammo_casing/spent{dir = 9; pixel_x = -13; pixel_y = 3},/turf/simulated/floor/tiled/dark,/area/space)
"W" = (/obj/effect/landmark/corpse/syndicatecommando,/turf/simulated/floor/tiled/dark,/area/space)
"Y" = (/obj/structure/table/steel_reinforced,/turf/simulated/shuttle/floor/red,/area/space)
"Z" = (/obj/item/ammo_casing/spent{dir = 9; pixel_x = -8; pixel_y = -5},/obj/item/ammo_casing/spent{dir = 8},/turf/simulated/floor/tiled/dark,/area/space)

(1,1,1) = {"
aaaaaaaaaaaaaaaaaaaaaaaaaaaaaaaaaaaaaaaaaaaaaaaaaa
aaaaaaaaaaaaaaaaaaaaaaaaaaaaaaaaaaaaaaaaaaaaaaaaaa
aaaaaaaaaaaaaaaaaaaaaaaaaaaaaaaaaaaaaaaaaaaaaaaaaa
aaaaaaaaaaaaaaaaaaaaaaaaaaaaaaaaaaaaaaaaaaaaaaaaaa
aaaaaaaaaaaaaaaaaaaaaaaaaaaaaaaaaaaaaaaaaaaaaaaaaa
aaaaaaaaaaaaaaaaaaaaaaaaaaaaaaaaaaaaaaaaaaaaaaaaaa
aaaaaaaaaaaaaaaaaaaaaaaaaaaaaaaaaaaaaaaaaaaaaaaaaa
aaaaaaaaaaaaaaaaaaaaaaaaaaaaaaaaaaaaaaaaaaaaaaaaaa
aaaaaaaaaaaaaaaaaaaaaaaaaaaaaaaaaaaaaaaaaaaaaaaaaa
aaaaaaaaaaaaaaaaaaaaaaaaaaaaaaaaaaaaaaaaaaaaaaaaaa
aaaaaaaaaaaaaaaaaaaaaaaaaaaaaaaaaaaaaaaaaaaaaaaaaa
aaaaaaaaaaaaaaaaaaaaaaaaaaaaaaaaaaaaaaaaaaaaaaaaaa
aaaaaaaaaaaaaaaaaaaaaaaaaaaaaaaaaaaaaaaaaaaaaaaaaa
aaaaaaaaaaaaaaaaaaaaaaaaaaaaaaaaaaaaaaaaaaaaaaaaaa
aaaaaaaaaaaaaaaaaaaaaaaaaaaaaaaaaaaaaaaaaaaaaaaaaa
aaaaaaaaaaaaaaaaaaaaaaaaaaaaaaaaaaaaaaaaaaaaaaaaaa
aaaaaaaaaaaaaaaaaaaaaaaaaaaaaaaaaaaaaaaaaaaaaaaaaa
aaaaaaaaaaaaaaaaaaaaaaaaaaaaaaaaaaaaaaaaaaaaaaaaaa
aaaaaaaaaaaaaaaaaaaaaaaaaaaaaaaaaaaaaaaaaaaaaaaaaa
aaaaaaaaaaaKKKKKKKKKKKKKaaaaaaaaaaaaaaaaaaaaaaaaaa
aaaaaaaaaaaKIBBBBBBBBBBKaaaaaaaaaaaaaaaaaaaaaaaaaa
aaaaaaaaaaaKIBWFFFFFFFBKaaaaaaaaaaaaaaaaaaaaaaaaaa
aaaaaaaaaaaKITFgvvvvvFBKaaaaaaaaaaaaaaaaaaaaaaaaaa
aaaaaaaaEKKKEBFYJCCCvFBKaaaaaaaaaaaaaaaaaaaaaaaaaa
aaaaaaaaKBBBKBFYMvvvvFBKaaaaaaaaaaaaaaaaaaaaaaaaaa
aaaaaaaaFFFFFFFYCCOCvFBKaaaaaaaaaaaaaaaaaaaaaaaaaa
aaaaaaaaKBBBKpZYnvvCvFBKaaaaaaaaaaaaaaaaaaaaaaaaaa
aaaaaaaaEKKKEBeYrCCCvFBKaaaaaaaaaaaaaaaaaaaaaaaaaa
aaaaaaaaaaaKIbFvvAvvvFBKaaaaaaaaaaaaaaaaaaaaaaaaaa
aaaaaaaaaaaKIBFFUFFmFFBKaaaaaaaaaaaaaaaaaaaaaaaaaa
aaaaaaaaaaaKIBBBBBBBBBBKaaaaaaaaaaaaaaaaaaaaaaaaaa
aaaaaaaaaaaKKKKKKKKKKKKKaaaaaaaaaaaaaaaaaaaaaaaaaa
aaaaaaaaaaaaaaaaaaaaaaaaaaaaaaaaaaaaaaaaaaaaaaaaaa
aaaaaaaaaaaaaaaaaaaaaaaaaaaaaaaaaaaaaaaaaaaaaaaaaa
aaaaaaaaaaaaaaaaaaaaaaaaaaaaaaaaaaaaaaaaaaaaaaaaaa
aaaaaaaaaaaaaaaaaaaaaaaaaaaaaaaaaaaaaaaaaaaaaaaaaa
aaaaaaaaaaaaaaaaaaaaaaaaaaaaaaaaaaaaaaaaaaaaaaaaaa
aaaaaaaaaaaaaaaaaaaaaaaaaaaaaaaaaaaaaaaaaaaaaaaaaa
aaaaaaaaaaaaaaaaaaaaaaaaaaaaaaaaaaaaaaaaaaaaaaaaaa
aaaaaaaaaaaaaaaaaaaaaaaaaaaaaaaaaaaaaaaaaaaaaaaaaa
aaaaaaaaaaaaaaaaaaaaaaaaaaaaaaaaaaaaaaaaaaaaaaaaaa
aaaaaaaaaaaaaaaaaaaaaaaaaaaaaaaaaaaaaaaaaaaaaaaaaa
aaaaaaaaaaaaaaaaaaaaaaaaaaaaaaaaaaaaaaaaaaaaaaaaaa
aaaaaaaaaaaaaaaaaaaaaaaaaaaaaaaaaaaaaaaaaaaaaaaaaa
aaaaaaaaaaaaaaaaaaaaaaaaaaaaaaaaaaaaaaaaaaaaaaaaaa
aaaaaaaaaaaaaaaaaaaaaaaaaaaaaaaaaaaaaaaaaaaaaaaaaa
aaaaaaaaaaaaaaaaaaaaaaaaaaaaaaaaaaaaaaaaaaaaaaaaaa
aaaaaaaaaaaaaaaaaaaaaaaaaaaaaaaaaaaaaaaaaaaaaaaaaa
aaaaaaaaaaaaaaaaaaaaaaaaaaaaaaaaaaaaaaaaaaaaaaaaaa
aaaaaaaaaaaaaaaaaaaaaaaaaaaaaaaaaaaaaaaaaaaaaaaaaa
"}
