"a" = (/turf/template_noop,/area/template_noop)
"d" = (/obj/structure/fence/corner{dir = 4},/turf/simulated/floor/beach/sand/desert/classh,/area/triumph_away/poi_h/POIs/graveyard)
"e" = (/obj/structure/closet/coffin,/obj/item/digestion_remains/skull,/obj/item/digestion_remains/ribcage,/obj/item/clothing/gloves/ring/material/gold,/obj/item/clothing/ears/earring/stud/silver,/obj/item/clothing/ears/skrell/chain/bluejewels,/obj/item/coin/gold,/obj/item/coin/gold,/obj/item/coin/gold,/turf/simulated/floor/wmarble,/area/triumph_away/poi_h/POIs/graveyard)
"i" = (/obj/structure/fence/corner{dir = 1},/turf/simulated/floor/beach/sand/desert/classh,/area/triumph_away/poi_h/POIs/graveyard)
"k" = (/obj/structure/fence/door/locked{dir = 1},/turf/simulated/floor/beach/sand/desert/classh,/area/triumph_away/poi_h/POIs/graveyard)
"n" = (/obj/structure/simple_door/wood,/turf/simulated/floor/wmarble,/area/triumph_away/poi_h/POIs/graveyard)
"v" = (/obj/structure/fence/corner,/turf/simulated/floor/beach/sand/desert/classh,/area/triumph_away/poi_h/POIs/graveyard)
"y" = (/obj/structure/closet/coffin,/obj/item/digestion_remains/skull,/obj/item/digestion_remains/ribcage,/obj/item/clothing/gloves/ring/material/silver,/obj/item/clothing/ears/earring/dangle/platinum,/obj/item/clothing/ears/skrell/chain/redjewels,/obj/item/coin/gold,/obj/item/coin/gold,/obj/item/coin/gold,/turf/simulated/floor/wmarble,/area/triumph_away/poi_h/POIs/graveyard)
"C" = (/obj/structure/fence/corner{dir = 8},/turf/simulated/floor/beach/sand/desert/classh,/area/triumph_away/poi_h/POIs/graveyard)
"D" = (/obj/item/material/gravemarker{material = MAT_WOOD},/turf/simulated/floor/beach/sand/desert/classh,/area/triumph_away/poi_h/POIs/graveyard)
"F" = (/obj/item/flame/lighter/zippo/engraved,/turf/simulated/floor/beach/sand/desert/classh,/area/triumph_away/poi_h/POIs/graveyard)
"H" = (/turf/simulated/wall/sandstone/classh,/area/triumph_away/poi_h/POIs/graveyard)
"K" = (/obj/structure/fence{dir = 1},/turf/simulated/floor/beach/sand/desert/classh,/area/triumph_away/poi_h/POIs/graveyard)
"O" = (/obj/structure/fence/cut/large{dir = 8},/turf/simulated/floor/beach/sand/desert/classh,/area/triumph_away/poi_h/POIs/graveyard)
"T" = (/obj/item/shovel,/turf/simulated/floor/beach/sand/desert/classh,/area/triumph_away/poi_h/POIs/graveyard)
"U" = (/obj/structure/fence{dir = 4},/turf/simulated/floor/beach/sand/desert/classh,/area/triumph_away/poi_h/POIs/graveyard)
"X" = (/turf/simulated/floor/beach/sand/desert/classh,/area/triumph_away/poi_h/POIs/graveyard)

(1,1,1) = {"
aaXXXXXXXXXXXaa
aXXXXXXXXXXXXXa
XXCUUUUUUUOUdXX
XXKHHHTHHHXDKXX
XXKHeHFHyHXDKXX
XXKHnHXHnHXDKXX
XXKXXXXXXXXXKXX
XXKDDDXDXDDDKXX
XXKXXXXDXXXXKXX
XXKDDDXDXDDDKXX
XXKXXXXDXXXXKXX
XXKDDDXXXDDDKXX
XXiUUOUkUUUUvXX
aXXXXXXXXXXXXXa
aaXXXXXXXXXXXaa
"}
