"a" = (/turf/simulated/floor/outdoors/beach/sand/desert/classh,/area/triumph_away/poi_h/unexplored)
"d" = (/obj/effect/rune,/obj/random/humanoidremains,/turf/simulated/floor/bmarble,/area/triumph_away/poi_h/explored)
"e" = (/obj/structure/simple_door/sandstone,/turf/simulated/floor/bmarble,/area/triumph_away/poi_h/explored)
"k" = (/turf/simulated/floor/wmarble,/area/triumph_away/poi_h/explored)
"l" = (/obj/item/material/knife/ritual,/turf/simulated/floor/plating,/area/triumph_away/poi_h/explored)
"m" = (/obj/effect/decal/cleanable/blood,/turf/simulated/floor/plating,/area/triumph_away/poi_h/explored)
"n" = (/obj/effect/rune,/turf/simulated/floor/bmarble,/area/triumph_away/poi_h/explored)
"o" = (/obj/effect/rune,/turf/simulated/floor/wmarble,/area/triumph_away/poi_h/explored)
"q" = (/turf/simulated/wall/sandstone,/area/triumph_away/poi_h/explored)
"r" = (/obj/item/flame/candle/candelabra/everburn{icon_state = "candelabra_lit"; lit = 1},/turf/simulated/floor/bmarble,/area/triumph_away/poi_h/explored)
"s" = (/turf/simulated/floor/bmarble,/area/triumph_away/poi_h/explored)
"u" = (/obj/random/humanoidremains,/obj/effect/decal/cleanable/blood,/turf/simulated/floor/plating,/area/triumph_away/poi_h/explored)
"A" = (/mob/living/simple_mob/faithless/strong,/obj/random/multiple/triumph/treasure,/turf/simulated/floor/wmarble,/area/triumph_away/poi_h/explored)
"C" = (/obj/item/flame/candle/candelabra/everburn{icon_state = "candelabra_lit"; lit = 1},/turf/simulated/floor/wmarble,/area/triumph_away/poi_h/explored)
"I" = (/obj/structure/simple_door/sandstone,/turf/simulated/mineral/floor/classh,/area/triumph_away/poi_h/explored)
"K" = (/turf/simulated/wall/sandstone/classh,/area/triumph_away/poi_h/explored)
"M" = (/turf/simulated/floor/plating,/area/triumph_away/poi_h/explored)
"P" = (/obj/structure/closet/coffin,/obj/random/roguemineloot,/obj/random/roguemineloot,/turf/simulated/floor/plating,/area/triumph_away/poi_h/explored)
"Q" = (/obj/effect/rune,/obj/random/humanoidremains,/turf/simulated/floor/wmarble,/area/triumph_away/poi_h/explored)
"S" = (/obj/random/humanoidremains,/turf/simulated/floor/plating,/area/triumph_away/poi_h/explored)
"V" = (/obj/effect/decal/cleanable/blood,/turf/simulated/floor/wmarble,/area/triumph_away/poi_h/explored)
"W" = (/obj/structure/simple_door/sandstone,/turf/simulated/floor/plating,/area/triumph_away/poi_h/explored)
"X" = (/mob/living/simple_mob/creature,/turf/simulated/floor/plating,/area/triumph_away/poi_h/explored)
"Z" = (/obj/random/humanoidremains,/turf/simulated/floor/wmarble,/area/triumph_away/poi_h/explored)

(1,1,1) = {"
aaaaaaaaaaaaaaaaa
aKKKKKKKKKKKKKKKa
aKmMXMMMMMMMmXMKa
aKXSmqqqIqqqMluKa
aKMlmqZsVskqmMXKa
aKMqqqqkqkqqqqMKa
aKMqAeonCdoeAqMKa
aKMqqqrVnZrqqqMKa
aKmqAeononoeAqMKa
aKMqqqrQsorqqqMKa
aKMqAeosVsoeAqmKa
aKMqqqqonoqqqqMKa
aKMMWPqKkKqPWMmKa
aKmMqqqksZqqqMMKa
aKMXMmIsZsIMmSXKa
aKlSmXqKIKqMlmXKa
aKKKKKKaaaKKKKKKa
aaaaaaaaaaaaaaaaa
"}
