"a" = (/turf/template_noop,/area/template_noop)
"d" = (/obj/random/mob/spider/nurse,/obj/effect/spider/stickyweb,/turf/simulated/floor/outdoors/beach/sand/dirt/classh,/area/triumph_away/poi_h/explored)
"k" = (/obj/structure/table/marble,/obj/item/flame/candle/candelabra/everburn{icon_state = "candelabra_lit"; lit = 1},/obj/item/clothing/ears/earring/dangle/glass,/obj/effect/spider/stickyweb,/turf/simulated/floor/outdoors/beach/sand/dirt/classh,/area/triumph_away/poi_h/explored)
"l" = (/turf/simulated/wall/sandstone,/area/triumph_away/poi_h/explored)
"m" = (/obj/structure/table/marble,/obj/item/flame/candle/candelabra/everburn{icon_state = "candelabra_lit"; lit = 1},/obj/item/clothing/accessory/necklace,/turf/simulated/floor/outdoors/beach/sand/dirt/classh,/area/triumph_away/poi_h/explored)
"n" = (/turf/simulated/mineral/classh,/area/triumph_away/poi_h/explored)
"o" = (/turf/simulated/floor/outdoors/beach/sand/desert/classh,/area/triumph_away/poi_h/explored)
"p" = (/obj/random/mob/spider,/turf/simulated/floor/outdoors/beach/sand/dirt/classh,/area/triumph_away/poi_h/explored)
"q" = (/turf/simulated/wall/sandstone/classh,/area/triumph_away/poi_h/explored)
"w" = (/obj/structure/table/marble,/obj/item/flame/candle/candelabra/everburn{icon_state = "candelabra_lit"; lit = 1},/obj/item/clothing/gloves/ring/material/iron,/obj/effect/spider/stickyweb,/turf/simulated/floor/outdoors/beach/sand/dirt/classh,/area/triumph_away/poi_h/explored)
"E" = (/turf/simulated/wall/sandstonediamond/classh,/area/triumph_away/poi_h/explored)
"H" = (/obj/structure/table/marble,/obj/item/flame/candle/candelabra/everburn{icon_state = "candelabra_lit"; lit = 1},/obj/item/clothing/ears/earring/stud/steel,/turf/simulated/floor/outdoors/beach/sand/dirt/classh,/area/triumph_away/poi_h/explored)
"K" = (/mob/living/simple_mob/animal/giant_spider,/turf/simulated/floor/outdoors/beach/sand/dirt/classh,/area/triumph_away/poi_h/explored)
"L" = (/obj/effect/floor_decal/plaque{desc = "The carving that used to be here has worn beyond any recoginition."; name = "dusty plaque"},/turf/simulated/wall/sandstonediamond/classh,/area/triumph_away/poi_h/explored)
"N" = (/obj/effect/spider/stickyweb,/turf/simulated/floor/outdoors/beach/sand/dirt/classh,/area/triumph_away/poi_h/explored)
"O" = (/obj/structure/table/marble,/obj/effect/decal/remains/mummy2,/turf/simulated/floor/outdoors/beach/sand/dirt/classh,/area/triumph_away/poi_h/explored)
"S" = (/obj/structure/table/marble,/obj/item/flame/candle/candelabra/everburn{icon_state = "candelabra_lit"; lit = 1},/obj/item/clothing/ears/skrell/chain,/obj/effect/spider/stickyweb,/turf/simulated/floor/outdoors/beach/sand/dirt/classh,/area/triumph_away/poi_h/explored)
"T" = (/obj/structure/table/marble,/obj/effect/decal/remains/mummy1,/turf/simulated/floor/outdoors/beach/sand/dirt/classh,/area/triumph_away/poi_h/explored)
"U" = (/obj/structure/table/marble,/obj/item/flame/candle/candelabra/everburn{icon_state = "candelabra_lit"; lit = 1},/obj/item/clothing/gloves/ring/material/silver,/turf/simulated/floor/outdoors/beach/sand/dirt/classh,/area/triumph_away/poi_h/explored)
"W" = (/turf/simulated/wall/sandstone/classh{can_open = 1},/area/triumph_away/poi_h/explored)
"X" = (/turf/simulated/floor/outdoors/beach/sand/dirt/classh,/area/triumph_away/poi_h/explored)
"Y" = (/obj/random/mob/spider/mutant,/obj/effect/spider/stickyweb,/turf/simulated/floor/outdoors/beach/sand/dirt/classh,/area/triumph_away/poi_h/explored)
"Z" = (/obj/effect/decal/remains/mummy1,/obj/random/multiple/triumph/treasure,/turf/simulated/floor/outdoors/beach/sand/dirt/classh,/area/triumph_away/poi_h/explored)

(1,1,1) = {"
aaannnnnnaaaaaa
aannnnnnnnnnnaa
annnqqEEEEqqnnn
nnnnqNNNXNNqnnn
nnllqNSTTmNqnnn
nnlZWdXXXXdqnnn
nnqqqqqXXqqqqqn
nnqYNXqXXqNNNqn
nnENUXXXXXKwYEn
nnLXOKXXXXXOXLn
nnENkXqppqXHXEn
nnqYNNqXXqKXYqn
nnqWqqqXXqqqqqn
nnqZqnqXXqnnnnn
nnqqqnqXXqnnnnn
annnnnoXXoonnnn
annnnoqXXqonnna
annnnoXXoXoonna
aaaoooXoXXoooaa
aaaoqXoXooXqoaa
"}
