//MAP CONVERTED BY dmm2tgm.py THIS HEADER COMMENT PREVENTS RECONVERSION, DO NOT REMOVE
"a" = (
/turf/template_noop,
/area/template_noop)
"c" = (
/turf/simulated/floor/outdoors/beach/sand/dirtlight,
/area/poi_h/explored)
"d" = (
/obj/random/mob/spider/nurse,
/obj/effect/spider/stickyweb,
/turf/simulated/floor/outdoors/beach/sand/dirt/classh,
/area/poi_h/explored)
"k" = (
/obj/structure/table/marble,
/obj/item/flame/candle/candelabra/everburn{
	icon_state = "candelabra_lit";
	lit = 1
	},
/obj/item/clothing/ears/earring/dangle/glass,
/obj/effect/spider/stickyweb,
/turf/simulated/floor/outdoors/beach/sand/dirt/classh,
/area/poi_h/explored)
"l" = (
/turf/simulated/wall/sandstone,
/area/poi_h/explored)
"m" = (
/obj/structure/table/marble,
/obj/item/flame/candle/candelabra/everburn{
	icon_state = "candelabra_lit";
	lit = 1
	},
/obj/item/clothing/accessory/necklace,
/turf/simulated/floor/outdoors/beach/sand/dirt/classh,
/area/poi_h/explored)
"n" = (
/turf/simulated/mineral/classh,
/area/poi_h/explored)
"o" = (
/turf/simulated/floor/outdoors/beach/sand/lowdesert,
/area/poi_h/explored)
"p" = (
/obj/random/mob/spider,
/turf/simulated/floor/outdoors/beach/sand/dirt/classh,
/area/poi_h/explored)
"q" = (
/turf/simulated/wall/sandstone/classh,
/area/poi_h/explored)
"w" = (
/obj/structure/table/marble,
/obj/item/flame/candle/candelabra/everburn{
	icon_state = "candelabra_lit";
	lit = 1
	},
/obj/item/clothing/gloves/ring/material/iron,
/obj/effect/spider/stickyweb,
/turf/simulated/floor/outdoors/beach/sand/dirt/classh,
/area/poi_h/explored)
"E" = (
/turf/simulated/wall/sandstonediamond/classh,
/area/poi_h/explored)
"H" = (
/obj/structure/table/marble,
/obj/item/flame/candle/candelabra/everburn{
	icon_state = "candelabra_lit";
	lit = 1
	},
/obj/item/clothing/ears/earring/stud/steel,
/turf/simulated/floor/outdoors/beach/sand/dirt/classh,
/area/poi_h/explored)
"K" = (
/mob/living/simple_mob/animal/giant_spider,
/turf/simulated/floor/outdoors/beach/sand/dirt/classh,
/area/poi_h/explored)
"L" = (
/obj/effect/floor_decal/plaque{
	desc = "The carving that used to be here has worn beyond any recoginition.";
	name = "dusty plaque"
	},
/turf/simulated/wall/sandstonediamond/classh,
/area/poi_h/explored)
"N" = (
/obj/effect/spider/stickyweb,
/turf/simulated/floor/outdoors/beach/sand/dirt/classh,
/area/poi_h/explored)
"O" = (
/obj/structure/table/marble,
/obj/effect/decal/remains/mummy2,
/turf/simulated/floor/outdoors/beach/sand/dirt/classh,
/area/poi_h/explored)
"S" = (
/obj/structure/table/marble,
/obj/item/flame/candle/candelabra/everburn{
	icon_state = "candelabra_lit";
	lit = 1
	},
/obj/item/clothing/ears/skrell/chain,
/obj/effect/spider/stickyweb,
/turf/simulated/floor/outdoors/beach/sand/dirt/classh,
/area/poi_h/explored)
"T" = (
/obj/structure/table/marble,
/obj/effect/decal/remains/mummy1,
/turf/simulated/floor/outdoors/beach/sand/dirt/classh,
/area/poi_h/explored)
"U" = (
/obj/structure/table/marble,
/obj/item/flame/candle/candelabra/everburn{
	icon_state = "candelabra_lit";
	lit = 1
	},
/obj/item/clothing/gloves/ring/material/silver,
/turf/simulated/floor/outdoors/beach/sand/dirt/classh,
/area/poi_h/explored)
"W" = (
/turf/simulated/wall/sandstone/classh{
	can_open = 1
	},
/area/poi_h/explored)
"X" = (
/turf/simulated/floor/outdoors/beach/sand/dirt/classh,
/area/poi_h/explored)
"Y" = (
/obj/random/mob/spider/mutant,
/obj/effect/spider/stickyweb,
/turf/simulated/floor/outdoors/beach/sand/dirt/classh,
/area/poi_h/explored)
"Z" = (
/obj/effect/decal/remains/mummy1,
/obj/random/multiple/treasure,
/turf/simulated/floor/outdoors/beach/sand/dirt/classh,
/area/poi_h/explored)

(1,1,1) = {"
a
a
a
n
n
n
n
n
n
n
n
n
n
n
n
a
a
a
a
a
"}
(2,1,1) = {"
a
a
n
n
n
n
n
n
n
n
n
n
n
n
n
n
n
n
a
a
"}
(3,1,1) = {"
a
n
n
n
l
l
q
q
E
L
E
q
q
q
q
n
n
n
a
a
"}
(4,1,1) = {"
n
n
n
n
l
Z
q
Y
N
X
N
Y
W
Z
q
n
n
n
o
o
"}
(5,1,1) = {"
n
n
q
q
q
W
q
N
U
O
k
N
q
q
q
n
n
n
o
q
"}
(6,1,1) = {"
n
n
q
N
N
d
q
X
X
K
X
N
q
n
n
n
o
o
o
c
"}
(7,1,1) = {"
n
n
E
N
S
X
q
q
X
X
q
q
q
q
q
o
q
c
c
o
"}
(8,1,1) = {"
n
n
E
N
T
X
X
X
X
X
p
X
X
X
c
c
c
c
o
c
"}
(9,1,1) = {"
n
n
E
X
T
X
X
X
X
X
p
X
X
X
X
c
c
o
c
o
"}
(10,1,1) = {"
a
n
E
N
m
X
q
q
X
X
q
q
q
q
q
o
q
c
c
o
"}
(11,1,1) = {"
a
n
q
N
N
d
q
N
K
X
X
K
q
n
n
o
o
o
o
c
"}
(12,1,1) = {"
a
n
q
q
q
q
q
N
w
O
H
X
q
n
n
n
n
o
o
q
"}
(13,1,1) = {"
a
n
n
n
n
n
q
N
Y
X
X
Y
q
n
n
n
n
n
o
o
"}
(14,1,1) = {"
a
a
n
n
n
n
q
q
E
L
E
q
q
n
n
n
n
n
a
a
"}
(15,1,1) = {"
a
a
n
n
n
n
n
n
n
n
n
n
n
n
n
n
a
a
a
a
"}
