"a" = (/turf/simulated/floor/beach/sand/desert/classh,/area/triumph_away/poi_h/unexplored)
"d" = (/obj/item/corncob,/turf/simulated/mineral/floor/classh,/area/triumph_away/poi_h/POIs/dirt_farm)
"f" = (/obj/structure/table/woodentable,/obj/item/flame/lighter/zippo,/turf/simulated/floor/wood/classh,/area/triumph_away/poi_h/POIs/dirt_farm)
"g" = (/obj/structure/closet/crate,/obj/item/reagent_containers/food/condiment/flour,/obj/item/reagent_containers/food/condiment/flour,/obj/item/reagent_containers/food/condiment/flour,/obj/item/reagent_containers/food/condiment/flour,/obj/item/reagent_containers/food/condiment/flour,/obj/item/reagent_containers/food/condiment/flour,/obj/item/reagent_containers/food/condiment/flour,/obj/item/reagent_containers/food/condiment/flour,/obj/item/reagent_containers/food/condiment/flour,/turf/simulated/mineral/floor/classh,/area/triumph_away/poi_h/POIs/dirt_farm)
"h" = (/obj/structure/railing{dir = 1},/turf/simulated/floor/beach/sand/desert/classh,/area/triumph_away/poi_h/POIs/dirt_farm)
"m" = (/obj/structure/sink/puddle,/turf/simulated/mineral/floor/classh,/area/triumph_away/poi_h/POIs/dirt_farm)
"o" = (/turf/simulated/wall/sandstone/classh,/area/triumph_away/poi_h/POIs/dirt_farm)
"p" = (/turf/simulated/floor/beach/sand/desert/classh,/area/triumph_away/poi_h/POIs/dirt_farm)
"r" = (/obj/structure/bed/chair/wood/wings{dir = 1},/turf/simulated/floor/wood/classh,/area/triumph_away/poi_h/POIs/dirt_farm)
"s" = (/obj/structure/table/woodentable,/obj/machinery/microwave,/turf/simulated/floor/wood/classh,/area/triumph_away/poi_h/POIs/dirt_farm)
"v" = (/obj/structure/simple_door/wood,/turf/simulated/floor/wood/classh,/area/triumph_away/poi_h/POIs/dirt_farm)
"w" = (/obj/item/bedsheet/browndouble,/obj/structure/bed/double,/turf/simulated/floor/wood/classh,/area/triumph_away/poi_h/POIs/dirt_farm)
"y" = (/obj/structure/railing{dir = 8},/turf/simulated/floor/beach/sand/desert/classh,/area/triumph_away/poi_h/POIs/dirt_farm)
"z" = (/obj/structure/bonfire,/turf/simulated/floor/beach/sand/desert/classh,/area/triumph_away/poi_h/POIs/dirt_farm)
"A" = (/obj/structure/railing{dir = 4},/turf/simulated/floor/beach/sand/desert/classh,/area/triumph_away/poi_h/POIs/dirt_farm)
"J" = (/turf/simulated/mineral/floor/classh,/area/triumph_away/poi_h/unexplored)
"K" = (/obj/structure/closet/crate,/obj/fiftyspawner/log,/obj/fiftyspawner/log,/obj/fiftyspawner/log,/turf/simulated/mineral/floor/classh,/area/triumph_away/poi_h/POIs/dirt_farm)
"M" = (/turf/simulated/floor/wood/classh,/area/triumph_away/poi_h/POIs/dirt_farm)
"N" = (/obj/structure/closet/cabinet,/obj/item/clothing/under/frontier,/obj/item/clothing/under/frontier,/obj/item/clothing/under/frontier,/obj/item/clothing/shoes/boots/cowboy/classic,/obj/item/clothing/shoes/boots/cowboy/classic,/obj/item/clothing/shoes/boots/cowboy/classic,/obj/item/clothing/head/cowboy_hat,/obj/item/clothing/head/cowboy_hat,/obj/item/clothing/head/cowboy_hat,/obj/item/gun/projectile/shotgun/doublebarrel/pellet,/obj/item/storage/box/shotgunshells,/turf/simulated/floor/wood/classh,/area/triumph_away/poi_h/POIs/dirt_farm)
"O" = (/turf/simulated/mineral/floor/classh,/area/triumph_away/poi_h/POIs/dirt_farm)
"P" = (/obj/structure/railing,/turf/simulated/floor/beach/sand/desert/classh,/area/triumph_away/poi_h/POIs/dirt_farm)
"S" = (/obj/machinery/botany,/turf/simulated/floor/beach/sand/desert/classh,/area/triumph_away/poi_h/POIs/dirt_farm)
"Z" = (/obj/structure/bed/chair/wood/wings,/turf/simulated/floor/wood/classh,/area/triumph_away/poi_h/POIs/dirt_farm)

(1,1,1) = {"
aaaaaaaaaaaaaaa
aoooooooPPooooa
aoZMMMwoppogKoa
aofMMMNoppoOOoa
aorMsoooppoOOoa
aoovoomOOOOdOya
aApOOOOOzppOOya
aAOdOOSSSSpdOya
JOOOOOOOOOOOOOJ
JOOdOOOOOOOOOOJ
aASpSpSdOSppSya
aASpSpSOOSppSya
aASpSpSOOSppSya
aphhhhhOOhhhhpa
aaaaaaaJJaaaaaa
"}
