//MAP CONVERTED BY dmm2tgm.py THIS HEADER COMMENT PREVENTS RECONVERSION, DO NOT REMOVE
"a" = (
/turf/simulated/floor/outdoors/beach/sand/lowdesert,
/area/poi_h/unexplored)
"b" = (
/turf/simulated/floor/outdoors/beach/sand/lowdesert,
/area/poi_h/explored)
"e" = (
/turf/simulated/floor/outdoors/water/shoreline/classh{
	dir = 9
	},
/area/poi_h/explored)
"g" = (
/turf/simulated/floor/outdoors/water/shoreline/classh,
/area/poi_h/explored)
"h" = (
/obj/random/outcrop,
/turf/simulated/floor/outdoors/beach/sand/lowdesert,
/area/poi_h/explored)
"i" = (
/turf/simulated/floor/outdoors/water/shoreline/classh{
	dir = 10
	},
/area/poi_h/explored)
"j" = (
/turf/simulated/floor/outdoors/water/classh,
/area/poi_h/explored)
"q" = (
/turf/simulated/floor/outdoors/water/shoreline/classh{
	dir = 1
	},
/area/poi_h/explored)
"s" = (
/turf/simulated/floor/outdoors/water/shoreline/corner/classh{
	dir = 8
	},
/area/poi_h/explored)
"u" = (
/turf/simulated/floor/outdoors/water/shoreline/classh{
	dir = 5
	},
/area/poi_h/explored)
"A" = (
/turf/simulated/floor/outdoors/water/shoreline/classh{
	dir = 8
	},
/area/poi_h/explored)
"B" = (
/turf/simulated/floor/outdoors/water/shoreline/classh{
	dir = 6
	},
/area/poi_h/explored)
"C" = (
/turf/simulated/floor/outdoors/water/shoreline/corner/classh{
	dir = 1
	},
/area/poi_h/explored)
"I" = (
/turf/simulated/floor/outdoors/water/shoreline/corner/classh,
/area/poi_h/explored)
"N" = (
/turf/simulated/floor/outdoors/water/shoreline/corner/classh{
	dir = 4
	},
/area/poi_h/explored)
"V" = (
/turf/simulated/floor/outdoors/water/shoreline/classh{
	dir = 4
	},
/area/poi_h/explored)

(1,1,1) = {"
a
a
a
a
a
a
a
a
a
a
"}
(2,1,1) = {"
a
h
b
I
A
A
A
s
h
a
"}
(3,1,1) = {"
a
b
I
B
j
j
j
u
s
a
"}
(4,1,1) = {"
a
I
B
j
j
j
j
j
q
a
"}
(5,1,1) = {"
a
g
j
j
j
j
j
e
N
a
"}
(6,1,1) = {"
a
g
j
j
j
j
e
N
h
a
"}
(7,1,1) = {"
a
C
i
j
j
j
q
b
b
a
"}
(8,1,1) = {"
a
b
C
i
j
e
N
b
b
a
"}
(9,1,1) = {"
a
h
b
C
V
N
h
b
b
a
"}
(10,1,1) = {"
a
a
a
a
a
a
a
a
a
a
"}
