//MAP CONVERTED BY dmm2tgm.py THIS HEADER COMMENT PREVENTS RECONVERSION, DO NOT REMOVE
"a" = (
/turf/template_noop,
/area/template_noop)
"m" = (
/obj/random/multiple/ores,
/turf/simulated/mineral/floor/classh,
/area/class_h/explored)
"q" = (
/turf/simulated/mineral/floor/classh,
/area/class_h/explored)
"r" = (
/obj/item/storage/mre/random,
/turf/simulated/mineral/floor/classh,
/area/class_h/explored)
"s" = (
/turf/simulated/mineral/classh,
/area/class_h/explored)
"u" = (
/obj/random/multiple/miningdrills,
/turf/simulated/mineral/floor/classh,
/area/class_h/explored)
"C" = (
/obj/random/multiple/ores,
/obj/structure/closet/crate/miningcar,
/turf/simulated/mineral/floor/classh,
/area/class_h/explored)
"D" = (
/obj/structure/hygiene/sink/puddle,
/turf/simulated/mineral/floor/classh,
/area/class_h/explored)
"E" = (
/obj/random/outcrop,
/turf/simulated/mineral/floor/classh,
/area/class_h/explored)
"K" = (
/obj/random/obstruction,
/turf/simulated/mineral/floor/classh,
/area/class_h/explored)
"M" = (
/obj/random/outcrop,
/turf/simulated/floor/outdoors/beach/sand/lowdesert,
/area/class_h/explored)
"N" = (
/obj/structure/closet/crate/miningcar,
/obj/random/multiple/ores,
/turf/simulated/mineral/floor/classh,
/area/class_h/explored)
"R" = (
/obj/item/flashlight/lantern,
/turf/simulated/mineral/floor/classh,
/area/class_h/explored)
"S" = (
/obj/random/obstruction,
/turf/simulated/mineral/classh,
/area/class_h/explored)
"W" = (
/turf/simulated/floor/outdoors/beach/sand/lowdesert,
/area/class_h/explored)

(1,1,1) = {"
a
a
W
W
W
W
W
W
W
W
W
W
W
W
W
W
W
a
a
a
"}
(2,1,1) = {"
a
W
W
s
s
s
s
S
s
s
s
s
s
s
s
M
W
a
a
a
"}
(3,1,1) = {"
a
W
s
s
s
s
s
s
s
s
s
s
s
s
s
s
W
W
a
a
"}
(4,1,1) = {"
a
W
s
s
s
E
q
q
E
s
s
s
s
s
q
q
q
W
W
W
"}
(5,1,1) = {"
W
W
s
s
C
q
q
q
q
E
s
s
s
q
q
q
q
s
M
W
"}
(6,1,1) = {"
W
s
s
q
q
q
s
q
q
q
s
s
q
q
q
s
s
s
s
W
"}
(7,1,1) = {"
W
s
s
E
D
s
s
E
q
s
s
s
q
q
s
s
s
s
s
W
"}
(8,1,1) = {"
W
W
s
s
s
s
s
s
K
s
q
q
K
s
s
s
E
s
s
W
"}
(9,1,1) = {"
a
W
s
s
s
s
E
r
q
q
q
q
s
s
s
D
q
q
s
W
"}
(10,1,1) = {"
a
W
W
q
q
q
q
q
q
u
q
s
s
s
s
E
u
E
s
W
"}
(11,1,1) = {"
a
W
W
q
q
q
q
R
N
s
K
q
s
s
s
q
q
q
s
W
"}
(12,1,1) = {"
a
W
M
s
s
s
q
q
s
s
E
q
q
q
q
m
q
s
s
W
"}
(13,1,1) = {"
a
W
s
s
s
s
q
E
s
s
s
s
q
q
q
q
s
s
s
W
"}
(14,1,1) = {"
W
W
s
s
s
s
q
q
q
s
s
s
s
E
q
E
s
s
s
W
"}
(15,1,1) = {"
W
W
s
s
s
s
q
q
q
q
s
s
s
s
s
s
s
s
W
W
"}
(16,1,1) = {"
W
W
s
s
s
s
s
E
q
K
q
q
q
E
s
s
s
s
M
W
"}
(17,1,1) = {"
a
W
M
s
s
s
s
s
s
q
q
q
q
q
q
s
s
s
W
W
"}
(18,1,1) = {"
a
a
W
W
M
s
s
s
s
s
s
s
s
q
q
s
s
s
W
a
"}
(19,1,1) = {"
a
a
a
W
W
W
W
W
W
W
s
s
M
W
W
s
s
W
W
a
"}
(20,1,1) = {"
a
a
a
a
a
a
W
W
W
W
W
W
W
W
W
W
W
W
a
a
"}
