//MAP CONVERTED BY dmm2tgm.py THIS HEADER COMMENT PREVENTS RECONVERSION, DO NOT REMOVE
"bd" = (
/obj/structure/table/bench/wooden,
/obj/machinery/light/small{
	dir = 4
	},
/turf/simulated/floor/carpet/bcarpet,
/area/class_h/POIs/saloon)
"bF" = (
/obj/structure/table/wooden_reinforced,
/obj/machinery/chemical_dispenser/bar_alc/full,
/turf/simulated/floor/wood/classh,
/area/class_h/POIs/saloon)
"cr" = (
/obj/structure/table/woodentable,
/obj/random/cigarettes,
/obj/item/flame/lighter/random,
/obj/machinery/light{
	dir = 1
	},
/turf/simulated/floor/wood/classh,
/area/class_h/POIs/saloon)
"cR" = (
/obj/structure/bed/chair/wood{
	dir = 8
	},
/obj/effect/debris/cleanable/blood,
/obj/spawner/corpse/syndicatesoldier,
/obj/machinery/light/small{
	dir = 1
	},
/turf/simulated/floor/wood/classh,
/area/class_h/POIs/saloon)
"cZ" = (
/obj/structure/table/gamblingtable,
/obj/item/deck/cards,
/turf/simulated/floor/wood/classh,
/area/class_h/POIs/saloon)
"dc" = (
/obj/structure/bed/chair/wood,
/mob/living/simple_mob/humanoid/merc/ranged,
/obj/machinery/light/small{
	dir = 4
	},
/turf/simulated/floor/wood/classh,
/area/class_h/POIs/saloon)
"dM" = (
/obj/item/stool/padded,
/turf/simulated/floor/wood/classh,
/area/class_h/POIs/saloon)
"gn" = (
/obj/machinery/vending/loadout/costume,
/turf/simulated/floor/wood/classh,
/area/class_h/POIs/saloon)
"io" = (
/turf/template_noop,
/area/template_noop)
"iQ" = (
/obj/structure/table/wooden_reinforced,
/obj/random/cigarettes,
/turf/simulated/floor/wood/classh,
/area/class_h/POIs/saloon)
"jW" = (
/obj/structure/bed/chair/wood{
	dir = 8
	},
/mob/living/simple_mob/humanoid/merc/ranged,
/turf/simulated/floor/wood/classh,
/area/class_h/POIs/saloon)
"kG" = (
/obj/effect/floor_decal/spline/fancy/wood{
	dir = 9
	},
/obj/structure/railing{
	dir = 8
	},
/obj/structure/railing{
	dir = 1
	},
/obj/random/cash,
/turf/simulated/floor/carpet/blucarpet,
/area/class_h/POIs/saloon)
"lb" = (
/obj/structure/bed/chair/wood{
	dir = 8
	},
/mob/living/simple_mob/humanoid/merc/melee,
/turf/simulated/floor/wood/classh,
/area/class_h/POIs/saloon)
"ln" = (
/obj/structure/table/wooden_reinforced,
/obj/item/reagent_containers/food/drinks/bottle/small/beer,
/turf/simulated/floor/wood/classh,
/area/class_h/POIs/saloon)
"lo" = (
/turf/simulated/floor/carpet/bcarpet,
/area/class_h/POIs/saloon)
"lW" = (
/obj/structure/sink/kitchen{
	name = "sink";
	pixel_y = 28
	},
/turf/simulated/floor/wood/classh,
/area/class_h/POIs/saloon)
"nK" = (
/obj/structure/table/wooden_reinforced,
/obj/structure/reagent_dispensers/beerkeg,
/turf/simulated/floor/wood/classh,
/area/class_h/POIs/saloon)
"pU" = (
/obj/structure/bed/chair/wood{
	dir = 1
	},
/turf/simulated/floor/wood/classh,
/area/class_h/POIs/saloon)
"qh" = (
/obj/effect/floor_decal/spline/fancy/wood/corner{
	dir = 4
	},
/turf/simulated/floor/carpet/blucarpet,
/area/class_h/POIs/saloon)
"qA" = (
/obj/item/ammo_casing/spent{
	pixel_y = -5
	},
/obj/item/ammo_casing/spent{
	pixel_x = 5;
	pixel_y = -3
	},
/obj/item/ammo_casing/spent{
	pixel_x = -2;
	pixel_y = 7
	},
/turf/simulated/floor/wood/classh,
/area/class_h/POIs/saloon)
"rL" = (
/obj/structure/bed/chair/wood,
/turf/simulated/floor/wood/classh,
/area/class_h/POIs/saloon)
"sl" = (
/obj/machinery/vending/boozeomat,
/turf/simulated/floor/wood/classh,
/area/class_h/POIs/saloon)
"tl" = (
/obj/effect/floor_decal/spline/fancy/wood{
	dir = 8
	},
/obj/structure/railing{
	dir = 8
	},
/obj/structure/musician/piano,
/turf/simulated/floor/carpet/blucarpet,
/area/class_h/POIs/saloon)
"tt" = (
/obj/effect/floor_decal/spline/fancy/wood{
	dir = 10
	},
/obj/structure/railing{
	dir = 8
	},
/obj/structure/railing,
/mob/living/simple_mob/humanoid/merc/ranged/smg/poi,
/turf/simulated/floor/carpet/blucarpet,
/area/class_h/POIs/saloon)
"ur" = (
/obj/structure/bed/chair/wood{
	dir = 4
	},
/turf/simulated/floor/wood/classh,
/area/class_h/POIs/saloon)
"uK" = (
/obj/structure/bed/chair/wood{
	dir = 4
	},
/obj/item/ammo_casing/spent,
/obj/item/ammo_casing/spent{
	pixel_x = 5;
	pixel_y = 7
	},
/obj/item/ammo_casing/spent{
	pixel_x = -2;
	pixel_y = 7
	},
/mob/living/simple_mob/humanoid/merc/ranged/deagle,
/turf/simulated/floor/wood/classh,
/area/class_h/POIs/saloon)
"wV" = (
/turf/simulated/floor/outdoors/beach/sand/lowdesert,
/area/class_h/explored)
"xI" = (
/turf/simulated/floor/wood/classh,
/area/class_h/POIs/saloon)
"zg" = (
/obj/structure/table/woodentable,
/obj/structure/mirror/raider{
	pixel_x = -28
	},
/obj/item/lipstick/random,
/obj/machinery/light/small,
/turf/simulated/floor/wood/classh,
/area/class_h/POIs/saloon)
"zO" = (
/obj/structure/table/wooden_reinforced,
/obj/random/drinkbottle,
/turf/simulated/floor/wood/classh,
/area/class_h/POIs/saloon)
"Bp" = (
/obj/structure/table/woodentable,
/obj/random/drinkbottle,
/obj/machinery/light{
	dir = 4
	},
/turf/simulated/floor/wood/classh,
/area/class_h/POIs/saloon)
"Dp" = (
/obj/effect/floor_decal/spline/fancy/wood{
	dir = 8
	},
/obj/structure/railing{
	dir = 8
	},
/obj/random/coin,
/turf/simulated/floor/carpet/blucarpet,
/area/class_h/POIs/saloon)
"Et" = (
/obj/effect/floor_decal/spline/fancy/wood/corner{
	dir = 8
	},
/obj/spawner/corpse/clown,
/obj/effect/debris/cleanable/blood,
/turf/simulated/floor/carpet/blucarpet,
/area/class_h/POIs/saloon)
"EJ" = (
/obj/random/coin,
/turf/simulated/floor/carpet/bcarpet,
/area/class_h/POIs/saloon)
"EY" = (
/obj/machinery/light/small{
	dir = 4
	},
/turf/simulated/floor/wood/classh,
/area/class_h/POIs/saloon)
"Fd" = (
/obj/structure/table/bench/wooden,
/turf/simulated/floor/wood/classh,
/area/class_h/POIs/saloon)
"Fm" = (
/obj/machinery/light/small{
	dir = 8
	},
/turf/simulated/floor/wood/classh,
/area/class_h/POIs/saloon)
"Ge" = (
/obj/machinery/media/jukebox,
/turf/simulated/floor/wood/classh,
/area/class_h/POIs/saloon)
"Hz" = (
/obj/structure/table/woodentable,
/obj/item/storage/dicecup,
/obj/machinery/light{
	dir = 4
	},
/turf/simulated/floor/wood/classh,
/area/class_h/POIs/saloon)
"HI" = (
/obj/structure/table/woodentable,
/obj/machinery/light/small,
/obj/random/cigarettes,
/turf/simulated/floor/wood/classh,
/area/class_h/POIs/saloon)
"HU" = (
/obj/structure/railing{
	dir = 4
	},
/obj/effect/floor_decal/spline/fancy/wood{
	dir = 4
	},
/turf/simulated/floor/wood/classh,
/area/class_h/POIs/saloon)
"IU" = (
/obj/machinery/light/small/flicker{
	dir = 8
	},
/obj/random/trash_pile,
/turf/simulated/floor/wood/classh,
/area/class_h/POIs/saloon)
"JY" = (
/obj/structure/table/woodentable,
/obj/random/drinkbottle,
/obj/machinery/light{
	dir = 1
	},
/turf/simulated/floor/wood/classh,
/area/class_h/POIs/saloon)
"Kd" = (
/obj/structure/table/woodentable,
/obj/structure/mirror{
	pixel_x = -28
	},
/obj/item/melee/umbrella/random,
/obj/machinery/light/small{
	dir = 1
	},
/turf/simulated/floor/wood/classh,
/area/class_h/POIs/saloon)
"Lw" = (
/obj/structure/simple_door/wood,
/turf/simulated/floor/wood/classh,
/area/class_h/POIs/saloon)
"LV" = (
/obj/structure/table/wooden_reinforced,
/obj/item/storage/box/glasses/mug,
/obj/item/storage/box/glasses/mug,
/obj/item/storage/box/glasses/mug,
/turf/simulated/floor/wood/classh,
/area/class_h/POIs/saloon)
"NB" = (
/obj/random/cash,
/obj/machinery/light/small{
	dir = 4
	},
/turf/simulated/floor/carpet/bcarpet,
/area/class_h/POIs/saloon)
"OS" = (
/obj/structure/railing{
	dir = 4
	},
/obj/effect/floor_decal/spline/fancy/wood{
	dir = 4
	},
/obj/machinery/light/small/flicker,
/turf/simulated/floor/wood/classh,
/area/class_h/POIs/saloon)
"PU" = (
/obj/structure/railing,
/obj/effect/floor_decal/spline/fancy/wood,
/turf/simulated/floor/wood/classh,
/area/class_h/POIs/saloon)
"Qs" = (
/obj/structure/table/wooden_reinforced,
/obj/item/reagent_containers/food/drinks/drinkingglass/shotglass,
/obj/machinery/light/small{
	dir = 4
	},
/turf/simulated/floor/wood/classh,
/area/class_h/POIs/saloon)
"TY" = (
/turf/simulated/wall/wood,
/area/class_h/POIs/saloon)
"Up" = (
/obj/structure/railing{
	dir = 8
	},
/obj/effect/floor_decal/spline/fancy/wood{
	dir = 8
	},
/turf/simulated/floor/wood/classh,
/area/class_h/POIs/saloon)
"UP" = (
/mob/living/simple_mob/humanoid/merc/ranged/grenadier/poi,
/turf/simulated/floor/wood/classh,
/area/class_h/POIs/saloon)
"WE" = (
/obj/machinery/light/small{
	dir = 1
	},
/turf/simulated/floor/wood/classh,
/area/class_h/POIs/saloon)
"Zm" = (
/obj/structure/closet/cabinet,
/obj/random/projectile/shotgun,
/obj/item/ammo_magazine/clip/c12g/pellet,
/obj/item/ammo_magazine/clip/c12g/beanbag,
/obj/item/ammo_magazine/clip/c12g/beanbag,
/obj/item/ammo_magazine/clip/c12g/beanbag,
/turf/simulated/floor/wood/classh,
/area/class_h/POIs/saloon)
"Zt" = (
/obj/structure/table/woodentable,
/obj/random/drinkbottle,
/obj/machinery/light/small{
	dir = 8
	},
/turf/simulated/floor/wood/classh,
/area/class_h/POIs/saloon)

(1,1,1) = {"
io
io
wV
wV
wV
wV
wV
wV
wV
wV
wV
wV
wV
io
io
io
"}
(2,1,1) = {"
io
wV
wV
xI
Up
Up
Up
Up
Up
Up
Up
xI
wV
wV
io
io
"}
(3,1,1) = {"
wV
wV
xI
xI
Fd
Bp
Fd
Fd
Hz
Fd
xI
xI
xI
wV
wV
io
"}
(4,1,1) = {"
wV
TY
TY
TY
TY
TY
TY
TY
TY
TY
TY
WE
xI
xI
wV
wV
"}
(5,1,1) = {"
wV
TY
lW
Fm
xI
xI
xI
rL
Zt
pU
xI
Lw
EY
xI
xI
wV
"}
(6,1,1) = {"
wV
TY
nK
xI
ln
dM
xI
xI
lb
xI
xI
xI
TY
xI
PU
wV
"}
(7,1,1) = {"
wV
TY
sl
UP
iQ
dM
xI
xI
xI
xI
xI
xI
TY
Fd
PU
wV
"}
(8,1,1) = {"
wV
TY
bF
xI
zO
dM
xI
xI
uK
xI
xI
ur
TY
JY
PU
wV
"}
(9,1,1) = {"
wV
TY
LV
xI
Qs
dM
Ge
dc
cZ
pU
xI
HI
TY
Fd
PU
wV
"}
(10,1,1) = {"
wV
TY
TY
Lw
TY
TY
TY
TY
cR
xI
qA
jW
TY
xI
PU
wV
"}
(11,1,1) = {"
wV
TY
Kd
xI
xI
UP
zg
TY
xI
xI
xI
xI
TY
Fd
PU
wV
"}
(12,1,1) = {"
wV
TY
Fd
xI
xI
xI
Fd
TY
xI
kG
tt
xI
TY
cr
PU
wV
"}
(13,1,1) = {"
wV
TY
TY
Lw
TY
xI
xI
Lw
Dp
qh
Et
tl
TY
Fd
PU
wV
"}
(14,1,1) = {"
wV
xI
IU
xI
TY
gn
Zm
TY
NB
lo
EJ
bd
TY
xI
xI
wV
"}
(15,1,1) = {"
wV
xI
HU
OS
TY
TY
TY
TY
TY
TY
TY
TY
TY
xI
wV
wV
"}
(16,1,1) = {"
wV
wV
wV
wV
wV
wV
wV
wV
wV
wV
wV
wV
wV
wV
wV
io
"}
