//MAP CONVERTED BY dmm2tgm.py THIS HEADER COMMENT PREVENTS RECONVERSION, DO NOT REMOVE
"a" = (
/turf/template_noop,
/area/template_noop)
"b" = (
/obj/random/multiple/minevault,
/obj/item/ore/gold,
/obj/item/ore/gold,
/obj/item/ore/gold,
/obj/item/ore/gold,
/obj/item/ore/gold,
/obj/item/ore/gold,
/obj/item/ore/gold,
/obj/item/ore/gold,
/turf/simulated/mineral/floor/cave,
/area/tether_away/beach/desert/poi/goldmine)
"e" = (
/turf/simulated/mineral/floor/cave,
/area/tether_away/beach/desert/poi/goldmine)
"f" = (
/mob/living/simple_mob/animal/giant_spider/nurse/queen,
/turf/simulated/mineral/floor/cave,
/area/tether_away/beach/desert/poi/goldmine)
"g" = (
/obj/structure/closet/crate/miningcar,
/obj/random/roguemineloot,
/obj/random/roguemineloot,
/obj/item/ore/gold,
/obj/item/ore/gold,
/obj/item/ore/gold,
/obj/item/ore/gold,
/turf/simulated/mineral/floor/cave,
/area/tether_away/beach/desert/poi/goldmine)
"h" = (
/obj/random/outcrop,
/turf/simulated/mineral/floor/cave,
/area/tether_away/beach/desert/poi/goldmine)
"j" = (
/obj/structure/loot_pile/mecha/ripley,
/turf/simulated/mineral/floor/cave,
/area/tether_away/beach/desert/poi/goldmine)
"m" = (
/obj/random/obstruction,
/turf/simulated/mineral/floor/cave,
/area/tether_away/beach/desert/poi/goldmine)
"o" = (
/turf/simulated/mineral/ignore_mapgen/classh,
/area/tether_away/beach/desert/poi/goldmine)
"p" = (
/mob/living/simple_mob/animal/giant_spider,
/turf/simulated/mineral/floor/cave,
/area/tether_away/beach/desert/poi/goldmine)
"q" = (
/turf/simulated/floor/outdoors/beach/sand/lowdesert,
/area/tether_away/beach/desert/poi/goldmine)
"r" = (
/obj/random/mob/spider/nurse,
/turf/simulated/mineral/floor/cave,
/area/tether_away/beach/desert/poi/goldmine)
"s" = (
/obj/effect/spider/stickyweb/dark,
/obj/structure/outcrop/gold,
/turf/simulated/mineral/floor/cave,
/area/tether_away/beach/desert/poi/goldmine)
"v" = (
/obj/structure/closet/crate/miningcar,
/obj/random/roguemineloot,
/obj/random/roguemineloot,
/obj/item/ore/gold,
/obj/item/ore/gold,
/obj/item/ore/gold,
/obj/item/ore/gold,
/obj/item/ore/gold,
/turf/simulated/mineral/floor/cave,
/area/tether_away/beach/desert/poi/goldmine)
"y" = (
/obj/effect/spider/stickyweb/dark,
/obj/effect/spider/eggcluster,
/obj/effect/spider/cocoon,
/turf/simulated/mineral/floor/cave,
/area/tether_away/beach/desert/poi/goldmine)
"z" = (
/obj/random/mob/spider/nurse,
/obj/effect/spider/stickyweb/dark,
/turf/simulated/mineral/floor/cave,
/area/tether_away/beach/desert/poi/goldmine)
"A" = (
/obj/effect/spider/stickyweb,
/obj/effect/spider/cocoon,
/turf/simulated/mineral/floor/cave,
/area/tether_away/beach/desert/poi/goldmine)
"B" = (
/obj/effect/spider/stickyweb,
/obj/effect/spider/eggcluster,
/turf/simulated/mineral/floor/cave,
/area/tether_away/beach/desert/poi/goldmine)
"C" = (
/obj/effect/spider/stickyweb/dark,
/turf/simulated/mineral/floor/cave,
/area/tether_away/beach/desert/poi/goldmine)
"E" = (
/obj/structure/outcrop/gold,
/turf/simulated/mineral/floor/cave,
/area/tether_away/beach/desert/poi/goldmine)
"F" = (
/obj/random/powercell,
/turf/simulated/mineral/floor/cave,
/area/tether_away/beach/desert/poi/goldmine)
"G" = (
/obj/structure/closet/crate/miningcar,
/obj/random/roguemineloot,
/obj/random/roguemineloot,
/obj/random/roguemineloot,
/obj/random/roguemineloot,
/obj/item/ore/gold,
/obj/item/ore/gold,
/obj/item/ore/gold,
/obj/item/ore/gold,
/turf/simulated/mineral/floor/cave,
/area/tether_away/beach/desert/poi/goldmine)
"H" = (
/obj/random/multiple/minevault,
/obj/item/ore/gold,
/obj/item/ore/gold,
/obj/item/ore/gold,
/obj/item/ore/gold,
/obj/item/ore/gold,
/obj/item/ore/gold,
/obj/item/ore/gold,
/obj/item/ore/gold,
/obj/item/ore/gold,
/obj/item/ore/gold,
/turf/simulated/mineral/floor/cave,
/area/tether_away/beach/desert/poi/goldmine)
"J" = (
/obj/item/pickaxe/diamond,
/turf/simulated/mineral/floor/cave,
/area/tether_away/beach/desert/poi/goldmine)
"M" = (
/obj/effect/spider/stickyweb/dark,
/obj/effect/spider/cocoon,
/turf/simulated/mineral/floor/cave,
/area/tether_away/beach/desert/poi/goldmine)
"O" = (
/obj/effect/spider/stickyweb,
/obj/structure/outcrop/gold,
/turf/simulated/mineral/floor/cave,
/area/tether_away/beach/desert/poi/goldmine)
"P" = (
/obj/random/mob/spider/mutant,
/turf/simulated/mineral/floor/cave,
/area/tether_away/beach/desert/poi/goldmine)
"R" = (
/obj/random/mob/spider/nurse,
/obj/effect/spider/stickyweb,
/turf/simulated/mineral/floor/cave,
/area/tether_away/beach/desert/poi/goldmine)
"S" = (
/obj/effect/spider/stickyweb,
/turf/simulated/mineral/floor/cave,
/area/tether_away/beach/desert/poi/goldmine)
"U" = (
/turf/simulated/wall/solidrock,
/area/tether_away/beach/desert/poi/goldmine)
"V" = (
/obj/random/multiple/mechtool,
/turf/simulated/mineral/floor/cave,
/area/tether_away/beach/desert/poi/goldmine)
"W" = (
/obj/random/mob/spider/nurse,
/obj/effect/spider/stickyweb,
/obj/effect/spider/cocoon,
/turf/simulated/mineral/floor/cave,
/area/tether_away/beach/desert/poi/goldmine)
"X" = (
/obj/random/mob/spider,
/turf/simulated/mineral/floor/cave,
/area/tether_away/beach/desert/poi/goldmine)
"Z" = (
/obj/effect/spider/stickyweb/dark,
/obj/random/multiple/miningdrills,
/turf/simulated/mineral/floor/cave,
/area/tether_away/beach/desert/poi/goldmine)

(1,1,1) = {"
a
a
a
a
a
a
a
a
a
a
a
a
a
a
a
a
a
a
a
a
a
a
a
a
a
a
a
a
a
a
"}
(2,1,1) = {"
a
a
a
a
a
q
q
q
q
q
q
o
o
o
o
o
o
o
q
q
q
q
q
q
q
q
q
a
a
a
"}
(3,1,1) = {"
a
a
a
a
q
q
q
o
o
o
o
U
U
U
U
U
U
U
o
o
o
o
o
o
o
q
q
a
a
a
"}
(4,1,1) = {"
a
a
a
q
q
o
o
o
o
o
U
U
e
e
S
S
e
o
o
o
o
o
o
o
m
e
q
q
a
a
"}
(5,1,1) = {"
a
a
q
q
o
o
o
o
U
U
U
e
e
e
S
S
e
e
o
o
o
o
e
m
m
m
e
q
q
a
"}
(6,1,1) = {"
a
q
q
q
o
o
o
U
U
E
e
e
e
E
o
o
e
X
e
e
e
S
e
e
m
m
o
o
q
a
"}
(7,1,1) = {"
a
q
q
o
o
o
U
U
e
X
e
e
o
o
o
o
E
e
e
e
e
S
S
e
e
o
o
o
q
a
"}
(8,1,1) = {"
a
q
q
o
o
U
U
E
e
e
e
E
o
o
o
o
o
g
E
o
X
o
o
o
o
o
o
o
q
a
"}
(9,1,1) = {"
a
q
q
o
o
U
E
e
e
E
o
o
o
o
o
o
o
o
o
o
o
o
o
o
o
o
o
o
q
a
"}
(10,1,1) = {"
a
q
q
o
o
U
e
e
X
o
o
U
U
U
U
U
U
U
U
U
U
U
U
o
o
o
o
o
q
a
"}
(11,1,1) = {"
a
q
q
o
U
U
e
e
o
o
U
U
s
y
S
e
G
e
e
C
C
s
U
U
o
o
o
o
q
a
"}
(12,1,1) = {"
a
q
o
o
U
o
P
e
o
U
U
s
C
S
R
e
P
e
e
C
C
M
C
U
U
o
o
o
q
a
"}
(13,1,1) = {"
a
q
o
o
U
h
e
o
o
U
C
C
W
S
b
e
e
e
e
e
e
e
C
s
U
o
o
o
q
a
"}
(14,1,1) = {"
a
q
o
o
U
S
e
o
o
U
y
S
S
e
e
J
e
P
e
e
e
e
e
e
U
o
o
o
q
a
"}
(15,1,1) = {"
a
q
o
o
U
S
S
o
o
U
S
S
H
f
e
e
e
e
e
E
o
e
e
e
U
o
o
o
q
a
"}
(16,1,1) = {"
a
q
o
o
U
e
e
o
o
U
S
S
S
S
e
e
P
V
e
E
o
E
e
C
U
o
o
o
q
a
"}
(17,1,1) = {"
a
q
o
U
U
m
m
o
o
U
C
z
M
S
H
e
j
E
U
o
o
C
M
C
U
o
o
o
q
a
"}
(18,1,1) = {"
a
q
o
U
E
e
e
o
o
U
C
M
C
B
S
r
E
U
U
o
o
C
C
e
U
o
o
q
q
a
"}
(19,1,1) = {"
a
q
o
U
Z
e
e
o
o
U
U
U
U
U
O
S
U
U
o
o
C
C
r
e
U
o
o
q
q
a
"}
(20,1,1) = {"
a
q
o
U
M
e
e
o
o
o
o
o
o
U
U
U
U
o
o
o
v
e
e
E
U
o
q
q
q
a
"}
(21,1,1) = {"
a
q
o
U
s
e
e
o
o
o
o
o
o
o
o
o
o
o
o
o
P
r
e
U
U
o
q
q
q
a
"}
(22,1,1) = {"
a
q
o
U
U
e
e
o
o
o
o
o
E
C
C
o
o
o
o
o
e
e
E
U
o
o
q
q
a
a
"}
(23,1,1) = {"
a
q
o
o
U
E
S
A
o
o
o
E
e
C
M
C
e
E
o
o
e
E
U
U
o
q
q
q
a
a
"}
(24,1,1) = {"
a
q
o
o
U
U
S
S
e
o
o
e
e
o
o
C
m
m
o
e
P
U
U
o
o
q
q
a
a
a
"}
(25,1,1) = {"
a
q
o
o
o
U
U
S
e
e
e
p
e
o
o
o
m
e
e
e
e
U
o
o
o
q
q
a
a
a
"}
(26,1,1) = {"
a
q
q
o
o
o
U
U
E
P
e
E
P
o
o
o
E
F
j
E
U
U
o
o
q
q
a
a
a
a
"}
(27,1,1) = {"
a
a
q
q
o
o
o
U
U
U
U
U
U
U
U
U
U
U
U
U
U
o
o
o
q
q
a
a
a
a
"}
(28,1,1) = {"
a
a
a
q
q
q
q
o
o
o
o
o
o
o
o
o
o
o
o
o
o
o
o
q
q
q
a
a
a
a
"}
(29,1,1) = {"
a
a
a
a
a
q
q
q
q
q
q
q
q
q
q
q
q
q
q
q
q
q
q
q
q
q
a
a
a
a
"}
(30,1,1) = {"
a
a
a
a
a
a
a
a
a
a
a
a
a
a
a
a
a
a
a
a
a
a
a
a
a
a
a
a
a
a
"}
