//MAP CONVERTED BY dmm2tgm.py THIS HEADER COMMENT PREVENTS RECONVERSION, DO NOT REMOVE
"a" = (
/turf/template_noop,
/area/template_noop)
"c" = (
/turf/simulated/mineral/floor/icerock/lythios43c/indoors/ignore_cavegen,
/area/rift/surfacebase/outside/west_caves)
"l" = (
/obj/structure/largecrate,
/obj/random/triumph,
/turf/simulated/mineral/floor/ignore_cavegen/lythios43c,
/area/rift/surfacebase/outside/west_caves)
"o" = (
/turf/simulated/mineral/floor/ignore_cavegen/lythios43c,
/area/rift/surfacebase/outside/west_caves)
"p" = (
/obj/random/outcrop,
/turf/simulated/mineral/floor/ignore_cavegen/lythios43c,
/area/rift/surfacebase/outside/west_caves)
"w" = (
/obj/machinery/crystal/ice,
/turf/simulated/mineral/floor/icerock/lythios43c/indoors/ignore_cavegen,
/area/rift/surfacebase/outside/west_caves)
"P" = (
/turf/simulated/mineral/icerock/ignore_cavegen/lythios43c,
/area/rift/surfacebase/outside/west_caves)
"Z" = (
/turf/simulated/mineral/ignore_cavegen/lythios43c,
/area/rift/surfacebase/outside/west_caves)

(1,1,1) = {"
c
c
c
P
P
a
a
a
P
P
a
a
a
a
a
"}
(2,1,1) = {"
c
c
c
c
P
P
a
P
P
P
P
P
a
a
a
"}
(3,1,1) = {"
P
c
c
c
c
P
P
P
P
P
P
P
P
P
a
"}
(4,1,1) = {"
P
P
c
c
c
c
c
c
c
w
P
P
P
P
a
"}
(5,1,1) = {"
a
P
P
c
c
c
c
c
c
c
c
P
P
P
a
"}
(6,1,1) = {"
a
P
P
P
c
c
c
c
c
c
c
Z
Z
P
a
"}
(7,1,1) = {"
a
a
P
P
c
c
w
P
P
c
o
p
Z
Z
P
"}
(8,1,1) = {"
a
a
P
P
c
c
P
P
Z
o
o
o
l
Z
Z
"}
(9,1,1) = {"
a
a
P
P
P
P
P
Z
Z
o
o
o
o
p
Z
"}
(10,1,1) = {"
a
a
P
P
P
P
P
Z
p
o
o
o
Z
Z
Z
"}
(11,1,1) = {"
a
P
P
P
w
c
c
c
o
o
o
l
Z
P
a
"}
(12,1,1) = {"
a
P
P
c
c
c
c
c
c
c
Z
Z
Z
P
a
"}
(13,1,1) = {"
a
P
P
c
c
c
c
c
c
c
P
P
P
a
a
"}
(14,1,1) = {"
a
P
P
P
P
P
P
P
c
c
P
a
a
a
a
"}
(15,1,1) = {"
a
a
P
P
P
P
P
P
c
c
a
a
a
a
a
"}
