//MAP CONVERTED BY dmm2tgm.py THIS HEADER COMMENT PREVENTS RECONVERSION, DO NOT REMOVE
"a" = (
/turf/simulated/mineral/floor/icerock/lythios43c/indoors/ignore_cavegen,
/area/rift/surfacebase/outside/west_caves)
"d" = (
/obj/machinery/crystal/ice,
/turf/simulated/mineral/floor/icerock/lythios43c/indoors/ignore_cavegen,
/area/rift/surfacebase/outside/west_caves)
"e" = (
/obj/effect/decal/remains/tajaran,
/turf/simulated/mineral/floor/ignore_cavegen/lythios43c,
/area/rift/surfacebase/outside/west_caves)
"f" = (
/obj/structure/fence/cut{
	dir = 1
	},
/turf/simulated/mineral/floor/icerock/lythios43c/indoors/ignore_cavegen,
/area/rift/surfacebase/outside/west_caves)
"h" = (
/obj/structure/fence/door/locked{
	dir = 4
	},
/turf/simulated/mineral/floor/icerock/lythios43c/indoors/ignore_cavegen,
/area/rift/surfacebase/outside/west_caves)
"l" = (
/obj/structure/fence/door/opened,
/turf/simulated/mineral/floor/icerock/lythios43c/indoors/ignore_cavegen,
/area/rift/surfacebase/outside/west_caves)
"m" = (
/obj/structure/fence/cut/medium{
	dir = 8
	},
/turf/simulated/mineral/floor/icerock/lythios43c/indoors/ignore_cavegen,
/area/rift/surfacebase/outside/west_caves)
"o" = (
/turf/simulated/wall,
/area/rift/surfacebase/outside/west_caves)
"q" = (
/obj/structure/fence{
	dir = 8
	},
/turf/simulated/mineral/floor/icerock/lythios43c/indoors/ignore_cavegen,
/area/rift/surfacebase/outside/west_caves)
"s" = (
/obj/random/multiple/underdark/miningdrills,
/turf/simulated/mineral/floor/ignore_cavegen/lythios43c,
/area/rift/surfacebase/outside/west_caves)
"u" = (
/turf/simulated/mineral/icerock/ignore_cavegen/lythios43c,
/area/rift/surfacebase/outside/west_caves)
"w" = (
/obj/random/landmine,
/turf/simulated/mineral/floor/icerock/lythios43c/indoors/ignore_cavegen,
/area/rift/surfacebase/outside/west_caves)
"x" = (
/obj/random/outcrop,
/turf/simulated/mineral/floor/icerock/lythios43c/indoors/ignore_cavegen,
/area/rift/surfacebase/outside/west_caves)
"D" = (
/obj/structure/fence/cut/large{
	dir = 1
	},
/turf/simulated/mineral/floor/icerock/lythios43c/indoors/ignore_cavegen,
/area/rift/surfacebase/outside/west_caves)
"H" = (
/obj/random/outcrop,
/turf/simulated/mineral/floor/ignore_cavegen/lythios43c,
/area/rift/surfacebase/outside/west_caves)
"I" = (
/obj/structure/fence/door/opened{
	dir = 8
	},
/turf/simulated/mineral/floor/icerock/lythios43c/indoors/ignore_cavegen,
/area/rift/surfacebase/outside/west_caves)
"J" = (
/obj/structure/fence/cut/large{
	dir = 8
	},
/turf/simulated/mineral/floor/icerock/lythios43c/indoors/ignore_cavegen,
/area/rift/surfacebase/outside/west_caves)
"K" = (
/obj/structure/fence/door/opened{
	dir = 4
	},
/turf/simulated/mineral/floor/icerock/lythios43c/indoors/ignore_cavegen,
/area/rift/surfacebase/outside/west_caves)
"L" = (
/turf/simulated/mineral/ignore_cavegen/lythios43c,
/area/rift/surfacebase/outside/west_caves)
"M" = (
/obj/structure/fence/cut{
	dir = 4
	},
/turf/simulated/mineral/floor/icerock/lythios43c/indoors/ignore_cavegen,
/area/rift/surfacebase/outside/west_caves)
"O" = (
/obj/structure/fence/door,
/turf/simulated/mineral/floor/icerock/lythios43c/indoors/ignore_cavegen,
/area/rift/surfacebase/outside/west_caves)
"Q" = (
/obj/item/flame/lighter/zippo/taj,
/turf/simulated/mineral/floor/ignore_cavegen/lythios43c,
/area/rift/surfacebase/outside/west_caves)
"S" = (
/obj/random/landmine,
/turf/simulated/mineral/floor/ignore_cavegen/lythios43c,
/area/rift/surfacebase/outside/west_caves)
"T" = (
/obj/structure/closet/crate/miningcar,
/obj/random/multiple/ores,
/obj/random/multiple/ores,
/obj/random/multiple/ores,
/turf/simulated/mineral/floor/ignore_cavegen/lythios43c,
/area/rift/surfacebase/outside/west_caves)
"U" = (
/turf/simulated/mineral/floor/ignore_cavegen/lythios43c,
/area/rift/surfacebase/outside/west_caves)
"V" = (
/turf/template_noop,
/area/template_noop)
"X" = (
/obj/structure/fence,
/turf/simulated/mineral/floor/icerock/lythios43c/indoors/ignore_cavegen,
/area/rift/surfacebase/outside/west_caves)
"Y" = (
/obj/structure/fence/cut,
/turf/simulated/mineral/floor/icerock/lythios43c/indoors/ignore_cavegen,
/area/rift/surfacebase/outside/west_caves)

(1,1,1) = {"
V
V
V
V
V
V
V
V
V
V
V
V
u
u
u
u
u
u
V
V
V
V
V
V
V
V
V
V
V
V
"}
(2,1,1) = {"
V
V
V
V
V
V
V
u
u
u
u
u
u
u
u
u
u
u
u
u
u
u
u
V
V
V
V
V
V
V
"}
(3,1,1) = {"
V
V
V
u
o
D
h
X
o
u
a
a
a
a
a
a
a
a
a
a
u
u
o
X
K
X
o
u
u
V
"}
(4,1,1) = {"
V
V
V
u
u
a
a
a
a
a
a
d
a
w
u
u
u
a
w
a
a
a
a
a
a
a
u
u
u
u
"}
(5,1,1) = {"
V
V
u
u
u
a
a
w
a
a
a
a
a
u
u
u
u
a
a
d
a
a
a
a
w
a
a
a
u
u
"}
(6,1,1) = {"
V
u
u
u
x
a
a
a
a
u
u
a
a
u
u
u
u
u
a
a
a
a
a
u
u
u
a
a
a
o
"}
(7,1,1) = {"
V
u
u
a
a
a
a
a
u
u
u
a
a
a
a
u
u
u
w
a
a
a
u
u
u
u
u
w
a
q
"}
(8,1,1) = {"
u
u
d
a
a
w
a
u
u
u
u
a
d
a
a
a
a
a
a
a
a
u
u
u
u
u
u
a
a
O
"}
(9,1,1) = {"
u
u
a
a
a
a
a
u
u
u
u
a
a
a
a
a
H
U
U
U
U
a
u
u
u
u
u
a
a
q
"}
(10,1,1) = {"
u
u
a
a
a
a
a
u
u
u
u
u
w
a
a
U
L
L
H
U
U
U
a
u
u
u
a
a
d
o
"}
(11,1,1) = {"
V
u
u
a
a
a
a
u
u
u
u
u
a
a
U
U
L
L
L
L
U
S
U
a
a
a
a
a
u
u
"}
(12,1,1) = {"
V
V
u
u
d
a
a
a
u
u
u
a
a
U
U
U
s
L
L
L
L
L
H
a
a
a
a
u
u
V
"}
(13,1,1) = {"
V
V
V
u
u
a
w
a
a
a
a
a
U
L
L
e
U
T
L
L
L
L
a
a
a
a
a
u
u
V
"}
(14,1,1) = {"
V
V
V
u
u
a
a
a
a
a
a
a
U
L
L
L
U
U
e
L
L
L
a
a
a
w
a
u
u
V
"}
(15,1,1) = {"
V
V
V
u
u
o
a
a
a
a
a
a
U
U
L
L
H
Q
U
U
U
U
a
a
a
a
u
u
V
V
"}
(16,1,1) = {"
V
V
V
a
a
m
a
a
a
w
a
a
a
H
L
T
U
U
s
U
U
a
a
d
a
u
u
V
V
V
"}
(17,1,1) = {"
V
V
a
a
a
l
a
a
d
a
a
a
a
a
a
U
e
L
L
L
L
a
a
a
a
u
V
V
V
V
"}
(18,1,1) = {"
V
V
a
a
a
M
a
a
a
a
a
u
u
a
a
a
L
L
L
L
a
a
a
a
a
u
u
V
V
V
"}
(19,1,1) = {"
V
V
V
a
a
M
a
a
a
a
u
u
u
a
a
a
a
a
w
a
a
a
a
w
a
a
u
u
V
V
"}
(20,1,1) = {"
V
V
V
u
u
o
a
a
a
u
u
u
u
u
a
a
d
a
a
a
a
u
u
a
a
a
d
u
u
V
"}
(21,1,1) = {"
V
V
V
V
u
o
a
a
a
u
u
u
u
u
u
a
a
a
a
u
u
u
u
u
a
a
a
a
u
V
"}
(22,1,1) = {"
V
V
V
V
u
o
a
w
a
u
u
u
u
u
u
w
a
u
u
u
u
u
u
u
u
w
a
a
u
V
"}
(23,1,1) = {"
V
V
V
V
V
J
a
a
a
a
u
u
u
u
u
a
a
u
u
u
u
u
a
a
a
a
a
a
u
V
"}
(24,1,1) = {"
V
V
V
V
a
M
a
a
a
a
a
u
u
u
u
a
a
a
a
a
a
w
a
a
a
a
a
a
u
u
"}
(25,1,1) = {"
V
V
V
V
u
o
a
a
a
a
w
x
u
u
u
a
a
a
a
a
a
a
a
o
X
Y
I
X
o
u
"}
(26,1,1) = {"
V
V
V
u
u
u
x
a
a
a
a
a
a
a
a
a
a
a
a
a
a
a
x
o
a
a
a
a
a
u
"}
(27,1,1) = {"
V
V
V
u
u
u
u
a
a
d
a
a
a
a
w
a
a
a
a
u
u
u
u
u
a
a
a
a
a
a
"}
(28,1,1) = {"
V
V
V
V
u
u
u
w
a
a
a
a
a
a
u
u
u
u
u
u
u
u
u
u
u
u
d
a
a
a
"}
(29,1,1) = {"
V
V
V
V
V
u
u
u
o
D
h
f
o
u
u
u
u
u
u
u
u
u
V
u
u
u
u
u
a
a
"}
(30,1,1) = {"
V
V
V
V
V
V
V
u
u
a
a
a
u
u
V
u
u
u
V
V
V
V
V
V
V
u
u
u
V
V
"}
