//MAP CONVERTED BY dmm2tgm.py THIS HEADER COMMENT PREVENTS RECONVERSION, DO NOT REMOVE
"a" = (
/turf/simulated/mineral/icerock/ignore_cavegen/lythios43c,
/area/rift/surfacebase/outside/west_caves)
"b" = (
/turf/simulated/mineral/floor/icerock/lythios43c/indoors/ignore_cavegen,
/area/rift/surfacebase/outside/west_caves)
"c" = (
/obj/effect/floor_decal/industrial/warning,
/turf/simulated/floor/concrete/lythios43c,
/area/rift/surfacebase/outside/west_caves)
"d" = (
/obj/effect/floor_decal/industrial/warning,
/obj/structure/event/prop/mining_truck,
/turf/simulated/floor/concrete/lythios43c,
/area/rift/surfacebase/outside/west_caves)
"e" = (
/obj/structure/fence/door/locked{
	dir = 8
	},
/turf/simulated/floor/concrete/lythios43c,
/area/rift/surfacebase/outside/west_caves)
"f" = (
/obj/structure/event/prop/covered_crawler,
/obj/effect/map_effect/radiation_emitter,
/turf/simulated/floor/concrete/lythios43c,
/area/rift/surfacebase/outside/west_caves)
"g" = (
/obj/structure/event/prop/tractor,
/obj/effect/map_effect/radiation_emitter/strong,
/turf/simulated/floor/concrete/lythios43c,
/area/rift/surfacebase/outside/west_caves)
"h" = (
/obj/effect/floor_decal/industrial/warning{
	dir = 4
	},
/turf/simulated/floor/concrete/lythios43c,
/area/rift/surfacebase/outside/west_caves)
"i" = (
/obj/structure/event/prop/covered_crawler,
/turf/simulated/floor/concrete/lythios43c,
/area/rift/surfacebase/outside/west_caves)
"j" = (
/obj/structure/fence/door{
	dir = 4
	},
/turf/simulated/floor/concrete/lythios43c,
/area/rift/surfacebase/outside/west_caves)
"k" = (
/obj/effect/floor_decal/industrial/warning{
	dir = 1
	},
/obj/random/multiple/large_corp_crate,
/turf/simulated/floor/concrete/lythios43c,
/area/rift/surfacebase/outside/west_caves)
"l" = (
/obj/structure/fence{
	dir = 1
	},
/turf/simulated/floor/concrete/lythios43c,
/area/rift/surfacebase/outside/west_caves)
"m" = (
/obj/effect/floor_decal/industrial/warning,
/obj/effect/floor_decal/industrial/warning{
	dir = 8
	},
/obj/effect/floor_decal/industrial/warning{
	dir = 8
	},
/obj/effect/floor_decal/industrial/warning{
	dir = 1
	},
/turf/simulated/floor/concrete/lythios43c,
/area/rift/surfacebase/outside/west_caves)
"n" = (
/obj/machinery/floodlight,
/turf/simulated/floor/concrete/lythios43c,
/area/rift/surfacebase/outside/west_caves)
"p" = (
/obj/structure/fence{
	dir = 1
	},
/obj/structure/fence{
	dir = 1
	},
/turf/simulated/floor/concrete/lythios43c,
/area/rift/surfacebase/outside/west_caves)
"q" = (
/turf/template_noop,
/area/template_noop)
"r" = (
/obj/effect/floor_decal/industrial/warning{
	dir = 1
	},
/turf/simulated/floor/concrete/lythios43c,
/area/rift/surfacebase/outside/west_caves)
"s" = (
/obj/structure/fence,
/turf/simulated/floor/concrete/lythios43c,
/area/rift/surfacebase/outside/west_caves)
"t" = (
/obj/structure/fence/door/locked{
	dir = 1
	},
/turf/simulated/floor/concrete/lythios43c,
/area/rift/surfacebase/outside/west_caves)
"u" = (
/obj/effect/floor_decal/industrial/warning,
/obj/effect/map_effect/radiation_emitter,
/turf/simulated/floor/concrete/lythios43c,
/area/rift/surfacebase/outside/west_caves)
"v" = (
/obj/structure/boulder,
/obj/structure/boulder,
/turf/simulated/floor/concrete/lythios43c,
/area/rift/surfacebase/outside/west_caves)
"w" = (
/obj/structure/boulder,
/obj/effect/floor_decal/industrial/warning,
/turf/simulated/floor/concrete/lythios43c,
/area/rift/surfacebase/outside/west_caves)
"x" = (
/obj/effect/floor_decal/industrial/warning{
	dir = 1
	},
/obj/structure/closet/crate/radiation,
/obj/effect/map_effect/radiation_emitter/strong,
/turf/simulated/floor/concrete/lythios43c,
/area/rift/surfacebase/outside/west_caves)
"y" = (
/obj/structure/sign/signnew/radiation,
/turf/simulated/wall/r_wall/prepainted,
/area/rift/surfacebase/outside/west_caves)
"z" = (
/obj/effect/floor_decal/industrial/warning{
	dir = 1
	},
/obj/random/multiple/corp_crate/no_weapons,
/turf/simulated/floor/concrete/lythios43c,
/area/rift/surfacebase/outside/west_caves)
"B" = (
/obj/structure/event/prop/mining_truck,
/turf/simulated/floor/concrete/lythios43c,
/area/rift/surfacebase/outside/west_caves)
"C" = (
/obj/structure/fence{
	dir = 4
	},
/turf/simulated/floor/concrete/lythios43c,
/area/rift/surfacebase/outside/west_caves)
"D" = (
/obj/effect/floor_decal/industrial/warning,
/obj/structure/event/prop/covered_crawler,
/turf/simulated/floor/concrete/lythios43c,
/area/rift/surfacebase/outside/west_caves)
"E" = (
/turf/simulated/wall/r_wall/prepainted,
/area/rift/surfacebase/outside/west_caves)
"H" = (
/obj/structure/event/prop/mining_truck,
/obj/effect/map_effect/radiation_emitter,
/turf/simulated/floor/concrete/lythios43c,
/area/rift/surfacebase/outside/west_caves)
"I" = (
/obj/effect/floor_decal/industrial/warning{
	dir = 1
	},
/obj/random/trash_pile,
/turf/simulated/floor/concrete/lythios43c,
/area/rift/surfacebase/outside/west_caves)
"J" = (
/obj/structure/boulder,
/obj/effect/floor_decal/industrial/warning,
/obj/effect/floor_decal/industrial/warning{
	dir = 1
	},
/turf/simulated/floor/concrete/lythios43c,
/area/rift/surfacebase/outside/west_caves)
"K" = (
/obj/structure/fence{
	dir = 8
	},
/turf/simulated/floor/concrete/lythios43c,
/area/rift/surfacebase/outside/west_caves)
"L" = (
/obj/random/trash_pile,
/turf/simulated/floor/concrete/lythios43c,
/area/rift/surfacebase/outside/west_caves)
"M" = (
/turf/simulated/floor/concrete/lythios43c,
/area/rift/surfacebase/outside/west_caves)
"O" = (
/obj/effect/floor_decal/industrial/warning{
	dir = 1
	},
/obj/random/multiple/minevault,
/turf/simulated/floor/concrete/lythios43c,
/area/rift/surfacebase/outside/west_caves)
"P" = (
/obj/structure/event/prop/crawler,
/turf/simulated/floor/concrete/lythios43c,
/area/rift/surfacebase/outside/west_caves)
"Q" = (
/obj/structure/boulder,
/turf/simulated/floor/concrete/lythios43c,
/area/rift/surfacebase/outside/west_caves)
"R" = (
/obj/effect/floor_decal/industrial/warning{
	dir = 4
	},
/obj/random/trash_pile,
/turf/simulated/floor/concrete/lythios43c,
/area/rift/surfacebase/outside/west_caves)
"T" = (
/obj/effect/map_effect/radiation_emitter/strong,
/turf/simulated/floor/concrete/lythios43c,
/area/rift/surfacebase/outside/west_caves)
"V" = (
/obj/effect/floor_decal/industrial/warning{
	dir = 10
	},
/turf/simulated/floor/concrete/lythios43c,
/area/rift/surfacebase/outside/west_caves)
"X" = (
/obj/effect/floor_decal/industrial/warning{
	dir = 8
	},
/turf/simulated/floor/concrete/lythios43c,
/area/rift/surfacebase/outside/west_caves)
"Y" = (
/obj/random/crystal/ice,
/turf/simulated/mineral/floor/icerock/lythios43c/indoors/ignore_cavegen,
/area/rift/surfacebase/outside/west_caves)
"Z" = (
/obj/structure/closet/crate/freezer/rations,
/turf/simulated/floor/concrete/lythios43c,
/area/rift/surfacebase/outside/west_caves)

(1,1,1) = {"
q
q
q
q
q
q
q
a
a
a
a
a
a
a
q
q
q
b
b
b
"}
(2,1,1) = {"
q
q
q
q
q
q
a
a
a
a
a
a
a
a
a
a
b
b
b
b
"}
(3,1,1) = {"
q
q
q
q
a
a
a
a
a
a
a
Y
b
a
a
b
b
b
b
b
"}
(4,1,1) = {"
q
q
q
a
a
a
a
a
a
a
E
b
b
b
b
b
b
b
b
q
"}
(5,1,1) = {"
q
q
a
E
E
E
E
E
E
E
y
l
p
l
l
y
b
b
a
q
"}
(6,1,1) = {"
q
a
a
E
Z
H
r
B
z
i
k
P
r
f
r
K
b
a
a
a
"}
(7,1,1) = {"
q
a
a
E
M
M
r
M
r
M
r
T
r
M
r
t
b
a
a
a
"}
(8,1,1) = {"
a
a
a
E
M
M
M
M
M
M
M
M
M
M
r
y
b
Y
a
a
"}
(9,1,1) = {"
a
a
b
C
M
M
n
M
M
M
M
M
M
M
r
K
b
b
a
a
"}
(10,1,1) = {"
a
a
Y
y
R
h
M
M
r
P
O
d
L
M
r
K
b
a
a
q
"}
(11,1,1) = {"
a
a
b
C
M
g
M
M
x
M
r
c
M
M
r
K
b
a
a
q
"}
(12,1,1) = {"
a
a
b
C
M
M
M
M
M
M
M
M
M
M
r
E
a
a
a
q
"}
(13,1,1) = {"
a
a
a
E
X
V
M
M
M
M
M
M
M
M
r
E
a
a
q
q
"}
(14,1,1) = {"
a
a
a
E
M
w
M
M
M
m
M
D
M
M
r
E
a
a
q
q
"}
(15,1,1) = {"
a
a
a
E
M
w
Q
L
M
J
M
u
M
M
I
E
a
q
q
q
"}
(16,1,1) = {"
a
a
E
y
j
E
Q
v
Q
E
y
s
s
e
s
y
a
q
q
q
"}
(17,1,1) = {"
q
b
b
b
b
E
Q
Q
Q
E
a
b
b
b
b
b
q
q
q
q
"}
(18,1,1) = {"
q
q
b
b
a
E
E
E
E
E
a
a
b
b
b
q
q
q
q
q
"}
(19,1,1) = {"
q
q
q
a
a
a
a
a
a
a
a
a
q
q
q
q
q
q
q
q
"}
(20,1,1) = {"
q
q
q
q
q
q
a
a
a
a
a
q
q
q
q
q
q
q
q
q
"}
