//MAP CONVERTED BY dmm2tgm.py THIS HEADER COMMENT PREVENTS RECONVERSION, DO NOT REMOVE
"a" = (
/turf/simulated/wall/lythios43c,
/area/rift/surfacebase/outside/west_caves)
"b" = (
/obj/structure/table/standard,
/obj/item/reagent_containers/food/drinks/cans/empty,
/turf/simulated/floor/lythios43c/indoors,
/area/rift/surfacebase/outside/west_caves)
"c" = (
/obj/structure/sandbag,
/obj/item/ammo_casing/spent,
/turf/simulated/floor/lythios43c/indoors,
/area/rift/surfacebase/outside/west_caves)
"e" = (
/turf/simulated/mineral/icerock/ignore_cavegen/lythios43c,
/area/rift/surfacebase/outside/west_caves)
"f" = (
/obj/item/ammo_casing/spent,
/turf/simulated/floor/lythios43c/indoors,
/area/rift/surfacebase/outside/west_caves)
"n" = (
/obj/effect/floor_decal/rust,
/turf/simulated/floor/lythios43c/indoors,
/area/rift/surfacebase/outside/west_caves)
"r" = (
/obj/structure/sign/warning/lethal_turrets{
	name = "\improper LIVE RANGE"
	},
/turf/simulated/wall/lythios43c,
/area/rift/surfacebase/outside/west_caves)
"u" = (
/turf/template_noop,
/area/template_noop)
"y" = (
/obj/machinery/crystal/ice,
/turf/simulated/mineral/floor/icerock/lythios43c/indoors/ignore_cavegen,
/area/rift/surfacebase/outside/west_caves)
"A" = (
/turf/simulated/mineral/floor/icerock/lythios43c/indoors/ignore_cavegen,
/area/rift/surfacebase/outside/west_caves)
"C" = (
/obj/effect/floor_decal/rust,
/obj/item/ammo_casing/spent,
/turf/simulated/floor/lythios43c/indoors,
/area/rift/surfacebase/outside/west_caves)
"F" = (
/obj/effect/floor_decal/rust,
/obj/structure/table/rack/shelf/steel,
/obj/random/maintenance/security,
/obj/random/maintenance/security,
/obj/random/maintenance/security,
/obj/random/maintenance/security,
/obj/random/maintenance/security,
/obj/random/maintenance/security,
/obj/random/maintenance/security,
/obj/random/maintenance/security,
/obj/random/maintenance/security,
/obj/random/maintenance/security,
/obj/random/maintenance/security,
/turf/simulated/floor/lythios43c/indoors,
/area/rift/surfacebase/outside/west_caves)
"K" = (
/obj/structure/barricade/cutout,
/turf/simulated/floor/lythios43c/indoors,
/area/rift/surfacebase/outside/west_caves)
"N" = (
/obj/item/ammo_casing/spent,
/obj/effect/floor_decal/rust,
/turf/simulated/floor/lythios43c/indoors,
/area/rift/surfacebase/outside/west_caves)
"S" = (
/obj/structure/sandbag,
/obj/effect/floor_decal/rust,
/turf/simulated/floor/lythios43c/indoors,
/area/rift/surfacebase/outside/west_caves)
"T" = (
/obj/structure/sandbag,
/turf/simulated/floor/lythios43c/indoors,
/area/rift/surfacebase/outside/west_caves)
"U" = (
/turf/simulated/floor/lythios43c/indoors,
/area/rift/surfacebase/outside/west_caves)
"W" = (
/obj/structure/table/standard,
/turf/simulated/floor/lythios43c/indoors,
/area/rift/surfacebase/outside/west_caves)
"Y" = (
/obj/structure/table/rack/shelf/steel,
/obj/random/maintenance/security,
/obj/random/maintenance/security,
/obj/random/maintenance/security,
/obj/random/maintenance/security,
/obj/random/maintenance/security,
/obj/random/maintenance/security,
/obj/random/maintenance/security,
/obj/random/maintenance/security,
/obj/random/maintenance/security,
/obj/random/maintenance/security,
/obj/random/maintenance/security,
/obj/item/clothing/head/tajaran/army_commissar,
/turf/simulated/floor/lythios43c/indoors,
/area/rift/surfacebase/outside/west_caves)

(1,1,1) = {"
u
u
e
e
e
e
e
e
e
e
e
e
e
u
u
u
u
u
"}
(2,1,1) = {"
u
e
e
e
a
a
a
a
a
a
a
a
a
e
u
u
u
u
"}
(3,1,1) = {"
e
e
e
a
a
Y
F
r
n
f
U
U
U
A
A
u
u
u
"}
(4,1,1) = {"
e
e
e
a
U
n
n
n
n
n
U
U
U
A
y
A
u
u
"}
(5,1,1) = {"
e
e
a
a
n
n
n
a
a
a
N
f
a
A
A
A
A
e
"}
(6,1,1) = {"
e
e
a
K
U
n
n
n
n
T
N
n
f
A
A
A
A
e
"}
(7,1,1) = {"
e
e
a
U
U
b
n
n
n
S
C
C
U
A
A
A
e
e
"}
(8,1,1) = {"
e
e
a
U
K
W
n
n
n
c
n
n
U
A
A
A
e
e
"}
(9,1,1) = {"
e
e
a
U
U
b
U
U
C
S
C
C
n
A
A
e
e
e
"}
(10,1,1) = {"
e
e
a
K
U
U
U
U
U
S
C
n
C
A
A
e
e
u
"}
(11,1,1) = {"
e
e
a
T
a
a
a
a
T
a
n
C
a
y
A
e
e
u
"}
(12,1,1) = {"
e
e
A
A
A
A
A
A
A
A
A
A
A
A
e
e
u
u
"}
(13,1,1) = {"
e
A
A
A
A
y
A
A
A
A
A
A
A
e
e
e
u
u
"}
(14,1,1) = {"
A
A
A
A
A
A
A
A
e
e
A
A
A
A
A
u
u
u
"}
(15,1,1) = {"
u
A
A
e
e
e
e
e
e
e
e
A
A
A
u
u
u
u
"}
