//MAP CONVERTED BY dmm2tgm.py THIS HEADER COMMENT PREVENTS RECONVERSION, DO NOT REMOVE
"a" = (
/turf/simulated/wall/lead,
/area/submap/lythios/west_caves/buried_structure)
"d" = (
/obj/structure/sign/signnew/radiation,
/turf/simulated/wall/lead,
/area/submap/lythios/west_caves/buried_structure)
"l" = (
/turf/template_noop,
/area/template_noop)
"K" = (
/obj/effect/floor_decal/rust,
/obj/effect/map_effect/radiation_emitter,
/obj/structure/closet/crate,
/obj/item/fuelrod/plutonium,
/obj/item/fuelrod/plutonium,
/obj/item/fuelrod/plutonium,
/obj/item/fuelrod/uranium,
/obj/item/fuelrod/uranium,
/obj/item/fuelrod/uranium,
/obj/random/ammo_all,
/obj/random/medical/pillbottle,
/obj/item/storage/single_use/mre/random,
/obj/item/storage/single_use/mre/random,
/obj/item/storage/single_use/mre/random,
/obj/item/storage/single_use/mre/random,
/turf/simulated/floor/lythios43c/indoors,
/area/submap/lythios/west_caves/buried_structure)

(1,1,1) = {"
l
l
l
l
l
"}
(2,1,1) = {"
l
d
a
d
l
"}
(3,1,1) = {"
l
a
K
a
l
"}
(4,1,1) = {"
l
d
a
d
l
"}
(5,1,1) = {"
l
l
l
l
l
"}
