//MAP CONVERTED BY dmm2tgm.py THIS HEADER COMMENT PREVENTS RECONVERSION, DO NOT REMOVE
"a" = (
/turf/simulated/mineral/floor/icerock/lythios43c/indoors/ignore_cavegen,
/area/rift/surfacebase/outside/west_caves)
"m" = (
/obj/random/crystal/normal_ice,
/turf/simulated/mineral/floor/icerock/lythios43c/indoors/ignore_cavegen,
/area/rift/surfacebase/outside/west_caves)
"w" = (
/turf/template_noop,
/area/template_noop)

(1,1,1) = {"
w
w
m
w
w
w
"}
(2,1,1) = {"
w
a
a
a
w
w
"}
(3,1,1) = {"
w
a
m
a
w
w
"}
(4,1,1) = {"
w
m
a
a
m
w
"}
(5,1,1) = {"
w
w
a
a
w
w
"}
(6,1,1) = {"
w
w
w
w
w
w
"}
