//MAP CONVERTED BY dmm2tgm.py THIS HEADER COMMENT PREVENTS RECONVERSION, DO NOT REMOVE
"a" = (
/turf/simulated/mineral/icerock/ignore_cavegen/lythios43c,
/area/rift/surfacebase/outside/west_caves)
"c" = (
/obj/item/barrier_tape_segment/engineering,
/turf/simulated/floor/lythios43c/indoors,
/area/submap/lythios/west_caves/buried_structure)
"g" = (
/obj/structure/table/rack/shelf/steel,
/obj/fiftyspawner/glass,
/obj/fiftyspawner/steel,
/obj/fiftyspawner/rods,
/turf/simulated/floor/lythios43c/indoors,
/area/submap/lythios/west_caves/buried_structure)
"j" = (
/obj/effect/floor_decal/rust,
/turf/simulated/floor/lythios43c/indoors,
/area/submap/lythios/west_caves/buried_structure)
"o" = (
/turf/simulated/mineral/icerock/ignore_cavegen/lythios43c,
/area/submap/lythios/west_caves/buried_structure)
"r" = (
/turf/simulated/wall/lythios43c,
/area/submap/lythios/west_caves/buried_structure)
"s" = (
/obj/structure/girder,
/turf/simulated/floor/lythios43c/indoors,
/area/submap/lythios/west_caves/buried_structure)
"u" = (
/obj/effect/floor_decal/rust,
/obj/item/storage/toolbox/mechanical,
/obj/item/storage/toolbox/electrical,
/obj/structure/table/rack/steel,
/turf/simulated/floor/lythios43c/indoors,
/area/submap/lythios/west_caves/buried_structure)
"v" = (
/obj/item/storage/box/lights/mixed,
/obj/structure/table/rack/shelf/steel,
/turf/simulated/floor/lythios43c/indoors,
/area/submap/lythios/west_caves/buried_structure)
"x" = (
/turf/simulated/mineral/floor/icerock/lythios43c/indoors/ignore_cavegen,
/area/rift/surfacebase/outside/west_caves)
"A" = (
/obj/machinery/power/apc/alarms_hidden/north_bump{
	start_charge = 0
	},
/turf/simulated/floor/lythios43c/indoors,
/area/submap/lythios/west_caves/buried_structure)
"B" = (
/obj/machinery/door/airlock/maintenance_hatch,
/obj/item/barrier_tape_segment/engineering,
/turf/simulated/floor/lythios43c/indoors,
/area/submap/lythios/west_caves/buried_structure)
"D" = (
/turf/template_noop,
/area/template_noop)
"K" = (
/obj/machinery/power/port_gen/pacman,
/turf/simulated/floor/lythios43c/indoors,
/area/submap/lythios/west_caves/buried_structure)
"S" = (
/obj/machinery/space_heater,
/turf/simulated/floor/lythios43c/indoors,
/area/submap/lythios/west_caves/buried_structure)
"V" = (
/turf/simulated/floor/lythios43c/indoors,
/area/submap/lythios/west_caves/buried_structure)
"Z" = (
/obj/item/storage/briefcase/inflatable{
	pixel_x = -2;
	pixel_y = -2
	},
/obj/structure/table/rack/steel,
/obj/item/stack/cable_coil/random,
/turf/simulated/floor/lythios43c/indoors,
/area/submap/lythios/west_caves/buried_structure)

(1,1,1) = {"
D
D
D
D
D
D
D
D
D
D
D
D
D
D
D
D
D
D
D
D
"}
(2,1,1) = {"
D
D
D
D
D
D
a
a
a
a
a
a
a
a
a
a
D
D
D
D
"}
(3,1,1) = {"
D
D
r
r
r
r
r
r
o
o
o
o
o
r
r
r
r
r
D
D
"}
(4,1,1) = {"
D
a
r
j
j
V
V
V
V
o
o
V
V
V
V
V
V
r
D
D
"}
(5,1,1) = {"
D
x
r
j
V
j
j
V
V
r
r
V
V
V
V
j
V
r
D
D
"}
(6,1,1) = {"
D
x
r
V
V
j
j
V
j
j
V
V
j
V
V
V
V
r
D
D
"}
(7,1,1) = {"
D
x
r
V
V
j
j
j
j
j
V
V
V
V
j
j
V
r
D
D
"}
(8,1,1) = {"
x
x
r
V
j
j
V
V
s
s
s
s
V
V
j
j
V
r
a
D
"}
(9,1,1) = {"
x
x
r
V
V
V
V
s
s
g
K
s
s
j
V
j
V
r
a
D
"}
(10,1,1) = {"
x
x
c
V
V
V
V
r
S
V
V
Z
r
V
V
r
r
r
a
D
"}
(11,1,1) = {"
x
x
c
V
V
V
V
r
A
V
V
u
r
V
V
r
r
r
a
D
"}
(12,1,1) = {"
x
x
r
V
V
V
V
r
r
V
v
s
s
V
V
V
V
r
a
D
"}
(13,1,1) = {"
D
x
r
V
V
j
j
j
r
B
r
s
V
V
V
V
j
r
a
D
"}
(14,1,1) = {"
D
x
r
V
V
j
j
j
V
V
j
V
V
V
V
V
j
r
a
D
"}
(15,1,1) = {"
D
x
r
V
V
V
V
j
j
j
V
V
V
V
V
j
j
r
a
D
"}
(16,1,1) = {"
D
D
r
V
V
V
V
V
V
r
r
V
V
V
j
j
j
r
a
D
"}
(17,1,1) = {"
D
a
o
j
V
V
j
j
j
o
r
V
j
j
j
j
j
r
a
a
"}
(18,1,1) = {"
D
a
o
o
r
r
r
r
o
o
r
r
o
o
o
o
o
o
a
a
"}
(19,1,1) = {"
D
D
a
a
a
a
a
a
a
a
a
a
a
a
a
a
a
a
a
a
"}
(20,1,1) = {"
D
D
D
D
D
D
D
D
a
a
a
a
a
D
D
D
a
a
a
a
"}
