"a" = (/turf/unsimulated/wall,/area/space)
"b" = (/obj/structure/flora/tree/dead,/turf/simulated/floor/outdoors/snow,/area/tether_away/snowfields/unexplored/near)
"c" = (/turf/simulated/floor/outdoors/snow,/area/tether_away/snowfields/unexplored/near)
"d" = (/turf/simulated/floor/outdoors/snow,/area/tether_away/snowfields/unexplored/far)
"e" = (/turf/simulated/floor/outdoors/snow,/area/tether_away/snowfields/explored/near)
"f" = (/turf/simulated/floor/outdoors/snow,/area/tether_away/snowfields/explored/far)
"g" = (/turf/simulated/floor/outdoors/snow,/area/shuttle/excursion/away_snowfields)
"h" = (/obj/shuttle_connector/snowfields,/turf/simulated/floor/outdoors/snow,/area/tether_away/snowfields/explored/near)
"i" = (/obj/structure/flora/tree/pine,/turf/simulated/floor/outdoors/snow,/area/tether_away/snowfields/unexplored/near)
"j" = (/obj/structure/flora/tree/pine,/turf/simulated/floor/outdoors/snow,/area/tether_away/snowfields/unexplored/far)
"k" = (/obj/structure/flora/tree/pine,/turf/simulated/floor/outdoors/snow,/area/tether_away/snowfields/explored/far)
"l" = (/mob/living/simple_animal/hostile/tree,/turf/simulated/floor/outdoors/snow,/area/tether_away/snowfields/unexplored/near)
"m" = (/obj/structure/flora/tree/dead,/turf/simulated/floor/outdoors/snow,/area/tether_away/snowfields/unexplored/far)
"n" = (/obj/structure/flora/tree/dead,/turf/simulated/floor/outdoors/snow,/area/tether_away/snowfields/explored/near)
"o" = (/obj/tether_away_spawner/snowfields_hard,/turf/simulated/floor/outdoors/snow,/area/tether_away/snowfields/unexplored/far)
"p" = (/obj/tether_away_spawner/snowfields_medium,/turf/simulated/floor/outdoors/snow,/area/tether_away/snowfields/unexplored/far)
"q" = (/obj/tether_away_spawner/snowfields_boss,/turf/simulated/floor/outdoors/snow,/area/tether_away/snowfields/unexplored/far)
"r" = (/obj/tether_away_spawner/snowfields_medium,/turf/simulated/floor/outdoors/snow,/area/tether_away/snowfields/unexplored/near)
"s" = (/obj/tether_away_spawner/snowfields_easy,/turf/simulated/floor/outdoors/snow,/area/tether_away/snowfields/unexplored/far)
"t" = (/obj/tether_away_spawner/snowfields_diyaab,/turf/simulated/floor/outdoors/snow,/area/tether_away/snowfields/unexplored/far)
"u" = (/obj/tether_away_spawner/snowfields_easy,/turf/simulated/floor/outdoors/snow,/area/tether_away/snowfields/unexplored/near)
"v" = (/obj/tether_away_spawner/snowfields_passive,/turf/simulated/floor/outdoors/snow,/area/tether_away/snowfields/unexplored/near)
"w" = (/obj/tether_away_spawner/snowfields_passive,/turf/simulated/floor/outdoors/snow,/area/tether_away/snowfields/unexplored/far)
"x" = (/obj/tether_away_spawner/snowfields_diyaab,/turf/simulated/floor/outdoors/snow,/area/tether_away/snowfields/unexplored/near)
"y" = (/obj/tether_away_spawner/underdark_hard,/turf/simulated/floor/outdoors/snow,/area/tether_away/snowfields/unexplored/near)
"z" = (/obj/tether_away_spawner/snowfields_hard,/turf/simulated/floor/outdoors/snow,/area/tether_away/snowfields/unexplored/near)

(1,1,1) = {"
aaaaaaaaaaaaaaaaaaaaaaaaaaaaaaaaaaaaaaaaaaaaaaaaaaaaaaaaaaaaaaaaaaaaaaaaaaaaaaaaaaaaaaaaaaaaaaaaaaaaaaaaaaaaaaaaaaaaaaaaaaaaaaaaaaaaaaaaaaaa
accccccccccccccccccccccccccccccccccccccccccccccccccccccccdddddddddddddddddddddddddddddddddddddddddddddddddddddddddddddddddddddddddddddddddda
accccccccccccccccccccccccccccccccccccccccccccccccccccccccdddddddddddddddddddddddddddddddddddddddddddddddmdddddddddddddddddddddddddddddddddda
acccccccccccccccccccccccccbcccccccccccccccccccccccccbccccdddjdddddddddddddddodddddddddddddmdddddddddddddddddddddddddddddddddddddddddddmdddda
accccccccccccccccccccccccccccccccccccicccccccccccccccccccdddddddmdddddddddddddddddddjdddpddddddjdddddddddddddddddddjddddddddddddddddddddddda
accccciccccccccccccccccccccccccccccccccccccccccccccccccccddddddddddddddddddddddddddddddddddddddddddddddddddddddddddddddddddjddddddddddddddda
accccccccccccccccccbccccccccccccccccczcccccccccccccccccccddddddddddddddddddddddddddddddddddddddddddddddddddddddddddddpddddddddddddddddddddda
accccccccccccccccccccccccccccccccccccccccccccccccccccccccddddddddddddddddjdddddddddddddddddjddddddddddddddddddddddddddddddddddddddddddddddda
accccccccccccccccccccccccccccccccccccccccccccccccccccccccdddddddddddddddddddddddddddddddddddddddddddddddddddddddddmddddddddqdddddddjddddddda
accccrcccccccccccccccccccccccccccccccccccccccccccccccccccddddddddpdddddddddddddddjdddddddddddddddddmddddddddddddddddddddddddddddddddddddddda
accccccccccccccccccccccccccccccccccccccccccccccccicccccccdddddddddddddddddddddddddddddddddddddpddddddddddddddddddddddddddddddddddddddddmddda
acccccbccccccccccccccccccccccccccccccccccccccccccccccccccdddddddddddddddddddddddddddddddddddddddddddddddddddddddddddddddddddddddddddddddddda
acccccccccccccccccccccccccccicccccccccccbccccccccccccccccddddddddddddddddddddmddddddddddddddddddddddddddddddddsdddddddddddddddddddddddddddda
acccccccccccccccccccccccccccccccccbccccccccccccccccccccccddddjddddddddjdddddddddddddddddddddddddddddddddddddddddddddddddddddmdddddddddddddda
accccccccccccccccccccccccccccccccccccccccccccccrcccccccccddddddmdddddddddddddddddddddddddddddddddddddddddddjddddddddddddddddddddddddddddddda
accccccccccccccciccccccccccccccccccccccccccccccccccccccccdddddddddddddddddddddddddddddddddddddddddddddddddddddddddddddddddddddddddddddodddda
accciccccccccccccccccccccccccccccccccccccccccccccccccccccdddddddddddddddddddddddjdddddddddddddddddddddsdddddddddddddddddddddddddddddddddddda
accccccccccccccccccccccccccccccccccccccccccccccccccccccccdddddddddddddddddddddddddddddddddddddddddddddddddddddddddddddddddddddddddddddddddda
accccccccccccccccccccccccccccccccccccccccicccccccccccccccdddddddddddddddddddddddddpddddddddddjdddddjddddddddddddddddddddpdddddddddddddddddda
accccccccccccccccccccccccccccccccccccccccccccccccccccccccddddddddddddddddddddddddddddddddddddddddddddddddddddddddddddddddddddddddddddmddddda
accccccccccccccccccccccccccccccccccccccccccccccccccccccccdddddddddjdddddddddddddddddddddddddddddddddddddddddddddddddjdddddddddddddddddddddda
accccccccccccccccccccccccccccciccccccccccccccccccccccccccddtddddddddddddddddddddddddddddddddddddddddddddddmddddddddddddddddddjddddddddddddda
accccccccccccccccbcccccccccccccccccccccccccccccccccccbcccddddtddddddddddddddddddddddddddmdddddddddddddddddddddddddddddddddddddddddddddddddda
acccccccccccicccccccccccicccccccccccccccccccccciccccccccctddddddddddddddddddddddddddddddddddddddddddddddddddddddddddddddddddddddddddddddddda
accccccccccccccccccccccccccccccccccccccccccccccccccccccccddddtddddddddddddddddddddddddddddddddddddddddddddddddddddddddddddddddddddddddddddda
accccccccccccccccccccccccccccccccccccccccccccccccccccccciddtddddddddddddddddddddddddddddpdddddddddddddddddddddddddsddddddddddddddddddddjddda
accccccccccccccccccccccccccccccccccccccccccccccccccccccccdddddddmdddddddddddddddddjddddddddddddmdddddddddddddddddddddddddddddddddmddddddddda
accicccccccccccccccccccccccccccccccciccccccccccccccccccccdddddddddddddddddddddddddddddddddddddddddddddddddddddddddddddddddddddddddddddddddda
accccccccccccccccccccccccccccccccccccccccccccccccccccccccddddddddddddddddddddddddddddddddddddddddddddddddddddddddjddddddddddddddodddddddddda
accccccccccccccccccccccvccccccccccccccuccccccccccccccccccdddddddddddddddddddddddddddddddddddddddddddddddddddddddddddddddddddddddddddddddddda
accccccccccccccccccccccccccccccccccccccccccccccccccccccccdddddddddddddddddddddddddddddddddddddddddddddddddddddddddddddddddddddddddddddddddda
accccccccccccccccccccccccccccccccccccccccccccccccccccccccddddddddddddjdddddddddddddddddddddddddddddddjdddddddddddpdddddddddmdddddddjddddddda
acccccccccccccccccccccccccccccccccccccccbccccccccccccccccdddddddddddddddddddddddddddddddpdddddddddddddddddddddddddddddddddddddddddddddddddda
accccccccccccccicccccccccccciccccccccccccccccccccccccccccddjddddddddddddddddddddddddddddddddjdddddddddddddddddddddddddddddddddddddddddddddda
accccccccccccccccccccccccccccccccccccccccccccccccccccccccdddddddddddddddddddddddmddddddddddddddddddmddddddddddddddddddddddddddddddddddddddda
acccccuccccccccccccccccccccccccccccccccccccccccccccccccccddddddddddddddddddddddddddddddddddddddddddddddddddddjddddddddddddddddddddddddddddda
accccccccicccccccccccccccccccccccccccccccccccccccccccccccddddddddddddddddddddddddddddddddddddddddddddddddddddddddddddddddddddddddddddddddmda
acccccccccccccccccccccccccccccccccccccccccccccccccccccrccdddddddddddddddddddddddddddddddddddddddddddddddddddmddddddddddjddddddddddddddddddda
accccccccccccccccccccccccccccccccccccccccccccccccccccccccdddwddddddddjddddddddddddddddddddddddddddddddddddddddddddddddddddddddddddddddddddda
acccccccccccccccccccccccccccbcccccccciccccccccccbccccccccdddddddddddddddddddddddddddddddddddjdddddddddddddddddddddddddddddddddddddddddddddda
accccccccccccccccccciccccccccccccccccccccccccccccccccccccdddddddddddddddddddddddddddddddddddddddddddddddddddddddddddddddddddddddddddddddddda
acccccccccccccvccccccccccccccccccccccccccccccccccccccciccdddddddddddddddddddpddddddddddddddddddddddddoddddddddddddddmddddpddddddddmdddddddda
accccccccccccccccccccccccccccccccccccccccccccccccvcccccccdddddddddddddddddddddddddddddddsdddddddddddddddddddddddddddddddddddddddddddddddddda
accccccccccccccccccccccccccccccccccccccccccciccccccccccccdddddddddddddddddddddddddddddddddddddddmdddddddddddddddddddddddddddddddddddddddddda
acccccccccccicccccccccccccccccccrccccccccccccccccccccccccddddddddddddddddddddddddjdddddddddddddddddddddddjdddddddddddddddddddddjddddddddddja
accbcccccccccccccccccccccccccicccccccccccccccccccccccccccjdddddddddmddddddddddddddddddddddddddddddddddddddddddddddddddddddddddddddddddddddda
accccciccccccccccccccccccccccccccccccccccccccccccccccccccdddddddddddddddddddddddddddddddddddddddddddddddddddddddddddddddddddddddddddddddddda
acccccccccccccccbccccccccccccccccccccccccccccccccccccccccddddddddddddddddddddddddddddddddddddddddddddddddddddddmddddddddddddddddddddddddddda
accccccccccccccccccccccccccccccccccccccccccccccccccccccccdddddddddddddddddddddddddddddddddddddddddddddddddddddddddddddddddddddddddddsddmddda
accccccccccccccccccccccccccccccccccccccccccccccccccccccccdddddddddddddddddddddddddddddddddddddddddddddddddddddddddpddjddddddddddddddddddddda
acccccccccccccccccccccccccccccccccccccccccccccccccccccuccdddddddddddddddddddddddddddddddddddddddddddddddddddddddddddddddddddddddddddddddddda
accccccrccccccccccccccccccccvccccccccccccccccccccccccccccddddddddddddddddddddmdddddddddddddddddddddddddjddddddddddddddddddddddddddddddddddda
accccccccccccccccccccccccccccccccccccccccccccccccccccccccddjddddddddddddddddddddddddddddddddddddddddddddddddddddddddddddddddddddddddddddddda
accicccccccccccccccccccccccccccccccccccccccccccccccciccccdddddddddddddddddddddddddddddddddddddmddddddddddpdddddddddddddddddddddddddddjddddda
accccccccccccccccccccciccccccccccccccccccccccccccccccccccddddddddddjddddddddddddddddddddddddddddddddddddddddddddddddddddddddddddddddddddddda
accccccccccccccccccccccccccccccccccccccccccccccccccccccccddddddddddddddddddddddddddddddddjddddddddddddddddddddddddddddddddddddmdddddddddddda
accccccccccccccccccccccccccccccccccccicccccccccccccccccccdddddddddddddddddddddddddddddddddddpddddddddddddddddddddjddddodddddddddddddddddddda
acccccccccccccccccccccccccccccccccccccccccrccccccccccccccdddddddddddddddddddddddddddddddddddddddddddddddddddddddddddddddddddddddddddddddddda
acccccccccccccccccccccccccccccccccccccccccccccccbccccccccdddddddddddddddddddddddddddddddddddddddddddddddddddddddddddddddddddddddddddddddddda
accccccccccccccccccccccccccccccccccccccccccccccccccccccccdddddddddddddddddddddddjddddddddddddddddddddddddddmddddddddddddddddddddddddddddddda
accccccccccccccccccccccccccccccccccccccccccccccccccccccccdddddddddddddddddddddddddddddddddddddddddddddddddddddddddddddddddddddddjdddddddddda
accccucccccccccccciccccccccccvccccccccccccccccceeeeecccccdddddddddddddddddddddddddddddddddddddjdddddddddddddddddddddddddddddddddddddmdddddda
acccccccccccccccccccccccccccccccccccccccciccceeeeeeeeecccdddddddddddddddddddddddddddddddddddddddddddddddddddddddddddddddddddddddddddddddddda
acccccccccbcccccccccccccccccccccccccccccccceeneeeeeeeeeecddddddmddddddjddddddddddddmdddddddddddddddddddddddddddddddjddddddddddddddddddddddda
accccccccccccccccccccccccccccccccccccccccceeeeeeeeeeeeeeedddddddddddddddddddddddddddddddddddddddddddddddddddddddddddddddddddddddddddddddddda
acccccccccccccccccccccccccccccccccccccccceeeeeeeeeeeeeeeefdddddoddddddddddddddddddddddddddddddddddddmddddddddddddddddddddddddddddddoddddddda
accccccciccccccrcccccccccccccccccccccccceeeeeeeeeeeeeeeeeffddddddddddddddddddddddddddddddddjddddddddddddddddddddqdddddddddddddddddddddddddda
acccccccccccccccccccccccccccccicccccccceeeeeeeeeeeeeeeeeefkfddddddddddddddddddddddddddddddddddddddddddddddddddddddddddmddddddddddddddddddjda
acccccccccccccccccccccccccccccccccccccceeeeeeegggggggeeeefffddddddddddddddddddjddddddddddddddddpddddddddddddddddddddddddddddddddddddddddddda
accccccccccccccccccccccccccccccccccccceeeeeeegggggggggeeeffffddddddddddddddddddddddddddddddddddddddddddddddddddddddddddddddddddddmddddddddda
acccccccccccccccicccccccccccccccccccceeeeeeeegggggggggeeefffffddddddddddddddddddddddddddddddddddddddddddddddddddddddddddddddddddddddddddddda
acccccccccccccccccccccccccccccccccccceeeeeeeegggggggggeeefffffddddddddddddddddddddddddddddddddddddddddddddddddddddddddddddddddddddddddddddda
acccccccccccccccccccccccccccccccccccceeeeeeeegggggggggeeefffffddddddddddddddddddddddddddddddddddddddddddjddddddddddjddddddddddddddddddddddda
accccccccccccccccccccccccccccvccccccceeeeeeeegggggggggeeefffffddddddddddddddddddddddddddddddddddddddddddddddddddddddddddddddddddddddddddddda
accrcccbcccccccccccccccccbccccccccccceeeeeeeegggggggggeeefffffddddjdddddddddddddddddddddddddjdddddddddddddddddddddddddddddddddddddddddddddda
acccccccccccccccccccccccccccccccccccceeeeeeegggggggggggeefffffdddddddddddddddddddddddddddddddddddmddddddddddddddddddddddddddddddddddddddmdda
acccccccccccccccccccccccccccccccccccceeeeeeegggggggggggeefffffdddddddddddddddddddddddddddddddddddddddddddddddddddddddddddddddddjddddddddddda
accccccccccccccccccccccccccccccccccccceeeeeegggggggggggeeffffddddddddwddddddddddddddddddddddddddddddddddddddddddddddddddddddddddddddddddddda
accccccccccccccccccccccccccccccccccccieeeeeegggggggggggeeffffdddddddddddddddmddddddddddddddddddddddddddddddddddddmddddddddddddddddddddddddda
acccccccccccccccciccccccccccccccccccccceeeeegggggggggggeefffddddddddddddddddddddddddddddddddddddddddddddddddddddddddddddddddddddddddddjdddda
acccccccccccccccccccccccccccccccccccccceeeeeggggeegggggeefffdddddddddddjddddddddddddddddddddddddddddddddddddddddddddddddddddddddddddddddddda
accccccccccccccccccccccccccccccccccccccceeeegggeeeeegggeeffddmddddddddddddddddddddddddddddddjdddddddddsddddddddddddddddddddddddddddddoddddda
accccccccccccccccccccccccccccccccccccccceeeeeeeeeheeeeeeeffddddddddddddddddddddddjdddddddddddddddddddddddddddddddddpddddddddddddddddddddddda
acccccccccccccccccccccccccccccccccccccccceeeeeeeeeeeeeeeefddddddddddddddddddddddddddddddddddddddddddddddddddjddddddddddddddddmddddddddddddda
acccciccccccccccccccccccccccccccccccccccceeeeeeeeeeeeeeeefddddddddddddddddddddddddddddddddddddddddddddddddddddddddddddddddddddddddddddddddda
accccccccccccccccccccccccccccccccciccccccceeeeeeeeeeeeeeedddddddddddddddddddddddddddddddddddddddddddddddddddddddddddddddddddddddddddddddjdda
accccccccccccbcccccccccccccccrcccccccclcccceeeeeeeeeeeeecddddddddddddddddddddddddddddddddddddddddddddddddddddddddddddddddjddddddddddddddddda
accccccccccccccccccccccccccccccccccccccccccceeeeeeeeeeeccdddddddddddddddddddddddpdjddddddddddddddddmdddddddddddddddddddddddddddddddddmddddda
acccccccccccccvccccccccccccccccccccccccccccccceeeeeeeccccddddddddjddddddddjdddddddddddddddddddddjdddddddddddddddddddddddddddddddddddddddddda
accccccccbcccccccccccccccccicccccccccccccccccccceeeccbcccdddddddddddddddddddddddddddddddddmddddddddddddddddddddddddddddddddddmddddddddddddda
accccccccccccccccccccccccccccccccccccccccccccccccccccccccdddddddddddddddddddddddddddddddddddddddddddddddddddddddddddddddddddddddddddddddddda
accccccccccccccccccccccccccccccccccccccccccccccccccccccccdddddddddddddddddddddddddddddddddddddddddddddddddddddddddddddddddddddddddddddddddda
accccccccccccccccccccccccccccccccccccccccccccccccccccccccddddddddddddmddddddddddddddddddddddddddddddddddddddddddddddddddddddddddddddddddddda
accccccccccccccccccccccccccccccccccccccccccccccccccicccccdddddddpddddddddddddddddddddddddddddddddddddddddddddddjddddddddddddddddddddddddddda
acccccccccccccccccccccccccccccccccccccbccccccccccccccccccdddddddddddddddddddddddddddddddddddddddddddddddddddddddddddddddddddddddddsdddddddda
acccrccccccccccccccccccccccccccccccccccccccccccccccccccccddddddddddddddddddddddddddddddddjddddddddddddddddddddddddddddddddddddddddddjdddddda
acccccccccccccccxccccccccccccccccccccccccccccccccccccccccddddddddddddddddddddddddddddddddddddddddddddddmddddddddddddddddddddddddddddddddddda
accccccccccccccccccccccccccccccccccccccccccccccccccccccccddddddddddddddddddddjddddddmddddddddddddddddddddddddddddsddddddddddddddddddddddddda
accccccccccccccccccccxcccccccccccccccccccczccccccccccccccdddddddddddddddddddddddddddddddddddddddddddddddddddddddddddddddddddddddddddddddddda
accccccccccccccccbcccccccccccccccccccccccccccccccccccccccddddjdddddddddddddddddddddddddddddddddddddjdddddddddddddddddddddmddddddddddddddddda
acccccccccccccxcccccccccccccciccycccccccccccccccccccbccccdddddddddddddddddddddddddddddddddddddddddddddddddddddddddddddddddddddddddddddddddda
acccccccciccccccccxccccccccccccccccccccciccccccccccccccccddddddddddddddddddddddddddddddddddddddddddddddddddddddddddddddddddddddddddddddmddda
accccccccccccccccccccccccccccccccccccccccccccccccccccccccdddddddddddddddddddddddddddddddddddddddddddddddddddddddddddddddddddddddddddddddddda
acccccccccccccccccccccccccccccccbccccccccccccccccccccccccddddddddddddddddddjdddddddddddddddddddddddddddddddddddddddddddddddddddddjddddddddda
accccccccccccxcccccxcccciccccccccccccccccccccccccccccccccdddddddddddddddddddddddddddddddddddddddddddddddddddmdddddddddddddddddddddddddddddda
accccccccccccccccccccccccccccccccccccccccccccccccccccccccdddpddddddddddddddddddddddddddddddjddddddddoddddddddddddoddddddddddddddddddddddddda
accccccccccccccccccccccccccccccccccccccccccccccccccccccccdddddddddddddddddddddddddddddddddddddddddddddddddddddddddddddddddddddddddddddddddda
accccccccccccccccxcccccccccccccccccccccccccccccccccccccccdddddddjddmdddddddddddddddddddddddddddddddddddddddddddddddddddddjddddddddddddddddda
accccccccccccccccccccccccccccccccccccccccccccccccccccccccdddddddddddddddddddddddddddddddddddddddddddddddddddddddddddddddddddddddddddddddddda
accccccccccccccccccccccccccccccccccccccccccbcccccccccccccddddddddddddddddddddddddddjddddddddddmdddddddddddddddddddddddddddddddddddddddddddda
acicccccccccccccccccccccccbccccccccccccccccccccccccccccccdddddddddddddddddddddddddddddddddddddddddddddddddddddddddddddddddddddddddddddddjdda
accccccccccccccccccccccccccccccccccccccccccccccccccccccccjdddddddddddddddddddddddddddsddddddddddddddddddddddddddddddddddddddddddmdddddddddda
accccccccccccccccccccccccccccccccccccccccccccccccccccccccddddddddddddddddddddddddddddddddddddddddddddddddjddddddddddddddddddddddddddodddddda
acccccccccbccccccccccccccccccccccccccccccccccccccccccccccddddddddddddddddddddddmddddddddddddddddddddddddpddddddddmddddddddddddddddddddddddda
accccccccccccccccccccbcccccccccccccciccccccccccccccccccccdddddddddddddddddddddddddddddddddddddddddddddddddddddddddddddddddddddddddddddddddda
accccccccccccccccccccccccccccccccccccccccccccccccccccccccddddddddddddddddddddddddddddddddddddddddddddddddddddddddddddddddmddddddddddddddddda
accccccccccccccccccccccccccccccccccccccccccucccccccccccccddddddjdddddddddddddddddddddddddddddddddddmddddddddddddddddddddddddddddddddddddddda
accccccccccccccccccccccccccccccccccccccccccccccicccccccccdddddddddddddddwddddddddjddddddddddddddddddddddddddddddddddddddddddddjdddddddddddda
accccccccccccccccccccccccccccccrcccccccccccccccccccccccccddddddddddddddddddddddddddddddddddddddddddddddddddddddddddddddddddddddddddddddmddda
accccccccccccccccccccccccccccccccccccccccccccccccccccccccdddddddddddddddddddddddddddddddddddmdddddddddddddddddddddddddddddddddddddddddddddda
accvcccccccccccccccccccccccccccccccccccccccccccccccbcccccdddddddddddddddddddddddddddddddddddddjdddddddddddddddddddddddddddddddddddddddddddda
acccccccciccccczccccccccccicccccccccccccbccccccccccccccccdddddddddddddddddddddddddddddddddddddddddddddddddddddddddddddddddddddddddmdddddddda
accccccccccccccccccccccccccccccccccccccccccccccccccccccccdddmdddddddddddddddddddddddddddddddddddddddddddddddddjdddddddddddmdddddddddddddddda
accccccccccccccccccccccccccccccccccccccccccccccccccccccccdddddddddddddddddddddddddddddddddddddddddddddddddddddddddddddddddddddddddddddddddda
accccbcccccccccccccccccccccccccbcccccccccccccccccccccccccdddddddddddddddddddddddddddddddddddddddddddddddddddddddddddddddddddddddddddddddddda
accccccccccccccccccccccccccccccccccccccccccccccccccccccccddddddddddddddddddjdddddddddddddddpdddddddddddddddddddddddddqddddddddddddddddddddda
accccccccccccccccccccccccccccccccccccccccccccccccciccccccdddddddddddddddddddddddddddddddddddddddddddddddddddddddddddddddddddddddddddddddddda
acccccccccccccbccccccccccccccccccccccccccccccccccccccccccddddddddddddddddddddddddddddddddddddddddddddddsssddddddddddddddddddddddddddddddddda
accccccccccccccccccccccccccccccccccccccccccccccccccccccccddddddddddddddddddddddddddddddddddddddddddddddsssddddddddddddddddddddddddddddddddda
acccccccccccccccccccccccccccccccccccccccccccccccccccccccrdddddddddddddddddddddddddddddddddddddmdddddddddddddmddddddddddddddddddddddoddjdddda
accccccccccccccccccccccicccccccccccccccccccccccccccccccccdddddddddddddddddddddddddddddddddddddddddddddddddddddddddddddddddddjdddddddddddddda
accccccccccccccccccccccccccccccccccccciccccccccccccccccccdddddddddddddddddddddddddddddddddddddddddddddddddddddddddddddddddddddddddddddddddda
accccccccccccccccccccccccccccvcccccccccccccccccccccccccccddddjddddddddddddddddddddddddddddddddddddddddddddddddddddddddddddddddddddddddddddda
accicccccccccccccccccccccccccccccccccccccccccccccccccccccddddddddddddddddddddddddddddddddddddddddddddddddddddddddddddddddddsddddddddddddddda
acccccccccccccccccccccccbccccccccccccccccccccbcccccccccccdddddddddddddddddddddddddddddddddddddddddddddddddddddddddddddddddddddddddddddddddda
accccccccccccccccccccccccccccccccicccccccccccccccccccccccdddddddddddddddddddddmddddddddddjdddddddddjddddddddddddddddddddddddddddddddddmdddda
accccccccccccccccccccccccccccccccccccccccccccccccccccccccdddddddddddddddddddpddddddddddddddddddddddddddddddddddddjdddddddddddddmddddddddddda
accccccccccccccicccccccccccccccccccccccccccccccccccccccccdddddddddddddddddddddddddddddddddddddddddddddddddddddddddddddddddddddddddddddddddda
acccccbccccccccccccccccccccccccccccccccccccccciccccccccccddddddmddddddddddddddddddddddddddddddddddddddddddddddddddddddddddddddddddddddddddda
aaaaaaaaaaaaaaaaaaaaaaaaaaaaaaaaaaaaaaaaaaaaaaaaaaaaaaaaaaaaaaaaaaaaaaaaaaaaaaaaaaaaaaaaaaaaaaaaaaaaaaaaaaaaaaaaaaaaaaaaaaaaaaaaaaaaaaaaaaaa
"}
