"a" = (/turf/simulated/floor/snow/snow2,/area/space)
"b" = (/turf/simulated/floor/snow/snow2,/area/tether_away/cave/explored)
"c" = (/turf/simulated/floor/outdoors/snow,/area/space)
"d" = (/turf/unsimulated/wall,/area/space)
"e" = (/mob/living/simple_animal/corgi/Lisa,/turf/simulated/floor/outdoors/snow,/area/space)
"f" = (/turf/simulated/floor/outdoors/grass/sif/virgo3b,/area/space)
"g" = (/turf/simulated/floor/outdoors/grass/sif/forest,/area/space)
"h" = (/turf/simulated/floor/outdoors/ice,/area/space)
"i" = (/turf/simulated/floor/outdoors/rocks,/area/space)
"j" = (/turf/snow/snow2,/area/space)
"k" = (/turf/snow/plating,/area/space)
"l" = (/turf/snow/drift,/area/space)
"m" = (/turf/snow/gravsnow,/area/space)
"n" = (/turf/simulated/wall/iron,/area/space)
"o" = (/turf/simulated/wall/snowbrick,/area/space)
"p" = (/turf/simulated/wall/solidrock,/area/space)

(1,1,1) = {"
aaaaaaaaaaaaaaaaaaaaaaaaaaaaaaaaaaaaaaaaaaaaaaaaaaaaaaaaaaaaaaaaaaaaaaaaaaaaaaaaaaaaaaaaaaaaaaaaaaaaaaaaaaaaaaaaaaaaaaaaaaaaaaaaaaaaaaaaaaaa
abbbbbbbbbbbbbbbbbbbbbbbbbbbbbbbbbbbbbbbbbbbbbbbbbbbbbbbbbbbbbbbbbbbbbbbbbbbbbbbbbbbbbbbbbbbbbbbbbbbbbbbbbbbbbbbbbbbbbbbbbbbbbbbbbbbbbbbbbba
abccccccccccccccccccccccccccccccccccccccccccccccccccccccccccccccccccccccccccccccccccccccccccccccccccccccccccccccccccccccccccccccccccccccccba
abccccccccccccccccccccccccccccccccccccccccccccccccccccccccccccccccccccccccccccccccccccccccccccccccccccccccccccccccccccccccccccccccccccccccba
abccccccccccccccccccccccccccccccccccccccccccccccccccccccccccccccccccccccccccccccccccccccccccccccccccccccccccccccccccccccccccccccccccccccccba
abccccccccccccccccccccccccccccccccccccccccccccccccccccccccccccccccccccccccccccccccccccccccccccccccccccccccccccccccccccccccccccccccccccccccba
abccccccccccccccccccccccccccccccccccccccccccccccccccccccccccccccccccccccccccccccccccccccccccccccccccccccccccccccccccccccccccccccccccccccccba
abccccccccccccccccccccccccccccccccccccccccccccccccccccccccccccccccccccccccccccccccccccccccccccccccccccccccccccccccccccccccccccccccccccccccba
abccccccccccccccccccccccccccccccccccccccccccccccccccccccccccccccccccccccccccccccccccccccccccccccccccccccccccccccccccccccccccccccccccccccccba
abccccccccccccccccccccccccccccccccccccccccccccccccccccccccccccccccccccccccccccccccccccccccccccccccccccccccccccccccccccccccccccccccccccccccba
abccccccccccccccccccccccccccccccccccccccccccccccccccccccccccccccccccccccccccccccccccccccccccccccccccccccccccccccccccccccccccccccccccccccccba
abccccccccccccccccccccccccccccccccccccccccccccccccccccccccccccccccccccccccccccccccccccccccccccccccccccccccccccccccccccccccccccccccccccccccba
abccccccccccccccccccccccccccccccccccccccccccccccccccccccccccccccccccccccccccccccccccccccccccccccccccccccccccccccccccccccccccccccccccccccccba
abccccccccccccccccccccccccccccccccccccccccccccccccccccccccccccccccccccccccccccccccccccccccccccccccccccccccccccccccccccccccccccccccccccccccba
abccccccccccccccccccccccccccccccccccccccccccccccccccccccccccccccccccccccccccccccccccccccccccccccccccccccccccccccccccccccccccccccccccccccccba
abccccccccccccccccccccccccccccccccccccccccccccccccccccccccccccccccccccccccccccccccccccccccccccccccccccccccccccccccccccccccccccccccccccccccba
abccccccccccccccccccccccccccccccccccccccccccccccccccccccccccccccccccccccccccccccccccccccccccccccccccccccccccccccccccccccccccccccccccccccccba
abccccccccccccccccccccccccccccccccccccccccccccccccccccccccccccccccccccccccccccccccccccccccccccccccccccccccccccccccccccccccccccccccccccccccba
abccccccccccccccccccccccccccccccccccccccccccccccccccccccccccccccccccccccccccccccccccccccccccccccccccccccccccccccccccccccccccccccccccccccccba
abccccccccccccccccccccccccccccccccccccccccccccccccccccccccccccccccccccccccccccccccccccccccccccccccccccccccccccccccccccccccccccccccccccccccba
abccccccccccccccccccccccccccccccccccccccccccccccccccccccccccccccccccccccccccccccccccccccccccccccccccccccccccccccccccccccccccccccccccccccccba
abccccccccccccccccccccccccccccccccccccccccccccccccccccccccccccccccccccccccccccccccccccccccccccccccccccccccccccccccccccccccccccccccccccccccba
abccccccccccccccccccccccccccccccccccccccccccccccccccccccccccccccccccccccccccccccccccccccccccccccccccccccccccccccccccccccccccccccccccccccccba
abccccccccccccccccccccccccccccccccccccccccccccccccccccccccccccccccccccccccccccccccccccccccccccccccccccccccccccccccccccccccccccccccccccccccba
abccccccccccccccccccccccccccccccccccccccccccccccccccccccccccccccccccccccccccccccccccccccccccccccccccccccccccccccccccccccccccccccccccccccccba
abccccccccccccccccccccccccccccccccccccccccccccccccccccccccccccccccccccccccccccccccccccccccccccccccccccccccccccccccccccccccccccccccccccccccba
abccccccccccccccccccccccccccccccccccccccccccccccccccccccccccccccccccccccccccccccccccccccccccccccccccccccccccccccccccccccccccccccccccccccccba
abccccccccccccccccccccccccccccccccccccccccccccccccccccccccccccccccccccccccccccccccccccccccccccccccccccccccccccccccccccccccccccccccccccccccba
abccccccccccccccccccccccccccccccccccccccccccccccccccccccccccccccccccccccccccccccccccccccccccccccccccccccccccccccccccccccccccccccccccccccccba
abccccccccccccccccccccccccccccccccccccccccccccccccccccccccccccccccccccccccccccccccccccccccccccccccccccccccccccccccccccccccccccccccccccccccba
abccccccccccccccccccccccccccccccccccccccccccccccccccccccccccccccccccccccccccccccccccccccccccccccccccccccccccccccccccccccccccccccccccccccccba
abccccccccccccccccccccccccccccccccccccccccccccccccccccccccccccccccccccccccccccccccccccccccccccccccccccccccccccccccccccccccccccccccccccccccba
abccccccccccccccccccccccccccccccccccccccccccccccccccccccccccccccccccccccccccccccccccccccccccccccccccccccccccccccccccccccccccccccccccccccccba
abccccccccccccccccccccccccccccccccccccccccccccccccccccccccccccccccccccccccccccccccccccccccccccccccccccccccccccccccccccccccccccccccccccccccba
abccccccccccccccccccccccccccccccccccccccccccccccccccccccccccccccccccccccccccccccccccccccccccccccccccccccccccccccccccccccccccccccccccccccccba
abccccccccccccccccccccccccccccccccccccccccccccccccccccccccccccccccccccccccccccccccccccccccccccccccccccccccccccccccccccccccccccccccccccccccba
abccccccccccccccccccccccccccccccccccccccccccccccccccccccccccccccccccccccccccccccccccccccccccccccccccccccccccccccccccccccccccccccccccccccccba
abccccccccccccccccccccccccccccccccccccccccccccccccccccccccccccccccccccccccccccccccccccccccccccccccccccccccccccccccccccccccccccccccccccccccba
abccccccccccccccccccccccccccccccccccccccccccccccccccccccccccccccccccccccccccccccccccccccccccccccccccccccccccccccccccccccccccccccccccccccccba
abccccccccccccccccccccccccccccccccccccccccccccccccccccccccccccccccccccccccccccccccccccccccccccccccccccccccccccccccccccccccccccccccccccccccba
abccccccccccccccccccccccccccccccccccccccccccccccccccccccccccccccccccccccccccccccccccccccccccccccccccccccccccccccccccccccccccccccccccccccccba
abccccccccccccccccccccccccccccccccccccccccccccccccccccccccccccccccccccccccccccccccccccccccccccccccccccccccccccccccccccccccccccccccccccccccba
abccccccccccccccccccccccccccccccccccccccccccccccccccccccccccccccccccccccccccccccccccccccccccccccccccccccccccccccccccccccccccccccccccccccccba
abccccccccccccccccccccccccccccccccccccccccccccccccccccccccccccccccccccccccccccccccccccccccccccccccccccccccccccccccccccccccccccccccccccccccba
abccccccccccccccccccccccccccccccccccccccccccccccccccccccccccccccccccccccccccccccccccccccccccccccccccccccccccccccccccccccccccccccccccccccccba
abccccccccccccccccccccccccccccccccccccccccccccccccccccccccccccccccccccccccccccccccccccccccccccccccccccccccccccccccccccccccccccccccccccccccba
abccccccccccccccccccccccccccccccccccccccccccccccccccccccccccccccccccccccccccccccccccccccccccccccccccccccccccccccccccccccccccccccccccccccccba
abccccccccccccccccccccccccccccccccccccccccccccccccccccccccccccccccccccccccccccccccccccccccccccccccccccccccccccccccccccccccccccccccccccccccba
abccccccccccccccccccccccccccccccccccccccccccccccccccccccccccccccccccccccccccccccccccccccccccccccccccccccccccccccccccccccccccccccccccccccccba
abccccccccccccccccccccccccccccccccccccccccccccccccccccccccccccccccccccccccccccccccccccccccccccccccccccccccccccccccccccccccccccccccccccccccba
abccccccccccccccccccccccccccccccccccccccccccccccccccccccccccccccccccccccccccccccccccccccccccccccccccccccccccccccccccccccccccccccccccccccccba
abccccccccccccccccccccccccccccccccccccccccccccccccccccccccccccccccccccccccccccccccccccccccccccccccccccccccccccccccccccccccccccccccccccccccba
abccccccccccccccccccccccccccccccccccccccccccccccccccccccccccccccccccccccccccccccccccccccccccccccccccccccccccccccccccccccccccccccccccccccccba
abccccccccccccccccccccccccccccccccccccccccccccccccccccccccccccccccccccccccccccccccccccccccccccccccccccccccccccccccccccccccccccccccccccccccba
abccccccccccccccccccccccccccccccccccccccccccccccccccccccccccccccccccccccccccccccccccccccccccccccccccccccccccccccccccccccccccccccccccccccccba
abccccccccccccccccccccccccccccccccccccccccccccccccccccccccccccccccccccccccccccccccccccccccccccccccccccccccccccccccccccccccccccccccccccccccba
abccccccccccccccccccccccccccccccccccccccccccccccccccccccccccccccccccccccccccccccccccccccccccccccccccccccccccccccccccccccccccccccccccccccccba
abccccccccccccccccccccccccccccccccccccccccccccccccccccccccccccccccccccccccccccccccccccccccccccccccccccccccccccccccccccccccccccccccccccccccba
abccccccccccccccccccccccccccccccccccccccccccccccccccccccccccccccccccccccccccccccccccccccccccccccccccccccccccccccccccccccccccccccccccccccccba
abccccccccccccccccccccccccccccccccccccccccccccccccccccccccccccccccccccccccccccccccccccccccccccccccccccccccccccccccccccccccccccccccccccccccba
abccccccccccccccccccccccccccccccccccccccccccccccccccccccccccccccccccccccccccccccccccccccccccccccccccccccccccccccccccccccccccccccccccccccccba
abccccccccccccccccccccccccccccccccccccccccccccccccccccccccccccccccccccccccccccccccccccccccccccccccccccccccccccccccccccccccccccccccccccccccba
abccccccccccccccccccccccccccccccccccccccccccccccccccccccccccccccccccccccccccccccccccccccccccccccccccccccccccccccccccccccccccccccccccccccccba
abccccccccccccccccccccccccccccccccccccccccccccccccccccccccccccccccccccccccccccccccccccccccccccccccccccccccccccccccccccccccccccccccccccccccba
abccccccccccccccccccccccccccccccccccccccccccccccccccccccccccccccccccccccccccccccccccccccccccccccccccccccccccccccccccccccccccccccccccccccccba
abccccccccccccccccccccccccccccccccccccccccccccccccccccccccccccccccccccccccccccccccccccccccccccccccccccccccccccccccccccccccccccccccccccccccba
abccccccccccccccccccccccccccccccccccccccccdddddddddddddddddddddddddcccccccccccccccccccccccccccccccccccccccccccccccccccccccccccccccccccccccba
abccccccccccccccccccccccccccccccccccccccccdcccccccccccccccccccccccdcccccccccccccccccccccccccccccccccccccccccccccccccccccccccccccccccccccccba
abccccccccccccccccccccccccccccccccccccccccdcccccccccccccccccccccccdcccccccccccccccccccccccccccccccccccccccccccccccccccccccccccccccccccccccba
abccccccccccccccccccccccccccccccccccccccccdcccccccccccccccccccccccdcccccccccccccccccccccccccccccccccccccccccccccccccccccccccccccccccccccccba
abccccccccccccccccccccccccccccccccccccccccdcccccccccccccccccccccccdcccccccccccccccccccccccccccccccccccccccccccccccccccccccccccccccccccccccba
abccccccccccccccccccccccccccccccccccccccccdcccccccccccccccccccccccdcccccccccccccccccccccccccccccccccccccccccccccccccccccccccccccccccccccccba
abccccccccccccccccccccccccccccccccccccccccdcccccccccccccccccccccccdcccccccccccccccccccccccccccccccccccccccccccccccccccccccccccccccccccccccba
abccccccccccccccccccccccccccccccccccccccccdcccccccccccccccccccccccdcccccccccccccccccccccccccccccccccccccccccccccccccccccccccccccccccccccccba
abccccccccccccccccccccccccccccccccccccccccdcccccccecccccccccccccccdcccccccccccccccccccccccccccccccccccccccccccccccccccccccccccccccccccccccba
abccccccccccccccccccccccccccccccccccccccccdcccccccccccccccccccccccdcccccccccccccccccccccccccccccccccccccccccccccccccccccccccccccccccccccccba
abccccccccccccccccccccccccccccccccccccccccdccccccccccccfffccccccccdcccccccccccccccccccccccccccccccccccccccccccccccccccccccccccccccccccccccba
abccccccccccccccccccccccccccccccccccccccccdcccccccccccccccccccccccdcccccccccccccccccccccccccccccccccccccccccccccccccccccccccccccccccccccccba
abccccccccccccccccccccccccccccccccccccccccdccccccccccccgggccccccccdcccccccccccccccccccccccccccccccccccccccccccccccccccccccccccccccccccccccba
abccccccccccccccccccccccccccccccccccccccccdcccccccccccccccccccccccdcccccccccccccccccccccccccccccccccccccccccccccccccccccccccccccccccccccccba
abccccccccccccccccccccccccccccccccccccccccdcccccccccccchhhccccccccdcccccccccccccccccccccccccccccccccccccccccccccccccccccccccccccccccccccccba
abccccccccccccccccccccccccccccccccccccccccdcccccccccccccccccccccccdcccccccccccccccccccccccccccccccccccccccccccccccccccccccccccccccccccccccba
abccccccccccccccccccccccccccccccccccccccccdcccccccccccciiiccccccccdcccccccccccccccccccccccccccccccccccccccccccccccccccccccccccccccccccccccba
abccccccccccccccccccccccccccccccccccccccccdcccccccccccccccccccccccdcccccccccccccccccccccccccccccccccccccccccccccccccccccccccccccccccccccccba
abccccccccccccccccccccccccccccccccccccccccdccccccccccccjjjccccccccdcccccccccccccccccccccccccccccccccccccccccccccccccccccccccccccccccccccccba
abccccccccccccccccccccccccccccccccccccccccdcccccccccccccccccccccccdcccccccccccccccccccccccccccccccccccccccccccccccccccccccccccccccccccccccba
abccccccccccccccccccccccccccccccccccccccccdcccccccccccckkkccccccccdcccccccccccccccccccccccccccccccccccccccccccccccccccccccccccccccccccccccba
abccccccccccccccccccccccccccccccccccccccccdcccccccccccccccccccccccdcccccccccccccccccccccccccccccccccccccccccccccccccccccccccccccccccccccccba
abccccccccccccccccccccccccccccccccccccccccdcccccccccccclllccccccccdcccccccccccccccccccccccccccccccccccccccccccccccccccccccccccccccccccccccba
abccccccccccccccccccccccccccccccccccccccccdcccccccccccccccccccccccdcccccccccccccccccccccccccccccccccccccccccccccccccccccccccccccccccccccccba
abccccccccccccccccccccccccccccccccccccccccdccccccccccccmmmccccccccdcccccccccccccccccccccccccccccccccccccccccccccccccccccccccccccccccccccccba
abccccccccccccccccccccccccccccccccccccccccdcccccccccccccccccccccccdcccccccccccccccccccccccccccccccccccccccccccccccccccccccccccccccccccccccba
abccccccccccccccccccccccccccccccccccccccccdccccccccccccnnnccccccccdcccccccccccccccccccccccccccccccccccccccccccccccccccccccccccccccccccccccba
abccccccccccccccccccccccccccccccccccccccccdcccccccccccccccccccccccdcccccccccccccccccccccccccccccccccccccccccccccccccccccccccccccccccccccccba
abccccccccccccccccccccccccccccccccccccccccdccccccccccccoooccccccccdcccccccccccccccccccccccccccccccccccccccccccccccccccccccccccccccccccccccba
abccccccccccccccccccccccccccccccccccccccccdcccccccccccccccccccccccdcccccccccccccccccccccccccccccccccccccccccccccccccccccccccccccccccccccccba
abccccccccccccccccccccccccccccccccccccccccdccccccccccccpppccccccccdcccccccccccccccccccccccccccccccccccccccccccccccccccccccccccccccccccccccba
abccccccccccccccccccccccccccccccccccccccccdcccccccccccccccccccccccdcccccccccccccccccccccccccccccccccccccccccccccccccccccccccccccccccccccccba
abccccccccccccccccccccccccccccccccccccccccdcccccccccccccccccccccccdcccccccccccccccccccccccccccccccccccccccccccccccccccccccccccccccccccccccba
abccccccccccccccccccccccccccccccccccccccccdddddddddddddddddddddddddcccccccccccccccccccccccccccccccccccccccccccccccccccccccccccccccccccccccba
abccccccccccccccccccccccccccccccccccccccccccccccccccccccccccccccccccccccccccccccccccccccccccccccccccccccccccccccccccccccccccccccccccccccccba
abccccccccccccccccccccccccccccccccccccccccccccccccccccccccccccccccccccccccccccccccccccccccccccccccccccccccccccccccccccccccccccccccccccccccba
abccccccccccccccccccccccccccccccccccccccccccccccccccccccccccccccccccccccccccccccccccccccccccccccccccccccccccccccccccccccccccccccccccccccccba
abccccccccccccccccccccccccccccccccccccccccccccccccccccccccccccccccccccccccccccccccccccccccccccccccccccccccccccccccccccccccccccccccccccccccba
abccccccccccccccccccccccccccccccccccccccccccccccccccccccccccccccccccccccccccccccccccccccccccccccccccccccccccccccccccccccccccccccccccccccccba
abccccccccccccccccccccccccccccccccccccccccccccccccccccccccccccccccccccccccccccccccccccccccccccccccccccccccccccccccccccccccccccccccccccccccba
abccccccccccccccccccccccccccccccccccccccccccccccccccccccccccccccccccccccccccccccccccccccccccccccccccccccccccccccccccccccccccccccccccccccccba
abccccccccccccccccccccccccccccccccccccccccccccccccccccccccccccccccccccccccccccccccccccccccccccccccccccccccccccccccccccccccccccccccccccccccba
abccccccccccccccccccccccccccccccccccccccccccccccccccccccccccccccccccccccccccccccccccccccccccccccccccccccccccccccccccccccccccccccccccccccccba
abccccccccccccccccccccccccccccccccccccccccccccccccccccccccccccccccccccccccccccccccccccccccccccccccccccccccccccccccccccccccccccccccccccccccba
abccccccccccccccccccccccccccccccccccccccccccccccccccccccccccccccccccccccccccccccccccccccccccccccccccccccccccccccccccccccccccccccccccccccccba
abccccccccccccccccccccccccccccccccccccccccccccccccccccccccccccccccccccccccccccccccccccccccccccccccccccccccccccccccccccccccccccccccccccccccba
abccccccccccccccccccccccccccccccccccccccccccccccccccccccccccccccccccccccccccccccccccccccccccccccccccccccccccccccccccccccccccccccccccccccccba
abccccccccccccccccccccccccccccccccccccccccccccccccccccccccccccccccccccccccccccccccccccccccccccccccccccccccccccccccccccccccccccccccccccccccba
abccccccccccccccccccccccccccccccccccccccccccccccccccccccccccccccccccccccccccccccccccccccccccccccccccccccccccccccccccccccccccccccccccccccccba
abccccccccccccccccccccccccccccccccccccccccccccccccccccccccccccccccccccccccccccccccccccccccccccccccccccccccccccccccccccccccccccccccccccccccba
abccccccccccccccccccccccccccccccccccccccccccccccccccccccccccccccccccccccccccccccccccccccccccccccccccccccccccccccccccccccccccccccccccccccccba
abccccccccccccccccccccccccccccccccccccccccccccccccccccccccccccccccccccccccccccccccccccccccccccccccccccccccccccccccccccccccccccccccccccccccba
abccccccccccccccccccccccccccccccccccccccccccccccccccccccccccccccccccccccccccccccccccccccccccccccccccccccccccccccccccccccccccccccccccccccccba
abccccccccccccccccccccccccccccccccccccccccccccccccccccccccccccccccccccccccccccccccccccccccccccccccccccccccccccccccccccccccccccccccccccccccba
abccccccccccccccccccccccccccccccccccccccccccccccccccccccccccccccccccccccccccccccccccccccccccccccccccccccccccccccccccccccccccccccccccccccccba
abccccccccccccccccccccccccccccccccccccccccccccccccccccccccccccccccccccccccccccccccccccccccccccccccccccccccccccccccccccccccccccccccccccccccba
abccccccccccccccccccccccccccccccccccccccccccccccccccccccccccccccccccccccccccccccccccccccccccccccccccccccccccccccccccccccccccccccccccccccccba
abccccccccccccccccccccccccccccccccccccccccccccccccccccccccccccccccccccccccccccccccccccccccccccccccccccccccccccccccccccccccccccccccccccccccba
abccccccccccccccccccccccccccccccccccccccccccccccccccccccccccccccccccccccccccccccccccccccccccccccccccccccccccccccccccccccccccccccccccccccccba
abccccccccccccccccccccccccccccccccccccccccccccccccccccccccccccccccccccccccccccccccccccccccccccccccccccccccccccccccccccccccccccccccccccccccba
abccccccccccccccccccccccccccccccccccccccccccccccccccccccccccccccccccccccccccccccccccccccccccccccccccccccccccccccccccccccccccccccccccccccccba
abccccccccccccccccccccccccccccccccccccccccccccccccccccccccccccccccccccccccccccccccccccccccccccccccccccccccccccccccccccccccccccccccccccccccba
abccccccccccccccccccccccccccccccccccccccccccccccccccccccccccccccccccccccccccccccccccccccccccccccccccccccccccccccccccccccccccccccccccccccccba
abccccccccccccccccccccccccccccccccccccccccccccccccccccccccccccccccccccccccccccccccccccccccccccccccccccccccccccccccccccccccccccccccccccccccba
abccccccccccccccccccccccccccccccccccccccccccccccccccccccccccccccccccccccccccccccccccccccccccccccccccccccccccccccccccccccccccccccccccccccccba
abccccccccccccccccccccccccccccccccccccccccccccccccccccccccccccccccccccccccccccccccccccccccccccccccccccccccccccccccccccccccccccccccccccccccba
abccccccccccccccccccccccccccccccccccccccccccccccccccccccccccccccccccccccccccccccccccccccccccccccccccccccccccccccccccccccccccccccccccccccccba
abccccccccccccccccccccccccccccccccccccccccccccccccccccccccccccccccccccccccccccccccccccccccccccccccccccccccccccccccccccccccccccccccccccccccba
abccccccccccccccccccccccccccccccccccccccccccccccccccccccccccccccccccccccccccccccccccccccccccccccccccccccccccccccccccccccccccccccccccccccccba
abccccccccccccccccccccccccccccccccccccccccccccccccccccccccccccccccccccccccccccccccccccccccccccccccccccccccccccccccccccccccccccccccccccccccba
abccccccccccccccccccccccccccccccccccccccccccccccccccccccccccccccccccccccccccccccccccccccccccccccccccccccccccccccccccccccccccccccccccccccccba
abccccccccccccccccccccccccccccccccccccccccccccccccccccccccccccccccccccccccccccccccccccccccccccccccccccccccccccccccccccccccccccccccccccccccba
abbbbbbbbbbbbbbbbbbbbbbbbbbbbbbbbbbbbbbbbbbbbbbbbbbbbbbbbbbbbbbbbbbbbbbbbbbbbbbbbbbbbbbbbbbbbbbbbbbbbbbbbbbbbbbbbbbbbbbbbbbbbbbbbbbbbbbbbbba
aaaaaaaaaaaaaaaaaaaaaaaaaaaaaaaaaaaaaaaaaaaaaaaaaaaaaaaaaaaaaaaaaaaaaaaaaaaaaaaaaaaaaaaaaaaaaaaaaaaaaaaaaaaaaaaaaaaaaaaaaaaaaaaaaaaaaaaaaaaa
"}
