"a" = (/turf/unsimulated/wall/planetary/normal,/area/space)
"b" = (/obj/structure/flora/tree/dead,/turf/simulated/floor/outdoors/snow,/area/tether_away/snowfields/unexplored/near)
"c" = (/turf/simulated/floor/outdoors/snow,/area/tether_away/snowfields/unexplored/near)
"d" = (/turf/simulated/floor/outdoors/snow,/area/tether_away/snowfields/unexplored/far)
"e" = (/turf/simulated/floor/outdoors/snow,/area/tether_away/snowfields/explored/near)
"f" = (/turf/simulated/floor/outdoors/snow,/area/tether_away/snowfields/explored/far)
"g" = (/turf/simulated/floor/outdoors/snow,/area/shuttle/excursion/away_snowfields)
"h" = (/obj/shuttle_connector/snowfields,/turf/simulated/floor/outdoors/snow,/area/tether_away/snowfields/explored/near)
"i" = (/obj/structure/flora/tree/pine,/turf/simulated/floor/outdoors/snow,/area/tether_away/snowfields/unexplored/near)
"j" = (/obj/structure/flora/tree/pine,/turf/simulated/floor/outdoors/snow,/area/tether_away/snowfields/unexplored/far)
"k" = (/obj/structure/flora/tree/pine,/turf/simulated/floor/outdoors/snow,/area/tether_away/snowfields/explored/far)
"l" = (/mob/living/simple_animal/hostile/tree,/turf/simulated/floor/outdoors/snow,/area/tether_away/snowfields/unexplored/near)
"m" = (/obj/structure/flora/tree/dead,/turf/simulated/floor/outdoors/snow,/area/tether_away/snowfields/unexplored/far)
"n" = (/obj/structure/flora/tree/dead,/turf/simulated/floor/outdoors/snow,/area/tether_away/snowfields/explored/near)
"o" = (/obj/tether_away_spawner/snowfields_hard,/turf/simulated/floor/outdoors/snow,/area/tether_away/snowfields/unexplored/far)
"p" = (/obj/tether_away_spawner/snowfields_medium,/turf/simulated/floor/outdoors/snow,/area/tether_away/snowfields/unexplored/far)
"q" = (/obj/tether_away_spawner/snowfields_boss,/turf/simulated/floor/outdoors/snow,/area/tether_away/snowfields/unexplored/far)
"r" = (/obj/tether_away_spawner/snowfields_medium,/turf/simulated/floor/outdoors/snow,/area/tether_away/snowfields/unexplored/near)
"s" = (/obj/tether_away_spawner/snowfields_easy,/turf/simulated/floor/outdoors/snow,/area/tether_away/snowfields/unexplored/far)
"t" = (/obj/tether_away_spawner/snowfields_diyaab,/turf/simulated/floor/outdoors/snow,/area/tether_away/snowfields/unexplored/far)
"u" = (/obj/tether_away_spawner/snowfields_easy,/turf/simulated/floor/outdoors/snow,/area/tether_away/snowfields/unexplored/near)
"v" = (/obj/tether_away_spawner/snowfields_passive,/turf/simulated/floor/outdoors/snow,/area/tether_away/snowfields/unexplored/near)
"w" = (/obj/tether_away_spawner/snowfields_passive,/turf/simulated/floor/outdoors/snow,/area/tether_away/snowfields/unexplored/far)
"x" = (/obj/tether_away_spawner/snowfields_diyaab,/turf/simulated/floor/outdoors/snow,/area/tether_away/snowfields/unexplored/near)
"y" = (/obj/tether_away_spawner/underdark_hard,/turf/simulated/floor/outdoors/snow,/area/tether_away/snowfields/unexplored/near)
"z" = (/obj/tether_away_spawner/snowfields_hard,/turf/simulated/floor/outdoors/snow,/area/tether_away/snowfields/unexplored/near)
"A" = (/obj/structure/flora/bush,/turf/simulated/floor/outdoors/snow,/area/tether_away/snowfields/unexplored/far)
"B" = (/obj/structure/flora/bush,/turf/simulated/floor/outdoors/snow,/area/tether_away/snowfields/unexplored/near)
"C" = (/obj/structure/flora/bush,/turf/simulated/floor/outdoors/snow,/area/tether_away/snowfields/explored/near)
"D" = (/obj/structure/flora/bush,/turf/simulated/floor/outdoors/snow,/area/tether_away/snowfields/explored/far)

(1,1,1) = {"
aaaaaaaaaaaaaaaaaaaaaaaaaaaaaaaaaaaaaaaaaaaaaaaaaaaaaaaaaaaaaaaaaaaaaaaaaaaaaaaaaaaaaaaaaaaaaaaaaaaaaaaaaaaaaaaaaaaaaaaaaaaaaaaaaaaaaaaaaaaa
accccccccccccccccccccccccccccccccccccccccccccccccccccccccdddddddddddddddAddddddddddddddddddddddddddddddddddddddddddddddAddddddddddddddddddda
acBccccccccccccccccccccccccccccccccccccccccccccccccccccccdddddddddddddddddddddddddddddddddddddddddAdddddmddAdddddddddddddddddddddddddddddAda
acccccccccccccccccccccccccbcccccccccccccccccccccccccbBcccdddjdddddddddddddddodddddddddddddmdddddddddddddddddddddddddddddddddddddddAdddmdddda
acccccccccccccccBccccccccccccccccccccicccccccccccccccccccdddddddmdddddddddddddddddddjddApddddddjdddddddddddddddddddjddddddddddddddddddddddda
accccciccccccccccccccccccccccccccccccccccccBcccccccccccccddddddddddddddddddddddddddddddddddddddddddddddddddddddddddddddddddjddddddddddddddda
accccccccccccccccccbccccccBcccccccccczcccccccccccccccccccdddddddddddddddddddddddAddddddddddddddddddddddddddddAdddddddpddddddddddddddddddddAa
accccccccccccccccccccccccccccccccBcccccccccccccccccccccccddddddddddddddddjdddddddddddddddddjdddddddAddddddddddddddddddddddddddddddddddddddda
accccccccccccccccccccccccccccccccccccccccccccccccccccccccddddddddddddddddddddddddddddddddddddddddddddddAddddddddddmddddddddqdddddddjddddddda
accccrccccccccBccccccccccccccccccccccccccccccccccccccccccddddddddpdddddddddddddddjdddddddddddddddddmddddddddddddddddddddddddddddddddddddddda
acBccccccccccccccccccccccccccccccccccccccccccccccicccccccddddddddddddddddAddddddddddddddddddddpddddddddddddddddddddddddddddddddddddddddmddda
acccccbccccccccccccccBcccccccccccccccccccccccccccBcccccccddddddddddddddddddddddddddddddddddddddddddddddddddAdddddddddddddddddddddAddddddddda
acccccccccccccccccccccccccccicccccccccccbccccccccccccccccddddddddddddddddddddmddddddddddddddddddddddddddddddddsdddddddddddddddddddddddddddda
acccccccBcccccccccccccccccccccBcccbccccccccccccccccccccccAdddjddddddddjddddddddddddddddddAddddddddddddddddddddddddddddAdddddmdddddddddddddda
accccccccccccccccccccccccccccccccccccccccccccccrcccccccccddddddmdddddddddddddddddddddddddddddddddddddddddddjddddddddddddddddddddddddddddddda
acccccccccccccccicccccccccccccccccccccBccccccccccccccccccddddddddddddddddddddddddddddddddddddddddAdddddddddddddddddddddddddddddddddAddodddda
accciccccccccccccccccccccccccccccccccccccccccccccccccccccdddddddddAdddddddddddddjdddddddddddddddddddddsddddddddAddddddddddddddddddddddddddda
accccccccccccccccccccccBcccccccccccccccccccccccccccccccccdddddddddddddddddAdddddddddddddddddddddddddddddddddddddddddddddddddddAdddddddddddda
accccccccccccccccccccccccccccccccccccccccicccccccccccccccddddddddddddddddddddddddApddddddddddjdddddjdAddddddddddddddddddpdddddddddddddddddda
accccccccccccccccBccccccccccccccccccccccccccccccBccccccccdddddddddddddddddddddddddddddddddddddddddddddddddddAddddddddddddddddddddddddmddddda
accccccccccccccccccccccccccccccccccccccccccccccccccccccccdddddAdddjdddddddddddddddddddddddddddddddddddddddddddddddddjdddddddddddddddddddddda
acccBccccccccccccccccccccccccciccccccccccccccccccccccccccddtdddddddddddddddddddddddddddddddAddddddddddddddmddddddddddddddddddjddddddddddddda
accccccccccccccccbcccccccccccccccccccccccccccccccccccbcccddddtddddddddddddddddddddddddddmdddddddddddddddddddAdddddddddddddddddddddddddddddda
acccccccccccicccccccccccicccccccBcccccccccccccciccccccccctdddddddddddddddddddddddddddAddddddddddddddddddddddddddddddddddddddddddddddddddddda
accccccccccccccccccccccccccccccccccccccccccccccccccccccccddAdtdddddddddddddddddddddddddddddddddddddddddddddddddddddddddAddddddddddAdddddddda
acccccccccccccccccccccccccccccccccccccccccBccccccccccccciddtdddddddddddddAddddddddddddddpdddddddddddAdddddddddddddsddddddddddddddddddddjddda
accccccccccccccccccccccccccccccccccccccccccccccccccccccccdddddddmdddddddddddddddddjddddddddddddmddddddddddddddAddddddddddddddddddmddddddddda
accicccccccBcccccccccccccccccccccccciccBcccccccccccccccccddddddddddAddddddddddddddddddddddddddAdddddddddddddddddddddddddddddddddddddddAdddda
accccccccccccccccccccccccccccccccccccccccccccccccccccccccddddddddddddddddddddddddddddddddddddddddddddddddddddddddjddddddddddddddodddddddddda
accccccccccccccccccccccvccccccccccccccuccccccccccccccccccddddddddddddddddddddddAdddddddddddddddddddddddddddddddddddddAddddddddddddddddddddda
acccccccccccccccccccccccBccccccccccccccccccccccccccccccccddddddddddddddddddddddddddddddddddAddddddddddddddddddddddddddddddddddddddddddddddda
accccccccccccccccccccccccccccccccccccccccccccccccccccBcccddddddddddddjddddddddddddddAddddddddddddddddjddddddAddddpdddddddddmdddddddjddddddda
accBccccccccccccccccccccccccccccccccccccbccccccccccccccccdddddddddddddddddddddddddddddddpdddddddddddAddddddddddddddddddddddddddAddddddddddda
accccccccccccccicccccccccccciccccccccccccccccccccccccccccddjdddAddddddddddddddddddddddddddddjdddddddddddddddddddddddddddddddddddddddddddddda
accccccccccccccccccccccccccccccccccccccccccccccccccccccccddddddddddddddddddAddddmddddddddddddddddddmddddddddddddddAdddddddddddddddddddddddda
acccccuccccccccccBcccccccccccccccccccccccccccccccccccccccdddddddddddddddddddddddddddddddAddddddddddddddddddddjddddddddddddddddddddddddddddda
acccccccciccccccccccccccccccccccccccccccccccBccccccccccccddddddddddddddddddddddddAddddddddddddddddddddddddddddddddddddddddddddddddddAddddmda
acccccccccccccccccccccccccccccccccccccccccccccccccccccrccdddddddddddddddddddddddddddddddddddddddddddddAdddddmddddddddddjddAdddddddddddddddda
acBccccccccccccccccccccccccccccccccccccccccccccccccccccccdddwddddddddjddddddddddddddddddddddddddAdddddddddddddddddddddddddddddddddddddddddda
acccccccccccccccccccccccccccbcccccccciccccccccccbccccccccdddddddddddddddddddddddddddddddddddjddddddddddddddAddddddddddddddddddddAdddddddddda
accccccccccccccccccciccccccccccccccccccBcccccccccccccccccdddddddddddddddddddddddddddddAddddddddddddddddddddddddddAddddddddddddddddddddddddda
acccccccccccccvccccccccccccccccccccccccccccccccccccccciccdddddddddAdddddddddpddddddddddddddddddddddddoddddddddddddddmddddpdAddddddmdddddAdda
accccccccccccccccccccBcccccccccccccccccccccccccccvcccccccdddddddddddddddddddddddddddddddsdddddddddddddddddddAdddddddddddddddddddddddddddddda
accccccccccccccccccccccccccccccccccccccccccciccccccccccccdddddddddddddddddddddddddddAdddddddddddmdddddddddddddddddddddddddddddddddddddddddda
acccccccccccicccccccccccccccccccrccccccccccccccccccccccccddddddddddddddddddddddddjdddddddddddddddddddddddjdddddddddddddddddddddjddddddddddja
accbccccccccccccccccccccccccciccccccccccccccccccccccccBccjdddddddddmdddddAddddddddddddddddddddddddddddddddddddddAdddddddAddddddAddddddddddda
acccBciccccccccccccccccccccccccBcccccccccccccccccccccccccdddddddddddddddddddddddddddddddddddddddddAdddddddddddddAdddddddddddddddddddddddddda
acccccccccccccccbcccccccccccccccccccccBccccccccccccccccccddddddddddddddddddddAddddddddddddddAddddddddddddddddddmddddddddddddddddddddddddddda
accccccccccccccccccccccccccccccccccccccccccccccccccccccccddddddAdddddddddddddddddddddddddddddddddddddddddddddAddddddddddddddddddddddsddmddda
accccccccccccccccccccccccccccccccccccccccccccBcccccccccccdddddddddddddddddddddddddddddddddddddddddddddddddddddddddpddjddddddddddddddddddddda
acccccccccccccccccccccccccccccccccccccccccccccccccccccuccdddddddddddddAddddddddddddddddAddddddddddddddddddddddddddddddAdddddddddddAdddddddda
accccccrcccccccBccccccccccccvccccccccccccccccccccccccccccddddddddddddddddddddmdddddddddddddddddddddddddjddddddAddddddddddddddddddddddddddAda
accccccccccccccccccccccccccccccccccccccccccccccccccccccccddjddddddddddddddddddddddddddddddddddddddddddddddddddddddddddddddAdddddddddddddddda
acciccccBccccccccccccccccccccccBcccccccccccccccccccciccccdddddddddddddddddddddddddddddddddddddmddddddddddpdddddddddddddddddddddddddddjddddda
accccccccccccccccccccciccccccccccccccccccccccccccccccccccddddddddddjddddddddddddddddddddddddddddddddddddddddddddddddddddddddddddddddddddddda
accccccccccccccccccccccccccccccccccccccccccccccccccccccccdddddddddddddddddddddddddAddddddjddddddddddAdddddddddddddddddddddddddmdddddAdddddda
accccccccccccccccccccccccccccccccccccicccBcccccccccccccccddAdddddddddddddAddddddddddddddddddpdddddddddddddddAddddjddddodddddddddddddddddAdda
acccccccccccccccccccccccccccccccccccccccccrccccccccccccccdddddddddddddddddddddddddddddddddAdddddddddddddddddddddddddddddddddddddddddddddddda
acccccccccccccccccccccccccccccccccccccccccccccccbccccccccdddddddddddddddddddddddddddddddddddddddddddddddddddddddddddddddddddddddddddddddddda
acccccccccccccccccccccccBccccccccccccccccccccccccccBcccccdddddddddddddddddddddddjddddddddddddddddddddddddddmddddddAdddddddAdddddddddddddddda
acccccccccccccccccccccccccccccccccccBccccccccccccccccccccddddddddddddddddddAdddddddddddddddddddddddddddddddddddddddddAddddddddddjdddddddddda
accBcucccccccccccciccccccccccvccccccccccccccccceeeeecccccdddddddddddddddddddddddddddddAdddddddjddddddddddddddddddddddddddddddddddddAmdddddda
acccccccccccccccccccccccccccccccccccccccciccceeeeeeeeecccddddddddddddddddddddddddddddddddddddAddddddddddddddddddddddddddddddddddddddddddAdda
acccccccccbcccccccccccccccccccccccccccccccceeneeeeeeeeeecddddddmdAddddjddddddddddddmdddddddddddddAdddddddAdddddddddjddddddddddddddddddddddda
accccccccccccccccccccccccccccccccccccccccceeeeeeeeeeeeeeeddddddddddddddddddddddddddddddddddddddddddddddddddddddddddddddddddddAddddddddddddda
acccccccccccccccccccccccccccccccccccccccceeeeeeeeeeeeeeeefdddddoddddddddddddddddddddddddddddddddddddmdddddddddAddddddddddddddddddddoddddddda
accccccciccccccrcccBcccccccccccccccccBcceeeeeeeeeeeeeeeeeffddddddddddddddddddddddddddddddddjddddddddddddddddddddqdddddddddddddddddddddddddda
acccccccccccccccccccccccBcccccicccccccceeeeeeeeeeeeeeeeeefkfddddddddddddAdddddddddddddddddddddddddddddddddddAdddddddddmddddddddddddddddddjda
acccccccccccccccccccccccccccccccccccccceeeeeeegggggggeeeefffddddddddddddddddddjddddddAdddddddddpdddddddddddddddddddddddddddddddddddddddddAda
acccccBccccccccccccccccccccccccccccccceeeeeeegggggggggeeCffffdddddddddddddddddddddddddddddddddddddddAddddddddddddddddddddddAdddddmddddddddda
acccccccccccccccicccccccccccccccccccceeeeeeeegggggggggeeefffffdddddddddddddddddddddddddddddAddddddddddddddddddddddddddddddddddddddddddddddda
acccccccccccccccccccccccccccccccccccceeeeeeeegggggggggeeefffffdddAddddddddddddddddddddddddddddddddddddddddddddddddddddddddddddddddddddddAdda
acccccccccccccccccccccccccccccccccccceeeeeeeegggggggggeeefffffddddddddddddAdddddddddddddddddddddddddddddjddddddddddjAdddddddddddddddAdddddda
accccccccccccccccccccccccccccvccccccceeCeeeeegggggggggeeefffffdddddddddddddddddddddddddddddddddddddddddddddddAddddddddddddddddddddddddddddda
accrcccbccccccccBccccccccbccccccccccceeeeeeeegggggggggeeefffffddddjdddddddddddddddddddddddddjdddddddddddddddddddddddddddddddddddddddddddddda
acccccccccccccccccccccccccccccccccccceeeeeeegggggggggggeefffffddddddddddddddddddddddAddddddddddddmddddddddddddddddddddddddddddddddddddddmdda
acBccccccccccccccccccccccccccccBccccceeeeeeegggggggggggeefffffdddddddddddddddddddddddddddddddddddddddddddddddddddddddddddddddddjddddddddddda
accccccccccccccccccccccccccccccccccccceeeeeegggggggggggeefffDddddddddwddddddddddddddddddddddddddddddddddddddAdddddddddddddddddddddddddddddda
accccccccccccccccccccccccccccccccccccieeeeeegggggggggggeeffffdddddddddddddddmdddddddddAddddddddddddAdddddddddddddmdddddAddddddddddddddddddda
acccccccccccccccciccccccccccccccccccccceeeeegggggggggggeefffdddddddddddddddAdddddddddddddddddddddddddddddddddddddddddddddddddddddAddddjdddda
accccccccccBcccccccccccccBccccccccccccceeeeeggggeegggggeefffdddddddAdddjddddddddddddddddddddddddddddddddddddddddddddddddddddddddddddddddddda
accccccccccccccccccccccccccccccccccccBcceeeegggeeeeegggeeffddmddddddddddddddddddddddddddddAdjdddddddddsddddddddddddddddddddddddddddddoddddda
accccccccccccccccccccccccccccccccccccccceeeeeeeeeheeeeeeeffddddddddddddddddddddddjdddddddddddddddddddddddddddddAdddpddddddddddddddddddddddda
acccBcccccccccccccccccccccccccccccccccccceeeeeeeeeeeeeeeefddddddddddddddddAdddddddddddddddddddddddddddAdddddjddddddddddddddddmddddddddddddda
acccciccccccccccccccccccccBcccccccccccccceeeeeeeeeeeeeeeefddddddddAddddddddddddddddddddddddddddddddddddddddddddddddddddddddAddddddddddddddda
accccccccccccccccccBcccccccccccccciccccccceeeeeeeeeeeeeeedddddddddddddddddddddddddddddddddddddddddddddddddddddddddddddddddddddddddAdddddjdda
accccccccccccbcccccccccccccccrcccccccclcccceeeeeeeeeeeeecdddddddddddddddddddddddddddddddddddddddddddddddddAddddddddddddddjddddddddddddddddda
accccccccccccccccccccccccccccccccccccccccccceeeeeeeeeeeccdddddddddddddddddddddddpdjddddAdddddddddddmdddddddddddddddddAdddddddddddddddmddddda
acccccccccccccvccccccccccccccccccccccccccccBcceeeeeeeccccddddddddjddddddddjdddddddddddddddddddddjddddddddddddddAdddddddddddddddddddddddddAda
accccccccbBccccccccccccccBcicccccccccccccccccccceeeccbcccdddddddddddddddddddddAdddddddddddmddddddddddddddddddddddddddddddddddmddddddddddddda
accccccccccccccccccccccccccccccccccBcccccccccccccccccccccddAdddddddddddddddddddddddddddddddddddddddddddddddAdddddddddddddAddddddddddddddddda
accccccccccccccccccccccccccccccccccccccccccccccccccccccccdddddddddddddddddddddddddddddddddddddddddddddddddddddddddddddddddddddddddddddddddda
accccccccccccccccccccccccccccccccccccccccccccccccccccccccddddddddddddmdddddddddddddddddddddAddddddddddddddddddddddddddddddddddddddddddddAdda
accccccccccccccccccccccBcccccccccccccccccccccccccccicccccdddddddpddddddddddddddddddddddddddddddddddddddAdddddddjdddddddAddddddddddddddddddda
accccccccBccccccccccccccccccccccccccccbccccccccccccccccccdddddddddddddddddAdddddddddddddddddddddddAdddddddddddddddAdddddddddddddddsdddddddda
acccrcccccccccccccccccccccccccccccccccccccccccccBccccccccddddddddddddddddddddddddddddddddjddddddddddddddddddddddddddddddddddddddAdddjdddddda
acccccccccccccccxcccccccccccccccBccccccccccccccccccccccccddddddddddddddddddddddddddddddddddddddddddddddmddAdddddddddddddddddddddddddddddddda
acccBccccccccccccccBcccccccccccccccccccccccccccccccccccccdddddAddddddddddddddjddddddmddddddddddddddddddddddddddddsdddddAddddddddddddddddddAa
accccccccccccccccccccxcccccccccccccccccccczccccccccccccccddddddddddddddddddddddddddddddddddddddddddddddddddddddddddddddddddddddddddAddddddda
accccccccccccccccbcccccccccccccccccccccccccccccccccccccccddddjdddddddddddddddddddddddddAdddddddddddjdddddddddddddddddddddmddddddddddddddddda
acccccccccccccxcccccccccccccciccycccccccccccccccccccbccccddddddddddddddddddddddddAdddddddddddddddddddAddddddddAdddddddddddddAdddddddddddddda
acccccccciccccccccxccccccccccccccccccccciccccccccccccccccddddddddddddAdddddddddddddddddddddddddddddddddddddddddddddddAdddddddddddddddddmddda
accccccccccccccccccccBcccccccccccccccccccccccccccccccccBcdddddddddddddddddddddddddddddddddddddddddddddddddddddddddddddddddddddddddddddddddda
acccccccccccccccccccccccccccccccbccccccccccccccccccccccccddddddddddddddddddjdddddddddddddddddddddddddddddAdddddddddddddddddddddddjddddAdddda
accccccccccccxcccccxcccciccccccccccccccccccBcccccccccccccdddddddddddddddddddddddddddddddddddddddddddddddddddmdddddddddddddddddddddddddddddda
accccccccccccccccccccccccccccccccccccccccccccccccccccccccdddpddddddddddddddddddddddddddddddjddddddddoddddddddddddoddddddddddddddddddddddddda
acccccccccBccccccccccccccccccccccccccccccccccccccccccccccddddddddddddddddddddAdddddddAdddddddAdddddddddddddddddddddAddddddddddddddddddddddda
accccccccccccccccxcccccccccccccccccBcccccccccccccccccccccdddddddjddmdddddddddddddddddddddddddddddddddddddddddddddddddddddjdddAdddddddddAddda
acccccccccccccccccccccccccBccccccccccccccccccccccccccccccdddddddddddddddddddddddddddddddddddddddddddddddddddddddddddddddddddddddddddddddddda
accccccccccccccccccccccccccccccccccccccccccbcccccccccccccddddddddddddddddddddddddddjddddddddddmdddddddddddddddddddddddddddddddddddddddddddda
acicccccccccccccccccccccccbccccccccccccccccccccccccccccccddddddddddddddddddddddddddddddddddddddddddddAddddddddAdddddddddddddddddddddddddjdda
aBccccccccccBcccccccccccccccccccccccccccccccBccccccccccccjdddddddddddddddddddddddddddsddddddddddddddddddddddddddddddddddddddddddmdddddddddda
accccccccccccccccccccccccccccccccccccccccccccccccccccccccdddddAddddddddddAdddddddddddddddddddddddddddddddjdddddddddddddddAddddddddddodddddda
acccccccccbccccccccccccccccccccccccccccccccccccccccccccBcddddddddddddddddddddddmdddddddddddAddddddddddddpddddddddmddddddddddddddddddddddddda
accccccccccccccccccccbcccccccccccccciccccccccccccccccccccdddddddddddddddddddddddddAddddddddddddddddddddddddddddAddddddddddddddddddddddddAdda
accccccccccccccccccccccccccccccccccccccccccccccccccccccccddddddddddddddddddddddddddddddddddddddddddddddddddddddddddddddddmddddddddddddddddda
accccccccccccccccccccccBcccccccccccccccccccucccccccccccccddddddjdddddddddddddddddddddddddddddddddddmdddddddddddddddddddddddddddddAddddddddda
acccccccccccBcccccccccccccccccccccccBccccccccccicccccccccdddddddddddddddwddddddddjdddddddddddddddddddddddAddddddddddddddddddddjdddddddddddda
accccBcccccccccccccccccccccccccrcccccccccccccccccccccccccddddddddAdddddddddddddddddddddddddddddddddddddddddddddddddddAdddddddddddddddddmddda
accccccccccccccccccccccccccccccccccccccccBcccccccccccBcccdddddddddddddddddddddddddddddddddddmdddddddddddddddddddddddddddddddddAdddddddddddda
accvcccccccccccccccccccccccccccccccBcccccccccccccccbcccccdddddddddddddddddddddddddddddAdddddddjdddddddddddddddddddddddddddddddddddddddddddda
acccccccciccccczccccccccccicccccccccccccbccccccccccccccccdddddddddddddddAdddddddddddddddddddddddddddddddddddddddddddddddddddddddddmdddddddda
accccccccccccccccccccccccccccccccccccccccccccccccccccccccdddmddddddddddddddddddddddddddddddddddddddddddddddddAjddAddddddddmdddddddddddddddAa
acccccccccccccccccccBccccccccccccccccccccccccccccccccccccdddddddddddddddddddddddddddddddddddddddddddddddddddddddddddddddddddddddddddddddddda
accccbcccccccccccccccccccccccccbcccccccccccccccccccccccccddddddddddddddddddddddddddddddddddddddddddddAddddddddddddddddddddddddddddddddddddda
accccccccccccccccccccccccccccccccccccccccccccccccccccccccddddddAdddddddddddjddddddddAddddddpdddddddddddddddddddddddddqdddddAddddddddddddAdda
acccccccccccccccccccccccccccccccccccccBccccccccccciccccccdddddddddddddddddddddddddddddddddddddddddddddddddddddddddddddddddddddddddddddddddda
acccccccccccccbccccccccccccccccccccccccccccccBcccccccccccddddddddddddddddddddddddddddddddddddddddddddddsssdddddAdddddddddddddddddAddddddddda
accccccccccccccccccccccccccccccccccccccccccccccccccccccccddddddddddddddddddddddddddddddddddddddddddddddsssddddddddddddddddddddddddddddddddda
acccccccBccccccccccccccccccccBccccccccccccccccccccccccccrdddddddddddddddAdddddddddddddddddddddmdddddddddddddmddddddddddddddddddddddoddjdddda
acccccccccccBccccccccccicccccccccccccccccccccccccccccccccAddddddddddddddddddddddddddddddddddddddddddAdddddddddddddddddddddddjdddddddddddddda
accccccccccccccccccccccccccccccccccccciccccBcccccccccccccdddddddddddddddddddddddddddddddddddddddddddddddddddddddddddAdddddddddddddddddddddda
accccccccccccccccccccccccccccvcccccBcccccccccccccccccccccddddjddddddddddddddddddddddddddddddddddddddddddddddddddddddddddddddddddddddddddddda
accicccccccccccccccccccccccccccccccccccccccccccccccccccccdddddddddAddddddddddddddddddddddddddddddddddddddddddddddddddddddddsdddAddddddddddda
accccccccccccccccccBccccbccccccccccccccccccccbcccccccccccdddddddddddddddddddddddddddddddddddddddddddddddddddddddddddddddddddddddddddddddddda
accccccccccccccccccccccccccccccccicccccccccccccccBcccccccdddddddddddddddddddddmdddAddddddjdddddddddjdddddddddAdddddddddAddddddddddddddmdddda
accccccccBccccccccccccccccccccccccccccBccccccccccccccccccdddddddddddddddddddpddddddddddddddddddddddddddddddddddddjdddddddddddddmddddddddddda
accccccccccccccicccccccccccccccccccccccccccccccccccccccccddAdddddddddddAdddddddddddddddddddddAdddddddddddddddddddddddddddddddddddddddddddAda
acccccbccccccccccccccccccccccccccccccccccccccciccccccccccddddddmdddddddddddddddddddddddddddddddddddddAdddddddddddddAddddddddddddddddddddddda
aaaaaaaaaaaaaaaaaaaaaaaaaaaaaaaaaaaaaaaaaaaaaaaaaaaaaaaaaaaaaaaaaaaaaaaaaaaaaaaaaaaaaaaaaaaaaaaaaaaaaaaaaaaaaaaaaaaaaaaaaaaaaaaaaaaaaaaaaaaa
"}
