"a" = (/turf/simulated/floor/snow/snow2,/area/space)
"b" = (/turf/simulated/floor/snow/snow2,/area/tether_away/cave/explored)
"c" = (/turf/simulated/floor/outdoors/snow,/area/space)
"d" = (/turf/unsimulated/wall,/area/awaymission/desert)
"e" = (/turf/simulated/floor/outdoors/snow,/area/awaymission/desert)
"f" = (/turf/space/snowyscroll,/area/awaymission/desert)
"g" = (/turf/simulated/floor/outdoors/grass/sif/virgo3b,/area/awaymission/desert)
"h" = (/turf/simulated/floor/outdoors/grass/sif/forest,/area/awaymission/desert)
"i" = (/turf/simulated/floor/outdoors/ice,/area/awaymission/desert)
"j" = (/turf/simulated/floor/outdoors/rocks,/area/awaymission/desert)
"k" = (/turf/snow/snow2,/area/awaymission/desert)
"l" = (/turf/snow/plating,/area/awaymission/desert)
"m" = (/turf/snow/drift,/area/awaymission/desert)
"n" = (/turf/snow/gravsnow,/area/awaymission/desert)
"o" = (/turf/simulated/wall/iron,/area/awaymission/desert)
"p" = (/turf/simulated/wall/snowbrick,/area/awaymission/desert)
"q" = (/turf/simulated/wall/solidrock,/area/awaymission/desert)

(1,1,1) = {"
aaaaaaaaaaaaaaaaaaaaaaaaaaaaaaaaaaaaaaaaaaaaaaaaaaaaaaaaaaaaaaaaaaaaaaaaaaaaaaaaaaaaaaaaaaaaaaaaaaaaaaaaaaaaaaaaaaaaaaaaaaaaaaaaaaaaaaaaaaaa
abbbbbbbbbbbbbbbbbbbbbbbbbbbbbbbbbbbbbbbbbbbbbbbbbbbbbbbbbbbbbbbbbbbbbbbbbbbbbbbbbbbbbbbbbbbbbbbbbbbbbbbbbbbbbbbbbbbbbbbbbbbbbbbbbbbbbbbbbba
abccccccccccccccccccccccccccccccccccccccccccccccccccccccccccccccccccccccccccccccccccccccccccccccccccccccccccccccccccccccccccccccccccccccccba
abccccccccccccccccccccccccccccccccccccccccccccccccccccccccccccccccccccccccccccccccccccccccccccccccccccccccccccccccccccccccccccccccccccccccba
abccccccccccccccccccccccccccccccccccccccccccccccccccccccccccccccccccccccccccccccccccccccccccccccccccccccccccccccccccccccccccccccccccccccccba
abccccccccccccccccccccccccccccccccccccccccccccccccccccccccccccccccccccccccccccccccccccccccccccccccccccccccccccccccccccccccccccccccccccccccba
abccccccccccccccccccccccccccccccccccccccccccccccccccccccccccccccccccccccccccccccccccccccccccccccccccccccccccccccccccccccccccccccccccccccccba
abccccccccccccccccccccccccccccccccccccccccccccccccccccccccccccccccccccccccccccccccccccccccccccccccccccccccccccccccccccccccccccccccccccccccba
abccccccccccccccccccccccccccccccccccccccccccccccccccccccccccccccccccccccccccccccccccccccccccccccccccccccccccccccccccccccccccccccccccccccccba
abccccccccccccccccccccccccccccccccccccccccccccccccccccccccccccccccccccccccccccccccccccccccccccccccccccccccccccccccccccccccccccccccccccccccba
abccccccccccccccccccccccccccccccccccccccccccccccccccccccccccccccccccccccccccccccccccccccccccccccccccccccccccccccccccccccccccccccccccccccccba
abccccccccccccccccccccccccccccccccccccccccccccccccccccccccccccccccccccccccccccccccccccccccccccccccccccccccccccccccccccccccccccccccccccccccba
abccccccccccccccccccccccccccccccccccccccccccccccccccccccccccccccccccccccccccccccccccccccccccccccccccccccccccccccccccccccccccccccccccccccccba
abccccccccccccccccccccccccccccccccccccccccccccccccccccccccccccccccccccccccccccccccccccccccccccccccccccccccccccccccccccccccccccccccccccccccba
abccccccccccccccccccccccccccccccccccccccccccccccccccccccccccccccccccccccccccccccccccccccccccccccccccccccccccccccccccccccccccccccccccccccccba
abccccccccccccccccccccccccccccccccccccccccccccccccccccccccccccccccccccccccccccccccccccccccccccccccccccccccccccccccccccccccccccccccccccccccba
abccccccccccccccccccccccccccccccccccccccccccccccccccccccccccccccccccccccccccccccccccccccccccccccccccccccccccccccccccccccccccccccccccccccccba
abccccccccccccccccccccccccccccccccccccccccccccccccccccccccccccccccccccccccccccccccccccccccccccccccccccccccccccccccccccccccccccccccccccccccba
abccccccccccccccccccccccccccccccccccccccccccccccccccccccccccccccccccccccccccccccccccccccccccccccccccccccccccccccccccccccccccccccccccccccccba
abccccccccccccccccccccccccccccccccccccccccccccccccccccccccccccccccccccccccccccccccccccccccccccccccccccccccccccccccccccccccccccccccccccccccba
abccccccccccccccccccccccccccccccccccccccccccccccccccccccccccccccccccccccccccccccccccccccccccccccccccccccccccccccccccccccccccccccccccccccccba
abccccccccccccccccccccccccccccccccccccccccccccccccccccccccccccccccccccccccccccccccccccccccccccccccccccccccccccccccccccccccccccccccccccccccba
abccccccccccccccccccccccccccccccccccccccccccccccccccccccccccccccccccccccccccccccccccccccccccccccccccccccccccccccccccccccccccccccccccccccccba
abccccccccccccccccccccccccccccccccccccccccccccccccccccccccccccccccccccccccccccccccccccccccccccccccccccccccccccccccccccccccccccccccccccccccba
abccccccccccccccccccccccccccccccccccccccccccccccccccccccccccccccccccccccccccccccccccccccccccccccccccccccccccccccccccccccccccccccccccccccccba
abccccccccccccccccccccccccccccccccccccccccccccccccccccccccccccccccccccccccccccccccccccccccccccccccccccccccccccccccccccccccccccccccccccccccba
abccccccccccccccccccccccccccccccccccccccccccccccccccccccccccccccccccccccccccccccccccccccccccccccccccccccccccccccccccccccccccccccccccccccccba
abccccccccccccccccccccccccccccccccccccccccccccccccccccccccccccccccccccccccccccccccccccccccccccccccccccccccccccccccccccccccccccccccccccccccba
abccccccccccccccccccccccccccccccccccccccccccccccccccccccccccccccccccccccccccccccccccccccccccccccccccccccccccccccccccccccccccccccccccccccccba
abccccccccccccccccccccccccccccccccccccccccccccccccccccccccccccccccccccccccccccccccccccccccccccccccccccccccccccccccccccccccccccccccccccccccba
abccccccccccccccccccccccccccccccccccccccccccccccccccccccccccccccccccccccccccccccccccccccccccccccccccccccccccccccccccccccccccccccccccccccccba
abccccccccccccccccccccccccccccccccccccccccccccccccccccccccccccccccccccccccccccccccccccccccccccccccccccccccccccccccccccccccccccccccccccccccba
abccccccccccccccccccccccccccccccccccccccccccccccccccccccccccccccccccccccccccccccccccccccccccccccccccccccccccccccccccccccccccccccccccccccccba
abccccccccccccccccccccccccccccccccccccccccccccccccccccccccccccccccccccccccccccccccccccccccccccccccccccccccccccccccccccccccccccccccccccccccba
abccccccccccccccccccccccccccccccccccccccccccccccccccccccccccccccccccccccccccccccccccccccccccccccccccccccccccccccccccccccccccccccccccccccccba
abccccccccccccccccccccccccccccccccccccccccccccccccccccccccccccccccccccccccccccccccccccccccccccccccccccccccccccccccccccccccccccccccccccccccba
abccccccccccccccccccccccccccccccccccccccccccccccccccccccccccccccccccccccccccccccccccccccccccccccccccccccccccccccccccccccccccccccccccccccccba
abccccccccccccccccccccccccccccccccccccccccccccccccccccccccccccccccccccccccccccccccccccccccccccccccccccccccccccccccccccccccccccccccccccccccba
abccccccccccccccccccccccccccccccccccccccccccccccccccccccccccccccccccccccccccccccccccccccccccccccccccccccccccccccccccccccccccccccccccccccccba
abccccccccccccccccccccccccccccccccccccccccccccccccccccccccccccccccccccccccccccccccccccccccccccccccccccccccccccccccccccccccccccccccccccccccba
abccccccccccccccccccccccccccccccccccccccccccccccccccccccccccccccccccccccccccccccccccccccccccccccccccccccccccccccccccccccccccccccccccccccccba
abccccccccccccccccccccccccccccccccccccccccccccccccccccccccccccccccccccccccccccccccccccccccccccccccccccccccccccccccccccccccccccccccccccccccba
abccccccccccccccccccccccccccccccccccccccccccccccccccccccccccccccccccccccccccccccccccccccccccccccccccccccccccccccccccccccccccccccccccccccccba
abccccccccccccccccccccccccccccccccccccccccccccccccccccccccccccccccccccccccccccccccccccccccccccccccccccccccccccccccccccccccccccccccccccccccba
abccccccccccccccccccccccccccccccccccccccccccccccccccccccccccccccccccccccccccccccccccccccccccccccccccccccccccccccccccccccccccccccccccccccccba
abccccccccccccccccccccccccccccccccccccccccccccccccccccccccccccccccccccccccccccccccccccccccccccccccccccccccccccccccccccccccccccccccccccccccba
abccccccccccccccccccccccccccccccccccccccccccccccccccccccccccccccccccccccccccccccccccccccccccccccccccccccccccccccccccccccccccccccccccccccccba
abccccccccccccccccccccccccccccccccccccccccccccccccccccccccccccccccccccccccccccccccccccccccccccccccccccccccccccccccccccccccccccccccccccccccba
abccccccccccccccccccccccccccccccccccccccccccccccccccccccccccccccccccccccccccccccccccccccccccccccccccccccccccccccccccccccccccccccccccccccccba
abccccccccccccccccccccccccccccccccccccccccccccccccccccccccccccccccccccccccccccccccccccccccccccccccccccccccccccccccccccccccccccccccccccccccba
abccccccccccccccccccccccccccccccccccccccccccccccccccccccccccccccccccccccccccccccccccccccccccccccccccccccccccccccccccccccccccccccccccccccccba
abccccccccccccccccccccccccccccccccccccccccccccccccccccccccccccccccccccccccccccccccccccccccccccccccccccccccccccccccccccccccccccccccccccccccba
abccccccccccccccccccccccccccccccccccccccccccccccccccccccccccccccccccccccccccccccccccccccccccccccccccccccccccccccccccccccccccccccccccccccccba
abccccccccccccccccccccccccccccccccccccccccccccccccccccccccccccccccccccccccccccccccccccccccccccccccccccccccccccccccccccccccccccccccccccccccba
abccccccccccccccccccccccccccccccccccccccccccccccccccccccccccccccccccccccccccccccccccccccccccccccccccccccccccccccccccccccccccccccccccccccccba
abccccccccccccccccccccccccccccccccccccccccccccccccccccccccccccccccccccccccccccccccccccccccccccccccccccccccccccccccccccccccccccccccccccccccba
abccccccccccccccccccccccccccccccccccccccccccccccccccccccccccccccccccccccccccccccccccccccccccccccccccccccccccccccccccccccccccccccccccccccccba
abccccccccccccccccccccccccccccccccccccccccccccccccccccccccccccccccccccccccccccccccccccccccccccccccccccccccccccccccccccccccccccccccccccccccba
abccccccccccccccccccccccccccccccccccccccccccccccccccccccccccccccccccccccccccccccccccccccccccccccccccccccccccccccccccccccccccccccccccccccccba
abccccccccccccccccccccccccccccccccccccccccccccccccccccccccccccccccccccccccccccccccccccccccccccccccccccccccccccccccccccccccccccccccccccccccba
abccccccccccccccccccccccccccccccccccccccccccccccccccccccccccccccccccccccccccccccccccccccccccccccccccccccccccccccccccccccccccccccccccccccccba
abccccccccccccccccccccccccccccccccccccccccccccccccccccccccccccccccccccccccccccccccccccccccccccccccccccccccccccccccccccccccccccccccccccccccba
abccccccccccccccccccccccccccccccccccccccccccccccccccccccccccccccccccccccccccccccccccccccccccccccccccccccccccccccccccccccccccccccccccccccccba
abccccccccccccccccccccccccccccccccccccccccccccccccccccccccccccccccccccccccccccccccccccccccccccccccccccccccccccccccccccccccccccccccccccccccba
abccccccccccccccccccccccccccccccccccccccccccccccccccccccccccccccccccccccccccccccccccccccccccccccccccccccccccccccccccccccccccccccccccccccccba
abccccccccccccccccccccccccccccccccccccccccccccccccccccccccccccccccccccccccccccccccccccccccccccccccccccccccccccccccccccccccccccccccccccccccba
abccccccccccccccccccccccccccccccccccccccccdddddddddddddddddddddddddcccccccccccccccccccccccccccccccccccccccccccccccccccccccccccccccccccccccba
abccccccccccccccccccccccccccccccccccccccccdeeeeeeeeeeeeeeeeeeeeeeedcccccccccccccccccccccccccccccccccccccccccccccccccccccccccccccccccccccccba
abccccccccccccccccccccccccccccccccccccccccdeeeeeeeeeeeeeeeeeeeeeeedcccccccccccccccccccccccccccccccccccccccccccccccccccccccccccccccccccccccba
abccccccccccccccccccccccccccccccccccccccccdeeeeeeeeeeeeffffffeeeeedcccccccccccccccccccccccccccccccccccccccccccccccccccccccccccccccccccccccba
abccccccccccccccccccccccccccccccccccccccccdeeeeeeeeeeeeffffffeeeeedcccccccccccccccccccccccccccccccccccccccccccccccccccccccccccccccccccccccba
abccccccccccccccccccccccccccccccccccccccccdeeeeeeeeeeeeffffffeeeeedcccccccccccccccccccccccccccccccccccccccccccccccccccccccccccccccccccccccba
abccccccccccccccccccccccccccccccccccccccccdeeeeeeeeeeeeffffffeeeeedcccccccccccccccccccccccccccccccccccccccccccccccccccccccccccccccccccccccba
abccccccccccccccccccccccccccccccccccccccccdeeeeeeeeeeeeffffffeeeeedcccccccccccccccccccccccccccccccccccccccccccccccccccccccccccccccccccccccba
abccccccccccccccccccccccccccccccccccccccccdeeeeeeeeeeeeffffffeeeeedcccccccccccccccccccccccccccccccccccccccccccccccccccccccccccccccccccccccba
abccccccccccccccccccccccccccccccccccccccccdeeeeeeeeeeeeeeeeeeeeeeedcccccccccccccccccccccccccccccccccccccccccccccccccccccccccccccccccccccccba
abccccccccccccccccccccccccccccccccccccccccdeeeeeeeeeeeegggeeeeeeeedcccccccccccccccccccccccccccccccccccccccccccccccccccccccccccccccccccccccba
abccccccccccccccccccccccccccccccccccccccccdeeeeeeeeeeeeeeeeeeeeeeedcccccccccccccccccccccccccccccccccccccccccccccccccccccccccccccccccccccccba
abccccccccccccccccccccccccccccccccccccccccdeeeeeeeeeeeehhheeeeeeeedcccccccccccccccccccccccccccccccccccccccccccccccccccccccccccccccccccccccba
abccccccccccccccccccccccccccccccccccccccccdeeeeeeeeeeeeeeeeeeeeeeedcccccccccccccccccccccccccccccccccccccccccccccccccccccccccccccccccccccccba
abccccccccccccccccccccccccccccccccccccccccdeeeeeeeeeeeeiiieeeeeeeedcccccccccccccccccccccccccccccccccccccccccccccccccccccccccccccccccccccccba
abccccccccccccccccccccccccccccccccccccccccdeeeeeeeeeeeeeeeeeeeeeeedcccccccccccccccccccccccccccccccccccccccccccccccccccccccccccccccccccccccba
abccccccccccccccccccccccccccccccccccccccccdeeeeeeeeeeeejjjeeeeeeeedcccccccccccccccccccccccccccccccccccccccccccccccccccccccccccccccccccccccba
abccccccccccccccccccccccccccccccccccccccccdeeeeeeeeeeeeeeeeeeeeeeedcccccccccccccccccccccccccccccccccccccccccccccccccccccccccccccccccccccccba
abccccccccccccccccccccccccccccccccccccccccdeeeeeeeeeeeekkkeeeeeeeedcccccccccccccccccccccccccccccccccccccccccccccccccccccccccccccccccccccccba
abccccccccccccccccccccccccccccccccccccccccdeeeeeeeeeeeeeeeeeeeeeeedcccccccccccccccccccccccccccccccccccccccccccccccccccccccccccccccccccccccba
abccccccccccccccccccccccccccccccccccccccccdeeeeeeeeeeeellleeeeeeeedcccccccccccccccccccccccccccccccccccccccccccccccccccccccccccccccccccccccba
abccccccccccccccccccccccccccccccccccccccccdeeeeeeeeeeeeeeeeeeeeeeedcccccccccccccccccccccccccccccccccccccccccccccccccccccccccccccccccccccccba
abccccccccccccccccccccccccccccccccccccccccdeeeeeeeeeeeemmmeeeeeeeedcccccccccccccccccccccccccccccccccccccccccccccccccccccccccccccccccccccccba
abccccccccccccccccccccccccccccccccccccccccdeeeeeeeeeeeeeeeeeeeeeeedcccccccccccccccccccccccccccccccccccccccccccccccccccccccccccccccccccccccba
abccccccccccccccccccccccccccccccccccccccccdeeeeeeeeeeeennneeeeeeeedcccccccccccccccccccccccccccccccccccccccccccccccccccccccccccccccccccccccba
abccccccccccccccccccccccccccccccccccccccccdeeeeeeeeeeeeeeeeeeeeeeedcccccccccccccccccccccccccccccccccccccccccccccccccccccccccccccccccccccccba
abccccccccccccccccccccccccccccccccccccccccdeeeeeeeeeeeeoooeeeeeeeedcccccccccccccccccccccccccccccccccccccccccccccccccccccccccccccccccccccccba
abccccccccccccccccccccccccccccccccccccccccdeeeeeeeeeeeeeeeeeeeeeeedcccccccccccccccccccccccccccccccccccccccccccccccccccccccccccccccccccccccba
abccccccccccccccccccccccccccccccccccccccccdeeeeeeeeeeeepppeeeeeeeedcccccccccccccccccccccccccccccccccccccccccccccccccccccccccccccccccccccccba
abccccccccccccccccccccccccccccccccccccccccdeeeeeeeeeeeeeeeeeeeeeeedcccccccccccccccccccccccccccccccccccccccccccccccccccccccccccccccccccccccba
abccccccccccccccccccccccccccccccccccccccccdeeeeeeeeeeeeqqqeeeeeeeedcccccccccccccccccccccccccccccccccccccccccccccccccccccccccccccccccccccccba
abccccccccccccccccccccccccccccccccccccccccdeeeeeeeeeeeeeeeeeeeeeeedcccccccccccccccccccccccccccccccccccccccccccccccccccccccccccccccccccccccba
abccccccccccccccccccccccccccccccccccccccccdeeeeeeeeeeeeeeeeeeeeeeedcccccccccccccccccccccccccccccccccccccccccccccccccccccccccccccccccccccccba
abccccccccccccccccccccccccccccccccccccccccdddddddddddddddddddddddddcccccccccccccccccccccccccccccccccccccccccccccccccccccccccccccccccccccccba
abccccccccccccccccccccccccccccccccccccccccccccccccccccccccccccccccccccccccccccccccccccccccccccccccccccccccccccccccccccccccccccccccccccccccba
abccccccccccccccccccccccccccccccccccccccccccccccccccccccccccccccccccccccccccccccccccccccccccccccccccccccccccccccccccccccccccccccccccccccccba
abccccccccccccccccccccccccccccccccccccccccccccccccccccccccccccccccccccccccccccccccccccccccccccccccccccccccccccccccccccccccccccccccccccccccba
abccccccccccccccccccccccccccccccccccccccccccccccccccccccccccccccccccccccccccccccccccccccccccccccccccccccccccccccccccccccccccccccccccccccccba
abccccccccccccccccccccccccccccccccccccccccccccccccccccccccccccccccccccccccccccccccccccccccccccccccccccccccccccccccccccccccccccccccccccccccba
abccccccccccccccccccccccccccccccccccccccccccccccccccccccccccccccccccccccccccccccccccccccccccccccccccccccccccccccccccccccccccccccccccccccccba
abccccccccccccccccccccccccccccccccccccccccccccccccccccccccccccccccccccccccccccccccccccccccccccccccccccccccccccccccccccccccccccccccccccccccba
abccccccccccccccccccccccccccccccccccccccccccccccccccccccccccccccccccccccccccccccccccccccccccccccccccccccccccccccccccccccccccccccccccccccccba
abccccccccccccccccccccccccccccccccccccccccccccccccccccccccccccccccccccccccccccccccccccccccccccccccccccccccccccccccccccccccccccccccccccccccba
abccccccccccccccccccccccccccccccccccccccccccccccccccccccccccccccccccccccccccccccccccccccccccccccccccccccccccccccccccccccccccccccccccccccccba
abccccccccccccccccccccccccccccccccccccccccccccccccccccccccccccccccccccccccccccccccccccccccccccccccccccccccccccccccccccccccccccccccccccccccba
abccccccccccccccccccccccccccccccccccccccccccccccccccccccccccccccccccccccccccccccccccccccccccccccccccccccccccccccccccccccccccccccccccccccccba
abccccccccccccccccccccccccccccccccccccccccccccccccccccccccccccccccccccccccccccccccccccccccccccccccccccccccccccccccccccccccccccccccccccccccba
abccccccccccccccccccccccccccccccccccccccccccccccccccccccccccccccccccccccccccccccccccccccccccccccccccccccccccccccccccccccccccccccccccccccccba
abccccccccccccccccccccccccccccccccccccccccccccccccccccccccccccccccccccccccccccccccccccccccccccccccccccccccccccccccccccccccccccccccccccccccba
abccccccccccccccccccccccccccccccccccccccccccccccccccccccccccccccccccccccccccccccccccccccccccccccccccccccccccccccccccccccccccccccccccccccccba
abccccccccccccccccccccccccccccccccccccccccccccccccccccccccccccccccccccccccccccccccccccccccccccccccccccccccccccccccccccccccccccccccccccccccba
abccccccccccccccccccccccccccccccccccccccccccccccccccccccccccccccccccccccccccccccccccccccccccccccccccccccccccccccccccccccccccccccccccccccccba
abccccccccccccccccccccccccccccccccccccccccccccccccccccccccccccccccccccccccccccccccccccccccccccccccccccccccccccccccccccccccccccccccccccccccba
abccccccccccccccccccccccccccccccccccccccccccccccccccccccccccccccccccccccccccccccccccccccccccccccccccccccccccccccccccccccccccccccccccccccccba
abccccccccccccccccccccccccccccccccccccccccccccccccccccccccccccccccccccccccccccccccccccccccccccccccccccccccccccccccccccccccccccccccccccccccba
abccccccccccccccccccccccccccccccccccccccccccccccccccccccccccccccccccccccccccccccccccccccccccccccccccccccccccccccccccccccccccccccccccccccccba
abccccccccccccccccccccccccccccccccccccccccccccccccccccccccccccccccccccccccccccccccccccccccccccccccccccccccccccccccccccccccccccccccccccccccba
abccccccccccccccccccccccccccccccccccccccccccccccccccccccccccccccccccccccccccccccccccccccccccccccccccccccccccccccccccccccccccccccccccccccccba
abccccccccccccccccccccccccccccccccccccccccccccccccccccccccccccccccccccccccccccccccccccccccccccccccccccccccccccccccccccccccccccccccccccccccba
abccccccccccccccccccccccccccccccccccccccccccccccccccccccccccccccccccccccccccccccccccccccccccccccccccccccccccccccccccccccccccccccccccccccccba
abccccccccccccccccccccccccccccccccccccccccccccccccccccccccccccccccccccccccccccccccccccccccccccccccccccccccccccccccccccccccccccccccccccccccba
abccccccccccccccccccccccccccccccccccccccccccccccccccccccccccccccccccccccccccccccccccccccccccccccccccccccccccccccccccccccccccccccccccccccccba
abccccccccccccccccccccccccccccccccccccccccccccccccccccccccccccccccccccccccccccccccccccccccccccccccccccccccccccccccccccccccccccccccccccccccba
abccccccccccccccccccccccccccccccccccccccccccccccccccccccccccccccccccccccccccccccccccccccccccccccccccccccccccccccccccccccccccccccccccccccccba
abccccccccccccccccccccccccccccccccccccccccccccccccccccccccccccccccccccccccccccccccccccccccccccccccccccccccccccccccccccccccccccccccccccccccba
abccccccccccccccccccccccccccccccccccccccccccccccccccccccccccccccccccccccccccccccccccccccccccccccccccccccccccccccccccccccccccccccccccccccccba
abccccccccccccccccccccccccccccccccccccccccccccccccccccccccccccccccccccccccccccccccccccccccccccccccccccccccccccccccccccccccccccccccccccccccba
abccccccccccccccccccccccccccccccccccccccccccccccccccccccccccccccccccccccccccccccccccccccccccccccccccccccccccccccccccccccccccccccccccccccccba
abccccccccccccccccccccccccccccccccccccccccccccccccccccccccccccccccccccccccccccccccccccccccccccccccccccccccccccccccccccccccccccccccccccccccba
abccccccccccccccccccccccccccccccccccccccccccccccccccccccccccccccccccccccccccccccccccccccccccccccccccccccccccccccccccccccccccccccccccccccccba
abccccccccccccccccccccccccccccccccccccccccccccccccccccccccccccccccccccccccccccccccccccccccccccccccccccccccccccccccccccccccccccccccccccccccba
abccccccccccccccccccccccccccccccccccccccccccccccccccccccccccccccccccccccccccccccccccccccccccccccccccccccccccccccccccccccccccccccccccccccccba
abbbbbbbbbbbbbbbbbbbbbbbbbbbbbbbbbbbbbbbbbbbbbbbbbbbbbbbbbbbbbbbbbbbbbbbbbbbbbbbbbbbbbbbbbbbbbbbbbbbbbbbbbbbbbbbbbbbbbbbbbbbbbbbbbbbbbbbbbba
aaaaaaaaaaaaaaaaaaaaaaaaaaaaaaaaaaaaaaaaaaaaaaaaaaaaaaaaaaaaaaaaaaaaaaaaaaaaaaaaaaaaaaaaaaaaaaaaaaaaaaaaaaaaaaaaaaaaaaaaaaaaaaaaaaaaaaaaaaaa
"}
