"a" = (/turf/unsimulated/wall/transit,/area/space)
"b" = (/obj/structure/flora/tree/dead,/turf/simulated/floor/outdoors/snow,/area/tether_away/snowfields/unexplored/near)
"c" = (/turf/simulated/floor/outdoors/snow,/area/tether_away/snowfields/unexplored/near)
"d" = (/turf/simulated/floor/outdoors/snow,/area/tether_away/snowfields/unexplored/far)
"e" = (/turf/simulated/floor/outdoors/snow,/area/tether_away/snowfields/explored/near)
"f" = (/turf/simulated/floor/outdoors/snow,/area/tether_away/snowfields/explored/far)
"g" = (/turf/simulated/floor/outdoors/snow,/area/shuttle/excursion/away_snowfields)
"h" = (/obj/shuttle_connector/snowfields,/turf/simulated/floor/outdoors/snow,/area/tether_away/snowfields/explored/near)
"i" = (/obj/structure/flora/tree/pine,/turf/simulated/floor/outdoors/snow,/area/tether_away/snowfields/unexplored/near)
"j" = (/obj/structure/flora/tree/pine,/turf/simulated/floor/outdoors/snow,/area/tether_away/snowfields/unexplored/far)
"k" = (/obj/structure/flora/tree/pine,/turf/simulated/floor/outdoors/snow,/area/tether_away/snowfields/explored/far)
"l" = (/mob/living/simple_animal/hostile/tree,/turf/simulated/floor/outdoors/snow,/area/tether_away/snowfields/unexplored/near)
"m" = (/obj/structure/flora/tree/dead,/turf/simulated/floor/outdoors/snow,/area/tether_away/snowfields/unexplored/far)
"n" = (/obj/structure/flora/tree/dead,/turf/simulated/floor/outdoors/snow,/area/tether_away/snowfields/explored/near)

(1,1,1) = {"
aaaaaaaaaaaaaaaaaaaaaaaaaaaaaaaaaaaaaaaaaaaaaaaaaaaaaaaaaaaaaaaaaaaaaaaaaaaaaaaaaaaaaaaaaaaaaaaaaaaaaaaaaaaaaaaaaaaaaaaaaaaaaaaaaaaaaaaaaaaa
accccccccccccccccccccccccccccccccccccccccccccccccccccccccdddddddddddddddddddddddddddddddddddddddddddddddddddddddddddddddddddddddddddddddddda
accccccccccccccccccccccccccccccccccccccccccccccccccccccccdddddddddddddddddddddddddddddddddddddddddddddddmdddddddddddddddddddddddddddddddddda
acccccccccccccccccccccccccbcccccccccccccccccccccccccbccccdddjdddddddddddddddddddddddddddddmdddddddddddddddddddddddddddddddddddddddddddmdddda
accccccccccccccccccccccccccccccccccccicccccccccccccccccccdddddddmdddddddddddddddddddjddddddddddjdddddddddddddddddddjddddddddddddddddddddddda
accccciccccccccccccccccccccccccccccccccccccccccccccccccccddddddddddddddddddddddddddddddddddddddddddddddddddddddddddddddddddjddddddddddddddda
accccccccccccccccccbcccccccccccccccccccccccccccccccccccccdddddddddddddddddddddddddddddddddddddddddddddddddddddddddddddddddddddddddddddddddda
accccccccccccccccccccccccccccccccccccccccccccccccccccccccddddddddddddddddjdddddddddddddddddjddddddddddddddddddddddddddddddddddddddddddddddda
accccccccccccccccccccccccccccccccccccccccccccccccccccccccdddddddddddddddddddddddddddddddddddddddddddddddddddddddddmddddddddddddddddjddddddda
accccccccccccccccccccccccccccccccccccccccccccccccccccccccddddddddddddddddddddddddjdddddddddddddddddmddddddddddddddddddddddddddddddddddddddda
accccccccccccccccccccccccccccccccccccccccccccccccicccccccddddddddddddddddddddddddddddddddddddddddddddddddddddddddddddddddddddddddddddddmddda
acccccbccccccccccccccccccccccccccccccccccccccccccccccccccdddddddddddddddddddddddddddddddddddddddddddddddddddddddddddddddddddddddddddddddddda
acccccccccccccccccccccccccccicccccccccccbccccccccccccccccddddddddddddddddddddmddddddddddddddddddddddddddddddddddddddddddddddddddddddddddddda
acccccccccccccccccccccccccccccccccbccccccccccccccccccccccddddjddddddddjdddddddddddddddddddddddddddddddddddddddddddddddddddddmdddddddddddddda
accccccccccccccccccccccccccccccccccccccccccccccccccccccccddddddmdddddddddddddddddddddddddddddddddddddddddddjddddddddddddddddddddddddddddddda
accccccccccccccciccccccccccccccccccccccccccccccccccccccccdddddddddddddddddddddddddddddddddddddddddddddddddddddddddddddddddddddddddddddddddda
accciccccccccccccccccccccccccccccccccccccccccccccccccccccdddddddddddddddddddddddjdddddddddddddddddddddddddddddddddddddddddddddddddddddddddda
accccccccccccccccccccccccccccccccccccccccccccccccccccccccdddddddddddddddddddddddddddddddddddddddddddddddddddddddddddddddddddddddddddddddddda
accccccccccccccccccccccccccccccccccccccccicccccccccccccccddddddddddddddddddddddddddddddddddddjdddddjddddddddddddddddddddddddddddddddddddddda
accccccccccccccccccccccccccccccccccccccccccccccccccccccccddddddddddddddddddddddddddddddddddddddddddddddddddddddddddddddddddddddddddddmddddda
accccccccccccccccccccccccccccccccccccccccccccccccccccccccdddddddddjdddddddddddddddddddddddddddddddddddddddddddddddddjdddddddddddddddddddddda
accccccccccccccccccccccccccccciccccccccccccccccccccccccccdddddddddddddddddddddddddddddddddddddddddddddddddmddddddddddddddddddjddddddddddddda
accccccccccccccccbcccccccccccccccccccccccccccccccccccbcccdddddddddddddddddddddddddddddddmdddddddddddddddddddddddddddddddddddddddddddddddddda
accccccccccciccccccccccciccccccccccccccccccccccicccccccccdddddddddddddddddddddddddddddddddddddddddddddddddddddddddddddddddddddddddddddddddda
accccccccccccccccccccccccccccccccccccccccccccccccccccccccdddddddddddddddddddddddddddddddddddddddddddddddddddddddddddddddddddddddddddddddddda
accccccccccccccccccccccccccccccccccccccccccccccccccccccciddddddddddddddddddddddddddddddddddddddddddddddddddddddddddddddddddddddddddddddjddda
accccccccccccccccccccccccccccccccccccccccccccccccccccccccdddddddmdddddddddddddddddjddddddddddddmdddddddddddddddddddddddddddddddddmddddddddda
accicccccccccccccccccccccccccccccccciccccccccccccccccccccdddddddddddddddddddddddddddddddddddddddddddddddddddddddddddddddddddddddddddddddddda
accccccccccccccccccccccccccccccccccccccccccccccccccccccccddddddddddddddddddddddddddddddddddddddddddddddddddddddddjddddddddddddddddddddddddda
accccccccccccccccccccccccccccccccccccccccccccccccccccccccdddddddddddddddddddddddddddddddddddddddddddddddddddddddddddddddddddddddddddddddddda
accccccccccccccccccccccccccccccccccccccccccccccccccccccccdddddddddddddddddddddddddddddddddddddddddddddddddddddddddddddddddddddddddddddddddda
accccccccccccccccccccccccccccccccccccccccccccccccccccccccddddddddddddjdddddddddddddddddddddddddddddddjdddddddddddddddddddddmdddddddjddddddda
acccccccccccccccccccccccccccccccccccccccbccccccccccccccccdddddddddddddddddddddddddddddddddddddddddddddddddddddddddddddddddddddddddddddddddda
accccccccccccccicccccccccccciccccccccccccccccccccccccccccddjddddddddddddddddddddddddddddddddjdddddddddddddddddddddddddddddddddddddddddddddda
accccccccccccccccccccccccccccccccccccccccccccccccccccccccdddddddddddddddddddddddmddddddddddddddddddmddddddddddddddddddddddddddddddddddddddda
accccccccccccccccccccccccccccccccccccccccccccccccccccccccddddddddddddddddddddddddddddddddddddddddddddddddddddjddddddddddddddddddddddddddddda
accccccccicccccccccccccccccccccccccccccccccccccccccccccccddddddddddddddddddddddddddddddddddddddddddddddddddddddddddddddddddddddddddddddddmda
accccccccccccccccccccccccccccccccccccccccccccccccccccccccdddddddddddddddddddddddddddddddddddddddddddddddddddmddddddddddjddddddddddddddddddda
accccccccccccccccccccccccccccccccccccccccccccccccccccccccddddddddddddjddddddddddddddddddddddddddddddddddddddddddddddddddddddddddddddddddddda
acccccccccccccccccccccccccccbcccccccciccccccccccbccccccccdddddddddddddddddddddddddddddddddddjdddddddddddddddddddddddddddddddddddddddddddddda
accccccccccccccccccciccccccccccccccccccccccccccccccccccccdddddddddddddddddddddddddddddddddddddddddddddddddddddddddddddddddddddddddddddddddda
accccccccccccccccccccccccccccccccccccccccccccccccccccciccdddddddddddddddddddddddddddddddddddddddddddddddddddddddddddmdddddddddddddmdddddddda
accccccccccccccccccccccccccccccccccccccccccccccccccccccccdddddddddddddddddddddddddddddddddddddddddddddddddddddddddddddddddddddddddddddddddda
accccccccccccccccccccccccccccccccccccccccccciccccccccccccdddddddddddddddddddddddddddddddddddddddmdddddddddddddddddddddddddddddddddddddddddda
accccccccccciccccccccccccccccccccccccccccccccccccccccccccddddddddddddddddddddddddjdddddddddddddddddddddddjdddddddddddddddddddddjddddddddddja
accbcccccccccccccccccccccccccicccccccccccccccccccccccccccjdddddddddmddddddddddddddddddddddddddddddddddddddddddddddddddddddddddddddddddddddda
accccciccccccccccccccccccccccccccccccccccccccccccccccccccdddddddddddddddddddddddddddddddddddddddddddddddddddddddddddddddddddddddddddddddddda
acccccccccccccccbccccccccccccccccccccccccccccccccccccccccddddddddddddddddddddddddddddddddddddddddddddddddddddddmddddddddddddddddddddddddddda
accccccccccccccccccccccccccccccccccccccccccccccccccccccccddddddddddddddddddddddddddddddddddddddddddddddddddddddddddddddddddddddddddddddmddda
accccccccccccccccccccccccccccccccccccccccccccccccccccccccddddddddddddddddddddddddddddddddddddddddddddddddddddddddddddjddddddddddddddddddddda
accccccccccccccccccccccccccccccccccccccccccccccccccccccccdddddddddddddddddddddddddddddddddddddddddddddddddddddddddddddddddddddddddddddddddda
accccccccccccccccccccccccccccccccccccccccccccccccccccccccddddddddddddddddddddmdddddddddddddddddddddddddjddddddddddddddddddddddddddddddddddda
accccccccccccccccccccccccccccccccccccccccccccccccccccccccddjddddddddddddddddddddddddddddddddddddddddddddddddddddddddddddddddddddddddddddddda
accicccccccccccccccccccccccccccccccccccccccccccccccciccccdddddddddddddddddddddddddddddddddddddmddddddddddddddddddddddddddddddddddddddjddddda
accccccccccccccccccccciccccccccccccccccccccccccccccccccccddddddddddjddddddddddddddddddddddddddddddddddddddddddddddddddddddddddddddddddddddda
accccccccccccccccccccccccccccccccccccccccccccccccccccccccddddddddddddddddddddddddddddddddjddddddddddddddddddddddddddddddddddddmdddddddddddda
accccccccccccccccccccccccccccccccccccicccccccccccccccccccddddddddddddddddddddddddddddddddddddddddddddddddddddddddjddddddddddddddddddddddddda
accccccccccccccccccccccccccccccccccccccccccccccccccccccccdddddddddddddddddddddddddddddddddddddddddddddddddddddddddddddddddddddddddddddddddda
acccccccccccccccccccccccccccccccccccccccccccccccbccccccccdddddddddddddddddddddddddddddddddddddddddddddddddddddddddddddddddddddddddddddddddda
accccccccccccccccccccccccccccccccccccccccccccccccccccccccdddddddddddddddddddddddjddddddddddddddddddddddddddmddddddddddddddddddddddddddddddda
accccccccccccccccccccccccccccccccccccccccccccccccccccccccdddddddddddddddddddddddddddddddddddddddddddddddddddddddddddddddddddddddjdddddddddda
acccccccccccccccccicccccccccccccccccccccccccccceeeeecccccdddddddddddddddddddddddddddddddddddddjdddddddddddddddddddddddddddddddddddddmdddddda
acccccccccccccccccccccccccccccccccccccccciccceeeeeeeeecccdddddddddddddddddddddddddddddddddddddddddddddddddddddddddddddddddddddddddddddddddda
acccccccccbcccccccccccccccccccccccccccccccceeneeeeeeeeeecddddddmddddddjddddddddddddmdddddddddddddddddddddddddddddddjddddddddddddddddddddddda
accccccccccccccccccccccccccccccccccccccccceeeeeeeeeeeeeeedddddddddddddddddddddddddddddddddddddddddddddddddddddddddddddddddddddddddddddddddda
acccccccccccccccccccccccccccccccccccccccceeeeeeeeeeeeeeeefddddddddddddddddddddddddddddddddddddddddddmdddddddddddddddddddddddddddddddddddddda
accccccciccccccccccccccccccccccccccccccceeeeeeeeeeeeeeeeeffddddddddddddddddddddddddddddddddjddddddddddddddddddddddddddddddddddddddddddddddda
acccccccccccccccccccccccccccccicccccccceeeeeeeeeeeeeeeeeefkfddddddddddddddddddddddddddddddddddddddddddddddddddddddddddmddddddddddddddddddjda
acccccccccccccccccccccccccccccccccccccceeeeeeegggggggeeeefffddddddddddddddddddjdddddddddddddddddddddddddddddddddddddddddddddddddddddddddddda
accccccccccccccccccccccccccccccccccccceeeeeeegggggggggeeeffffddddddddddddddddddddddddddddddddddddddddddddddddddddddddddddddddddddmddddddddda
acccccccccccccccicccccccccccccccccccceeeeeeeegggggggggeeefffffddddddddddddddddddddddddddddddddddddddddddddddddddddddddddddddddddddddddddddda
acccccccccccccccccccccccccccccccccccceeeeeeeegggggggggeeefffffddddddddddddddddddddddddddddddddddddddddddddddddddddddddddddddddddddddddddddda
acccccccccccccccccccccccccccccccccccceeeeeeeegggggggggeeefffffddddddddddddddddddddddddddddddddddddddddddjddddddddddjddddddddddddddddddddddda
acccccccccccccccccccccccccccccccccccceeeeeeeegggggggggeeefffffddddddddddddddddddddddddddddddddddddddddddddddddddddddddddddddddddddddddddddda
accccccbcccccccccccccccccbccccccccccceeeeeeeegggggggggeeefffffddddjdddddddddddddddddddddddddjdddddddddddddddddddddddddddddddddddddddddddddda
acccccccccccccccccccccccccccccccccccceeeeeeegggggggggggeefffffdddddddddddddddddddddddddddddddddddmddddddddddddddddddddddddddddddddddddddmdda
acccccccccccccccccccccccccccccccccccceeeeeeegggggggggggeefffffdddddddddddddddddddddddddddddddddddddddddddddddddddddddddddddddddjddddddddddda
accccccccccccccccccccccccccccccccccccceeeeeegggggggggggeeffffdddddddddddddddddddddddddddddddddddddddddddddddddddddddddddddddddddddddddddddda
accccccccccccccccccccccccccccccccccccieeeeeegggggggggggeeffffdddddddddddddddmddddddddddddddddddddddddddddddddddddmddddddddddddddddddddddddda
acccccccccccccccciccccccccccccccccccccceeeeegggggggggggeefffddddddddddddddddddddddddddddddddddddddddddddddddddddddddddddddddddddddddddjdddda
acccccccccccccccccccccccccccccccccccccceeeeeggggeegggggeefffdddddddddddjddddddddddddddddddddddddddddddddddddddddddddddddddddddddddddddddddda
accccccccccccccccccccccccccccccccccccccceeeegggeeeeegggeeffddmddddddddddddddddddddddddddddddjdddddddddddddddddddddddddddddddddddddddddddddda
accccccccccccccccccccccccccccccccccccccceeeeeeeeeheeeeeeeffddddddddddddddddddddddjddddddddddddddddddddddddddddddddddddddddddddddddddddddddda
acccccccccccccccccccccccccccccccccccccccceeeeeeeeeeeeeeeefddddddddddddddddddddddddddddddddddddddddddddddddddjddddddddddddddddmddddddddddddda
acccciccccccccccccccccccccccccccccccccccceeeeeeeeeeeeeeeefddddddddddddddddddddddddddddddddddddddddddddddddddddddddddddddddddddddddddddddddda
accccccccccccccccccccccccccccccccciccccccceeeeeeeeeeeeeeedddddddddddddddddddddddddddddddddddddddddddddddddddddddddddddddddddddddddddddddjdda
accccccccccccbcccccccccccccccccccccccclcccceeeeeeeeeeeeecddddddddddddddddddddddddddddddddddddddddddddddddddddddddddddddddjddddddddddddddddda
accccccccccccccccccccccccccccccccccccccccccceeeeeeeeeeeccdddddddddddddddddddddddddjddddddddddddddddmdddddddddddddddddddddddddddddddddmddddda
accccccccccccccccccccccccccccccccccccccccccccceeeeeeeccccddddddddjddddddddjdddddddddddddddddddddjdddddddddddddddddddddddddddddddddddddddddda
accccccccbcccccccccccccccccicccccccccccccccccccceeeccbcccdddddddddddddddddddddddddddddddddmddddddddddddddddddddddddddddddddddmddddddddddddda
accccccccccccccccccccccccccccccccccccccccccccccccccccccccdddddddddddddddddddddddddddddddddddddddddddddddddddddddddddddddddddddddddddddddddda
accccccccccccccccccccccccccccccccccccccccccccccccccccccccdddddddddddddddddddddddddddddddddddddddddddddddddddddddddddddddddddddddddddddddddda
accccccccccccccccccccccccccccccccccccccccccccccccccccccccddddddddddddmddddddddddddddddddddddddddddddddddddddddddddddddddddddddddddddddddddda
accccccccccccccccccccccccccccccccccccccccccccccccccicccccddddddddddddddddddddddddddddddddddddddddddddddddddddddjddddddddddddddddddddddddddda
acccccccccccccccccccccccccccccccccccccbccccccccccccccccccdddddddddddddddddddddddddddddddddddddddddddddddddddddddddddddddddddddddddddddddddda
accccccccccccccccccccccccccccccccccccccccccccccccccccccccddddddddddddddddddddddddddddddddjddddddddddddddddddddddddddddddddddddddddddjdddddda
accccccccccccccccccccccccccccccccccccccccccccccccccccccccddddddddddddddddddddddddddddddddddddddddddddddmddddddddddddddddddddddddddddddddddda
accccccccccccccccccccccccccccccccccccccccccccccccccccccccddddddddddddddddddddjddddddmdddddddddddddddddddddddddddddddddddddddddddddddddddddda
accccccccccccccccccccccccccccccccccccccccccccccccccccccccdddddddddddddddddddddddddddddddddddddddddddddddddddddddddddddddddddddddddddddddddda
accccccccccccccccbcccccccccccccccccccccccccccccccccccccccddddjdddddddddddddddddddddddddddddddddddddjdddddddddddddddddddddmddddddddddddddddda
acccccccccccccccccccccccccccciccccccccccccccccccccccbccccdddddddddddddddddddddddddddddddddddddddddddddddddddddddddddddddddddddddddddddddddda
accccccccicccccccccccccccccccccccccccccciccccccccccccccccddddddddddddddddddddddddddddddddddddddddddddddddddddddddddddddddddddddddddddddmddda
accccccccccccccccccccccccccccccccccccccccccccccccccccccccdddddddddddddddddddddddddddddddddddddddddddddddddddddddddddddddddddddddddddddddddda
acccccccccccccccccccccccccccccccbccccccccccccccccccccccccddddddddddddddddddjdddddddddddddddddddddddddddddddddddddddddddddddddddddjddddddddda
accccccccccccccccccccccciccccccccccccccccccccccccccccccccdddddddddddddddddddddddddddddddddddddddddddddddddddmdddddddddddddddddddddddddddddda
accccccccccccccccccccccccccccccccccccccccccccccccccccccccddddddddddddddddddddddddddddddddddjddddddddddddddddddddddddddddddddddddddddddddddda
accccccccccccccccccccccccccccccccccccccccccccccccccccccccdddddddddddddddddddddddddddddddddddddddddddddddddddddddddddddddddddddddddddddddddda
accccccccccccccccccccccccccccccccccccccccccccccccccccccccdddddddjddmdddddddddddddddddddddddddddddddddddddddddddddddddddddjddddddddddddddddda
accccccccccccccccccccccccccccccccccccccccccccccccccccccccdddddddddddddddddddddddddddddddddddddddddddddddddddddddddddddddddddddddddddddddddda
accccccccccccccccccccccccccccccccccccccccccbcccccccccccccddddddddddddddddddddddddddjddddddddddmdddddddddddddddddddddddddddddddddddddddddddda
acicccccccccccccccccccccccbccccccccccccccccccccccccccccccdddddddddddddddddddddddddddddddddddddddddddddddddddddddddddddddddddddddddddddddjdda
accccccccccccccccccccccccccccccccccccccccccccccccccccccccjddddddddddddddddddddddddddddddddddddddddddddddddddddddddddddddddddddddmdddddddddda
accccccccccccccccccccccccccccccccccccccccccccccccccccccccddddddddddddddddddddddddddddddddddddddddddddddddjddddddddddddddddddddddddddddddddda
acccccccccbccccccccccccccccccccccccccccccccccccccccccccccddddddddddddddddddddddmdddddddddddddddddddddddddddddddddmddddddddddddddddddddddddda
accccccccccccccccccccbcccccccccccccciccccccccccccccccccccdddddddddddddddddddddddddddddddddddddddddddddddddddddddddddddddddddddddddddddddddda
accccccccccccccccccccccccccccccccccccccccccccccccccccccccddddddddddddddddddddddddddddddddddddddddddddddddddddddddddddddddmddddddddddddddddda
accccccccccccccccccccccccccccccccccccccccccccccccccccccccddddddjdddddddddddddddddddddddddddddddddddmddddddddddddddddddddddddddddddddddddddda
accccccccccccccccccccccccccccccccccccccccccccccicccccccccddddddddddddddddddddddddjddddddddddddddddddddddddddddddddddddddddddddjdddddddddddda
accccccccccccccccccccccccccccccccccccccccccccccccccccccccddddddddddddddddddddddddddddddddddddddddddddddddddddddddddddddddddddddddddddddmddda
accccccccccccccccccccccccccccccccccccccccccccccccccccccccdddddddddddddddddddddddddddddddddddmdddddddddddddddddddddddddddddddddddddddddddddda
accccccccccccccccccccccccccccccccccccccccccccccccccbcccccdddddddddddddddddddddddddddddddddddddjdddddddddddddddddddddddddddddddddddddddddddda
acccccccciccccccccccccccccicccccccccccccbccccccccccccccccdddddddddddddddddddddddddddddddddddddddddddddddddddddddddddddddddddddddddmdddddddda
accccccccccccccccccccccccccccccccccccccccccccccccccccccccdddmdddddddddddddddddddddddddddddddddddddddddddddddddjdddddddddddmdddddddddddddddda
accccccccccccccccccccccccccccccccccccccccccccccccccccccccdddddddddddddddddddddddddddddddddddddddddddddddddddddddddddddddddddddddddddddddddda
accccbcccccccccccccccccccccccccbcccccccccccccccccccccccccdddddddddddddddddddddddddddddddddddddddddddddddddddddddddddddddddddddddddddddddddda
accccccccccccccccccccccccccccccccccccccccccccccccccccccccddddddddddddddddddjddddddddddddddddddddddddddddddddddddddddddddddddddddddddddddddda
accccccccccccccccccccccccccccccccccccccccccccccccciccccccdddddddddddddddddddddddddddddddddddddddddddddddddddddddddddddddddddddddddddddddddda
acccccccccccccbccccccccccccccccccccccccccccccccccccccccccdddddddddddddddddddddddddddddddddddddddddddddddddddddddddddddddddddddddddddddddddda
accccccccccccccccccccccccccccccccccccccccccccccccccccccccdddddddddddddddddddddddddddddddddddddddddddddddddddddddddddddddddddddddddddddddddda
accccccccccccccccccccccccccccccccccccccccccccccccccccccccdddddddddddddddddddddddddddddddddddddmdddddddddddddmdddddddddddddddddddddddddjdddda
accccccccccccccccccccccicccccccccccccccccccccccccccccccccdddddddddddddddddddddddddddddddddddddddddddddddddddddddddddddddddddjdddddddddddddda
accccccccccccccccccccccccccccccccccccciccccccccccccccccccdddddddddddddddddddddddddddddddddddddddddddddddddddddddddddddddddddddddddddddddddda
accccccccccccccccccccccccccccccccccccccccccccccccccccccccddddjddddddddddddddddddddddddddddddddddddddddddddddddddddddddddddddddddddddddddddda
accicccccccccccccccccccccccccccccccccccccccccccccccccccccdddddddddddddddddddddddddddddddddddddddddddddddddddddddddddddddddddddddddddddddddda
acccccccccccccccccccccccbccccccccccccccccccccbcccccccccccdddddddddddddddddddddddddddddddddddddddddddddddddddddddddddddddddddddddddddddddddda
accccccccccccccccccccccccccccccccicccccccccccccccccccccccdddddddddddddddddddddmddddddddddjdddddddddjddddddddddddddddddddddddddddddddddmdddda
accccccccccccccccccccccccccccccccccccccccccccccccccccccccddddddddddddddddddddddddddddddddddddddddddddddddddddddddjdddddddddddddmddddddddddda
accccccccccccccicccccccccccccccccccccccccccccccccccccccccdddddddddddddddddddddddddddddddddddddddddddddddddddddddddddddddddddddddddddddddddda
acccccbccccccccccccccccccccccccccccccccccccccciccccccccccddddddmddddddddddddddddddddddddddddddddddddddddddddddddddddddddddddddddddddddddddda
aaaaaaaaaaaaaaaaaaaaaaaaaaaaaaaaaaaaaaaaaaaaaaaaaaaaaaaaaaaaaaaaaaaaaaaaaaaaaaaaaaaaaaaaaaaaaaaaaaaaaaaaaaaaaaaaaaaaaaaaaaaaaaaaaaaaaaaaaaaa
"}
