"a" = (/turf/unsimulated/wall/planetary/virgo6,/area/space)
"b" = (/turf/simulated/floor/outdoors/snow/virgo6,/area/tether_away/snowfields/unexplored/near)
"c" = (/turf/simulated/floor/outdoors/snow/virgo6,/area/tether_away/snowfields/unexplored/far)
"d" = (/obj/structure/flora/bush,/turf/simulated/floor/outdoors/snow/virgo6,/area/tether_away/snowfields/unexplored/far)
"e" = (/obj/structure/flora/bush,/turf/simulated/floor/outdoors/snow/virgo6,/area/tether_away/snowfields/unexplored/near)
"f" = (/obj/structure/flora/tree/dead,/turf/simulated/floor/outdoors/snow/virgo6,/area/tether_away/snowfields/unexplored/far)
"g" = (/obj/structure/flora/tree/dead,/turf/simulated/floor/outdoors/snow/virgo6,/area/tether_away/snowfields/unexplored/near)
"h" = (/obj/structure/flora/tree/pine,/turf/simulated/floor/outdoors/snow/virgo6,/area/tether_away/snowfields/unexplored/far)
"i" = (/obj/tether_away_spawner/snowfields_hard,/turf/simulated/floor/outdoors/snow/virgo6,/area/tether_away/snowfields/unexplored/far)
"j" = (/obj/structure/flora/tree/pine,/turf/simulated/floor/outdoors/snow/virgo6,/area/tether_away/snowfields/unexplored/near)
"k" = (/obj/tether_away_spawner/snowfields_medium,/turf/simulated/floor/outdoors/snow/virgo6,/area/tether_away/snowfields/unexplored/far)
"l" = (/obj/tether_away_spawner/snowfields_hard,/turf/simulated/floor/outdoors/snow/virgo6,/area/tether_away/snowfields/unexplored/near)
"m" = (/obj/tether_away_spawner/snowfields_boss,/turf/simulated/floor/outdoors/snow/virgo6,/area/tether_away/snowfields/unexplored/far)
"n" = (/obj/tether_away_spawner/snowfields_medium,/turf/simulated/floor/outdoors/snow/virgo6,/area/tether_away/snowfields/unexplored/near)
"o" = (/obj/tether_away_spawner/snowfields_easy,/turf/simulated/floor/outdoors/snow/virgo6,/area/tether_away/snowfields/unexplored/far)
"p" = (/obj/tether_away_spawner/snowfields_diyaab,/turf/simulated/floor/outdoors/snow/virgo6,/area/tether_away/snowfields/unexplored/far)
"q" = (/obj/tether_away_spawner/snowfields_passive,/turf/simulated/floor/outdoors/snow/virgo6,/area/tether_away/snowfields/unexplored/near)
"r" = (/obj/tether_away_spawner/snowfields_easy,/turf/simulated/floor/outdoors/snow/virgo6,/area/tether_away/snowfields/unexplored/near)
"s" = (/obj/tether_away_spawner/snowfields_passive,/turf/simulated/floor/outdoors/snow/virgo6,/area/tether_away/snowfields/unexplored/far)
"t" = (/turf/simulated/floor/outdoors/snow/virgo6,/area/tether_away/snowfields/explored/near)
"u" = (/turf/simulated/floor/outdoors/snow/virgo6,/area/tether_away/snowfields/explored/far)
"v" = (/obj/structure/flora/bush,/turf/simulated/floor/outdoors/snow/virgo6,/area/tether_away/snowfields/explored/far)
"w" = (/obj/structure/flora/bush,/turf/simulated/floor/outdoors/snow/virgo6,/area/tether_away/snowfields/explored/near)
"x" = (/obj/tether_away_spawner/snowfields_easy,/turf/simulated/floor/outdoors/snow/virgo6,/area/tether_away/snowfields/explored/near)
"y" = (/obj/structure/flora/tree/pine,/turf/simulated/floor/outdoors/snow/virgo6,/area/tether_away/snowfields/explored/far)
"z" = (/obj/structure/flora/tree/pine,/turf/simulated/floor/outdoors/snow/virgo6,/area/tether_away/snowfields/explored/near)
"A" = (/obj/tether_away_spawner/snowfields_medium,/turf/simulated/floor/outdoors/snow/virgo6,/area/tether_away/snowfields/explored/near)
"B" = (/obj/structure/flora/tree/dead,/turf/simulated/floor/outdoors/snow/virgo6,/area/tether_away/snowfields/explored/near)
"C" = (/obj/structure/flora/tree/dead,/turf/simulated/floor/outdoors/snow/virgo6,/area/tether_away/snowfields/explored/far)
"D" = (/obj/tether_away_spawner/snowfields_hard,/turf/simulated/floor/outdoors/snow/virgo6,/area/tether_away/snowfields/explored/far)
"E" = (/turf/simulated/floor/outdoors/snow/virgo6,/area/shuttle/excursion/away_snowfields)
"F" = (/obj/tether_away_spawner/snowfields_passive,/turf/simulated/floor/outdoors/snow/virgo6,/area/tether_away/snowfields/explored/far)
"G" = (/obj/shuttle_connector/snowfields,/turf/simulated/floor/outdoors/snow/virgo6,/area/tether_away/snowfields/explored/near)
"H" = (/mob/living/simple_animal/hostile/tree,/turf/simulated/floor/outdoors/snow/virgo6,/area/tether_away/snowfields/explored/near)
"I" = (/obj/tether_away_spawner/snowfields_medium,/turf/simulated/floor/outdoors/snow/virgo6,/area/tether_away/snowfields/explored/far)
"J" = (/obj/tether_away_spawner/snowfields_diyaab,/turf/simulated/floor/outdoors/snow/virgo6,/area/tether_away/snowfields/unexplored/near)
"K" = (/obj/tether_away_spawner/snowfields_hard,/turf/simulated/floor/outdoors/snow/virgo6,/area/tether_away/snowfields/explored/near)

(1,1,1) = {"
aaaaaaaaaaaaaaaaaaaaaaaaaaaaaaaaaaaaaaaaaaaaaaaaaaaaaaaaaaaaaaaaaaaaaaaaaaaaaaaaaaaaaaaaaaaaaaaaaaaaaaaaaaaaaaaaaaaaaaaaaaaaaaaaaaaaaaaaaaaa
abbbbbbbbbbbbbbbbbbbbbbbbbbbbbbbbbbbbbbbbbbbbbbbbbbbbbbbbcccccccccccccccdccccccccccccccccccccccccccccccccccccccccccccccdccccccccccccccccccca
abebbbbbbbbbbbbbbbbbbbbbbbbbbbbbbbbbbbbbbbbbbbbbbbbbbbbbbcccccccccccccccccccccccccccccccccccccccccdcccccfccdcccccccccccccccccccccccccccccdca
abbbbbbbbbbbbbbbbbbbbbbbbbgbbbbbbbbbbbbbbbbbbbbbbbbbgebbbccchcccccccccccccccicccccccccccccfcccccccccccccccccccccccccccccccccccccccdcccfcccca
abbbbbbbbbbbbbbbebbbbbbbbbbbbbbbbbbbbjbbbbbbbbbbbbbbbbbbbcccccccfccccccccccccccccccchccdkcccccchccccccccccccccccccchccccccccccccccccccccccca
abbbbbjbbbbbbbbbbbbbbbbbbbbbbbbbbbbbbbbbbbbebbbbbbbbbbbbbcccccccccccccccccccccccccccccccccccccccccccccccccccccccccccccccccchccccccccccccccca
abbbbbbbbbbbbbbbbbbgbbbbbbebbbbbbbbbblbbbbbbbbbbbbbbbbbbbcccccccccccccccccccccccdccccccccccccccccccccccccccccdccccccckccccccccccccccccccccda
abbbbbbbbbbbbbbbbbbbbbbbbbbbbbbbbebbbbbbbbbbbbbbbbbbbbbbbcccccccccccccccchccccccccccccccccchcccccccdccccccccccccccccccccccccccccccccccccccca
abbbbbbbbbbbbbbbbbbbbbbbbbbbbbbbbbbbbbbbbbbbbbbbbbbbbbbbbccccccccccccccccccccccccccccccccccccccccccccccdccccccccccfccccccccmccccccchccccccca
abbbbnbbbbbbbbebbbbbbbbbbbbbbbbbbbbbbbbbbbbbbbbbbbbbbbbbbcccccccckccccccccccccccchcccccccccccccccccfccccccccccccccccccccccccccccccccccccccca
abebbbbbbbbbbbbbbbbbbbbbbbbbbbbbbbbbbbbbbbbbbbbbbjbbbbbbbccccccccccccccccdcccccccccccccccccccckccccccccccccccccccccccccccccccccccccccccfccca
abbbbbgbbbbbbbbbbbbbbebbbbbbbbbbbbbbbbbbbbbbbbbbbebbbbbbbccccccccccccccccccccccccccccccccccccccccccccccccccdcccccccccccccccccccccdccccccccca
abbbbbbbbbbbbbbbbbbbbbbbbbbbjbbbbbbbbbbbgbbbbbbbbbbbbbbbbccccccccccccccccccccfccccccccccccccccccccccccccccccccocccccccccccccccccccccccccccca
abbbbbbbebbbbbbbbbbbbbbbbbbbbbebbbgbbbbbbbbbbbbbbbbbbbbbbdccchcccccccchccccccccccccccccccdccccccccccccccccccccccccccccdcccccfcccccccccccccca
abbbbbbbbbbbbbbbbbbbbbbbbbbbbbbbbbbbbbbbbbbbbbbnbbbbbbbbbccccccfccccccccccccccccccccccccccccccccccccccccccchccccccccccccccccccccccccccccccca
abbbbbbbbbbbbbbbjbbbbbbbbbbbbbbbbbbbbbebbbbbbbbbbbbbbbbbbccccccccccccccccccccccccccccccccccccccccdcccccccccccccccccccccccccccccccccdccicccca
abbbjbbbbbbbbbbbbbbbbbbbbbbbbbbbbbbbbbbbbbbbbbbbbbbbbbbbbcccccccccdccccccccccccchcccccccccccccccccccccoccccccccdccccccccccccccccccccccccccca
abbbbbbbbbbbbbbbbbbbbbbebbbbbbbbbbbbbbbbbbbbbbbbbbbbbbbbbcccccccccccccccccdcccccccccccccccccccccccccccccccccccccccccccccccccccdcccccccccccca
abbbbbbbbbbbbbbbbbbbbbbbbbbbbbbbbbbbbbbbbjbbbbbbbbbbbbbbbccccccccccccccccccccccccdkcccccccccchccccchcdcccccccccccccccccckcccccccccccccccccca
abbbbbbbbbbbbbbbbebbbbbbbbbbbbbbbbbbbbbbbbbbbbbbebbbbbbbbcccccccccccccccccccccccccccccccccccccccccccccccccccdccccccccccccccccccccccccfccccca
abbbbbbbbbbbbbbbbbbbbbbbbbbbbbbbbbbbbbbbbbbbbbbbbbbbbbbbbcccccdccchccccccccccccccccccccccccccccccccccccccccccccccccchcccccccccccccccccccccca
abbbebbbbbbbbbbbbbbbbbbbbbbbbbjbbbbbbbbbbbbbbbbbbbbbbbbbbccpcccccccccccccccccccccccccccccccdccccccccccccccfcccccccccccccccccchccccccccccccca
abbbbbbbbbbbbbbbbgbbbbbbbbbbbbbbbbbbbbbbbbbbbbbbbbbbbgbbbccccpccccccccccccccccccccccccccfcccccccccccccccccccdcccccccccccccccccccccccccccccca
abbbbbbbbbbbjbbbbbbbbbbbjbbbbbbbebbbbbbbbbbbbbbjbbbbbbbbbpcccccccccccccccccccccccccccdccccccccccccccccccccccccccccccccccccccccccccccccccccca
abbbbbbbbbbbbbbbbbbbbbbbbbbbbbbbbbbbbbbbbbbbbbbbbbbbbbbbbccdcpcccccccccccccccccccccccccccccccccccccccccccccccccccccccccdccccccccccdcccccccca
abbbbbbbbbbbbbbbbbbbbbbbbbbbbbbbbbbbbbbbbbebbbbbbbbbbbbbjccpcccccccccccccdcccccccccccccckcccccccccccdcccccccccccccocccccccccccccccccccchccca
abbbbbbbbbbbbbbbbbbbbbbbbbbbbbbbbbbbbbbbbbbbbbbbbbbbbbbbbcccccccfccccccccccccccccchccccccccccccfccccccccccccccdccccccccccccccccccfccccccccca
abbjbbbbbbbebbbbbbbbbbbbbbbbbbbbbbbbjbbebbbbbbbbbbbbbbbbbccccccccccdccccccccccccccccccccccccccdcccccccccccccccccccccccccccccccccccccccdcccca
abbbbbbbbbbbbbbbbbbbbbbbbbbbbbbbbbbbbbbbbbbbbbbbbbbbbbbbbcccccccccccccccccccccccccccccccccccccccccccccccccccccccchccccccccccccccicccccccccca
abbbbbbbbbbbbbbbbbbbbbbqbbbbbbbbbbbbbbrbbbbbbbbbbbbbbbbbbccccccccccccccccccccccdcccccccccccccccccccccccccccccccccccccdccccccccccccccccccccca
abbbbbbbbbbbbbbbbbbbbbbbebbbbbbbbbbbbbbbbbbbbbbbbbbbbbbbbccccccccccccccccccccccccccccccccccdccccccccccccccccccccccccccccccccccccccccccccccca
abbbbbbbbbbbbbbbbbbbbbbbbbbbbbbbbbbbbbbbbbbbbbbbbbbbbebbbcccccccccccchccccccccccccccdcccccccccccccccchccccccdcccckcccccccccfccccccchccccccca
abbebbbbbbbbbbbbbbbbbbbbbbbbbbbbbbbbbbbbgbbbbbbbbbbbbbbbbccccccccccccccccccccccccccccccckcccccccccccdccccccccccccccccccccccccccdccccccccccca
abbbbbbbbbbbbbbjbbbbbbbbbbbbjbbbbbbbbbbbbbbbbbbbbbbbbbbbbcchcccdcccccccccccccccccccccccccccchcccccccccccccccccccccccccccccccccccccccccccccca
abbbbbbbbbbbbbbbbbbbbbbbbbbbbbbbbbbbbbbbbbbbbbbbbbbbbbbbbccccccccccccccccccdccccfccccccccccccccccccfccccccccccccccdcccccccccccccccccccccccca
abbbbbrbbbbbbbbbbebbbbbbbbbbbbbbbbbbbbbbbbbbbbbbbbbbbbbbbcccccccccccccccccccccccccccccccdcccccccccccccccccccchccccccccccccccccccccccccccccca
abbbbbbbbjbbbbbbbbbbbbbbbbbbbbbbbbbbbbbbbbbbebbbbbbbbbbbbccccccccccccccccccccccccdccccccccccccccccccccccccccccccccccccccccccccccccccdccccfca
abbbbbbbbbbbbbbbbbbbbbbbbbbbbbbbbbbbbbbbbbbbbbbbbbbbbbnbbcccccccccccccccccccccccccccccccccccccccccccccdcccccfcccccccccchccdcccccccccccccccca
abebbbbbbbbbbbbbbbbbbbbbbbbbbbbbbbbbbbbbbbbbbbbbbbbbbbbbbcccscccccccchccccccccccccccccccccccccccdcccccccccccccccccccccccccccccccccccccccccca
abbbbbbbbbbbbbbbbbbbbbbbbbbbgbbbbbbbbjbbbbbbbbbbgbbbbbbbbccccccccccccccccccccccccccccccccccchccccccccccccccdccccccccccccccccccccdcccccccccca
abbbbbbbbbbbbbbbbbbbjbbbbbbbbbbbbbbbbbbebbbbbbbbbbbbbbbbbcccccccccccccccccccccccccccccdccccccccccccccccccccccccccdccccccccccccccccccccccccca
abbbbbbbbbbbbbqbbbbbbbbbbbbbbbbbbbbbbbbbbbbbbbbbbbbbbbjbbcccccccccdccccccccckcccccccccccccccccccccccciccccccccccccccfcccckcdccccccfcccccdcca
abbbbbbbbbbbbbbbbbbbbebbbbbbbbbbbbbbbbbbbbbbbbbbbqbbbbbbbcccccccccccccccccccccccccccccccocccccccccccccccccccdcccccccccccccccccccccccccccccca
abbbbbbbbbbbbbbbbbbbbbbbbbbbbbbbbbbbbbbbbbbbjbbbbbbbbbbbbcccccccccccccccccccccccccccdcccccccccccfcccccccccccccccccccccccccccccccccccccccccca
abbbbbbbbbbbjbbbbbbbbbbbbbbbbbbbnbbbbbbbbbbbbbbbbbbbbbbbbcccccccccccccccccccccccchccccccccccccccccccccccchccccccccccccccccccccchccccccccccha
abbgbbbbbbbbbbbbbbbbbbbbbbbbbjbbbbbbbbbbbbbbbbbbbbbbbbebbhcccccccccfcccccdccccccccccccccccccccccccccccccccccccccdcccccccdccccccdccccccccccca
abbbebjbbbbbbbbbbbbbbbbbbbbbbbbebbbbbbbbbbbbbbbbbbbbbbbbbcccccccccccccccccccccccccccccccccccccccccdcccccccccccccdcccccccccccccccccccccccccca
abbbbbbbbbbbbbbbgbbbbbbbbbbbbbbbbbbbbbebbbtttttttttttttttuuuuuuuuuuuuuuuuuuucdccccccccccccccdccccccccccccccccccfccccccccccccccccccccccccccca
abbbbbbbbbbbbbbbbbbbbbbbbbbbbbbbbbbbbbbbbbtttttttttttttttuuuuuuvuuuuuuuuuuuucccccccccccccccccccccccccccccccccdccccccccccccccccccccccoccfccca
abbbbbbbbbbbbbbbbbbbbbbbbbbbbbbbbbbbbbbbbbtttwtttttttttttuuuuuuuuuuuuuuuuuuucccccccccccccccccccccccccccccccccccccckcchccccccccccccccccccccca
abbbbbbbbbbbbbbbbbbbbbbbbbbbbbbbbbbbbbbbbbttttttttttttxttuuuuuuuuuuuuuvuuuuucccccccccccdccccccccccccccccccccccccccccccdcccccccccccdcccccccca
abbbbbbnbbbbbbbebbbbbbbbbbbbqbbbbbbbbbbbbbtttttttttttttttuuuuuuuuuuuuuuuuuuucfccccccccccccccccccccccccchccccccdccccccccccccccccccccccccccdca
abbbbbbbbbbbbbbbbbbbbbbbbbbbbbbbbbbbbbbbbbtttttttttttttttuuyuuuuuuuuuuuuuuuuccccccccccccccccccccccccccccccccccccccccccccccdcccccccccccccccca
abbjbbbbebbbbbbbbbbbbbbbbbbbbbbebbbbbbbbttttttttttttzttttuuuuuuuuuuuuuuuuuuuccccccccccccccccccfcccccccccckccccccccccccccccccccccccccchccccca
abbbbbbbbbbbbbbbbbbbbbjbbbbbbbbbbbbbbbbbtttttttttttttttttuuuuuuuuuuyuuuuuuuuccccccccccccccccccccccccccccccccccccccccccccccccccccccccccccccca
abbbbbbbbbbbbbbbbbbbbbbbbbbbbbbbbbbbbttttttttttttttttttttuuuuuuuuuuuuuuuuuuuccccccdcccccchccccccccccdcccccccccccccccccccccccccfcccccdcccccca
abbbbbbbbbbbbbbbbbbbbbbbbbbbbbbbbbbbbztttwtttttttttttttttuuvuuuuuuuuuuuuuvuucccccccccccccccckcccccccccccccccdcccchccccicccccccccccccccccdcca
abbbbbbbbbbbbbbbbbbbbbbbbbbbbbbbbbbbbtttttAttttttttttttttuuuuuuuuuuuuuuuuuuuccccccccccccccdcccccccccccccccccccccccccccccccccccccccccccccccca
abbbbbbbbbbbbbbbbbbbbbbbbbbbbbbbbbbbbtttttttttttBttttttttuuuuuuuuuuuuuuuuuuuccccccccccccccccccccccccccccccccccccccccccccccccccccccccccccccca
abbbbbbbbbbbbbbbbbbbbbbbebbbbbbbbbbbbttttttttttttttwtttttuuuuuuuuuuuuuuuuuuucccchccccccccccccccccccccccccccfccccccdcccccccdcccccccccccccccca
abbbbbbbbbbbbbbbbbbbbbbbbbbbbbbbbbbbettttttttttttttttttttuuuuuuuuuuuuuuuuuuvcccccccccccccccccccccccccccccccccccccccccdcccccccccchcccccccccca
abbebrbbbbbbbbbbbbjbbbbbbbbbbqbbbbbttttttttttttttttttttttuuuuuuuuuuuuuuuuuuuccccccccccdccccccchccccccccccccccccccccccccccccccccccccdfcccccca
abbbbbbbbbbbbbbbbbbbbbbbbbbbbbbbbbbttttttztttttttttttttttuuuuuuuuuuuuuuuuuuucccccccccccccccccdccccccccccccccccccccccccccccccccccccccccccdcca
abbbbbbbbbgbbbbbbbbbbbbbbbbbbbbbbbbttttttttttBtttttttttttuuuuuuCuvuuuuyuuuuucccccccfcccccccccccccdcccccccdccccccccchccccccccccccccccccccccca
abbbbbbbbbbbbbbbbbbbbbbbbbbbbbbbbbbttttttttttttttttttttttuuuuuuuuuuuuuuuuuuucccccccccccccccccccccccccccccccccccccccccccccccccdccccccccccccca
abbbbbbbbbbbbbbbbbbbbbbbbbbbbbbbbbbttttttttttttttttttttttuuuuuuDuuuuuuuuuuuuccccccccccccccccccccccccfcccccccccdcccccccccccccccccccciccccccca
abbbbbbbjbbbbbbnbbbebbbbbbbbbbbbbbtttwtttttttttttttttttttuuuuuuuuuuuuuuuuuuuccccccccccccccchccccccccccccccccccccmcccccccccccccccccccccccccca
abbbbbbbbbbbbbbbbbbbbbbbebbbbbjbbbtttttttttttttttttttttttuyuuuuuuuuuuuuuvuuuccccccccccccccccccccccccccccccccdcccccccccfcccccccccccccccccchca
abbbbbbbbbbbbbbbbbbbbbbbbbbbbbbbbtttttttttttttEEEEEEEttttuuuuuuuuuuuuuuuuuuucchccccccdccccccccckcccccccccccccccccccccccccccccccccccccccccdca
abbbbbebbbbbbbbbbbbbbbbbbbbbbbbbbttttttttttttEEEEEEEEEttwuuuuuuuuuuuuuuuuuuuccccccccccccccccccccccccdccccccccccccccccccccccdcccccfccccccccca
abbbbbbbbbbbbbbbjbbbbbbbbbbbbbbbbttttttttttttEEEEEEEEEtttuuuuuuuuuuuuuuuuuuucccccccccccccccdccccccccccccccccccccccccccccccccccccccccccccccca
abbbbbbbbbbbbbbbbbbbbbbbbbbbbbbbbttttttttttttEEEEEEEEEtttuuuuuuuuvuuuuuuuuuuccccccccccccccccccccccccccccccccccccccccccccccccccccccccccccdcca
abbbbbbbbbbbbbbbbbbbbbbbbbbbbbbbbttttttttttttEEEEEEEEEtttuuuuuuuuuuuuuuuuuvucccccccccccccccccccccccccccchcccccccccchdcccccccccccccccdcccccca
abbbbbbbbbbbbbbbbbbbbbbbbbbbbqbbbttttttwtttttEEEEEEEEEtttuuuuuuuuuuuuuuuuuuucccccccccccccccccccccccccccccccccdccccccccccccccccccccccccccccca
abbnbbbgbbbbbbbbebbbbbbbbgbbbbbbbttttttttttttEEEEEEEEEtttuuuuuuuuuyuuuuuuuuucccccccccccccccchcccccccccccccccccccccccccccccccccccccccccccccca
abbbbbbbbbbbbbbbbbbbbbbbbbbbbbbbbtttttttttttEEEEEEEEEEEttuuuuuuuuuuuuuuuuuuuccccccccdccccccccccccfccccccccccccccccccccccccccccccccccccccfcca
abebbbbbbbbbbbbbbbbbbbbbbbbbbbbebtttttttttttEEEEEEEEEEEttuuuuuuuuuuuuuuuuuuuccccccccccccccccccccccccccccccccccccccccccccccccccchccccccccccca
abbbbbbbbbbbbbbbbbbbbbbbbbbbbbbbbtttttttttttEEEEEEEEEEEttuuuvuuuuuuuuFuuuuuuccccccccccccccccccccccccccccccccdcccccccccccccccccccccccccccccca
abbbbbbbbbbbbbbbbbbbbbbbbbbbbbbbbbtttzttttttEEEEEEEEEEEttuuuuuuuuuuuuuuuuuuufcccccccccdccccccccccccdcccccccccccccfcccccdccccccccccccccccccca
abbbbbbbbbbbbbbbbjbbbbbbbbbbbbbbbbttttttttttEEEEEEEEEEEttuuuuuuuuuuuuuuuuuuvcccccccccccccccccccccccccccccccccccccccccccccccccccccdcccchcccca
abbbbbbbbbbebbbbbbbbbbbbbebbbbbbbbttttttttttEEEEttEEEEEttuuuuuuuuuuvuuuyuuuuccccccccccccccccccccccccccccccccccccccccccccccccccccccccccccccca
abbbbbbbbbbbbbbbbbbbbbbbbbbbbbbbbbtttwttttttEEEtttttEEEttuuuuCuuuuuuuuuuuuuuccccccccccccccdchcccccccccocccccccccccccccccccccccccccccciccccca
abbbbbbbbbbbbbbbbbbbbbbbbbbbbbbbbbtttttttttttttttGtttttttuuuuuuuuuuuuuuuuuuuccccchcccccccccccccccccccccccccccccdccckccccccccccccccccccccccca
abbbebbbbbbbbbbbbbbbbbbbbbbbbbbbbbtttttttttttttttttttttttuuuuuuuuuuuuuuuuuvuccccccccccccccccccccccccccdccccchccccccccccccccccfccccccccccccca
abbbbjbbbbbbbbbbbbbbbbbbbbebbbbbbbtttttttttttttttttttttttuuuuuuuuuvuuuuuuuuucccccccccccccccccccccccccccccccccccccccccccccccdccccccccccccccca
abbbbbbbbbbbbbbbbbbebbbbbbbbbbbbbbzttttttttttttttttttttttuuuuuuuuuuuuuuuuuuuccccccccccccccccccccccccccccccccccccccccccccccccccccccdccccchcca
abbbbbbbbbbbbgbbbbbbbbbbbbbbbnbbbbttttHttttttttttttttttttuuuuuuuuuuuuuuuuuuuccccccccccccccccccccccccccccccdcccccccccccccchccccccccccccccccca
abbbbbbbbbbbbbbbbbbbbbbbbbbbbbbbbbbttttttttttttttttttttttuuuuuuuuuuuuuuuuuuucccckchccccdcccccccccccfcccccccccccccccccdcccccccccccccccfccccca
abbbbbbbbbbbbbqbbbbbbbbbbbbbbbbbbbbttttttttwtttttttttttttuuuuuuuuyuuuuuuuuyucccccccccccccccccccchccccccccccccccdcccccccccccccccccccccccccdca
abbbbbbbbgebbbbbbbbbbbbbbebjbbbbbbbbtttttttttttttttttBtttuuuuuuuuuuuuuuuuuuuccdcccccccccccfccccccccccccccccccccccccccccccccccfccccccccccccca
abbbbbbbbbbbbbbbbbbbbbbbbbbbbbbbbbbetttttttttttttttttttttuuvuuuuuuuuuuuuuuuucccccccccccccccccccccccccccccccdcccccccccccccdccccccccccccccccca
abbbbbbbbbbbbbbbbbbbbbbbbbbbbbbbbbbbbttttttttttttttttttttuuuuuuuuuuuuuuuuuuuccccccccccccccccccccccccccccccccccccccccccccccccccccccccccccccca
abbbbbbbbbbbbbbbbbbbbbbbbbbbbbbbbbbbbttttttttttttttttttttuuuuuuuuuuuuCuuuuuucccccccccccccccdccccccccccccccccccccccccccccccccccccccccccccdcca
abbbbbbbbbbbbbbbbbbbbbbebbbbbbbbbbbbbttttttttttttttztttttuuuuuuuIuuuuuuuuuuucccccccccccccccccccccccccccdccccccchcccccccdccccccccccccccccccca
abbbbbbbbebbbbbbbbbbbbbbbbbbbbbbbbbbbtBttttttttttttttttttuuuuuuuuuuuuuuuuuvuccccccccccccccccccccccdcccccccccccccccdcccccccccccccccocccccccca
abbbnbbbbbbbbbbbbbbbbbbbbbbbbbbbbbbbbbbtttttttttwttttttttuuuuuuuuuuuuuuuuuuuccccccccccccchccccccccccccccccccccccccccccccccccccccdccchcccccca
abbbbbbbbbbbbbbbJbbbbbbbbbbbbbbbebbbbbbttttttttttttttttttuuuuuuuuuuuuuuuuuuucccccccccccccccccccccccccccfccdcccccccccccccccccccccccccccccccca
abbbebbbbbbbbbbbbbbebbbbbbbbbbbbbbbbbbbttttttttttttttttttuuuuuvuuuuuuuuuuuuuchccccccfccccccccccccccccccccccccccccocccccdccccccccccccccccccda
abbbbbbbbbbbbbbbbbbbbJbbbbbbbbbbbbbbbbbbbtKttttttttttttttuuuuuuuuuuuuuuuuuuucccccccccccccccccccccccccccccccccccccccccccccccccccccccdccccccca
abbbbbbbbbbbbbbbbgbbbbbbbbbbbbbbbbbbbbbbbttttttttttttttttuuuuyuuuuuuuuuuuuuucccccccccccdccccccccccchcccccccccccccccccccccfccccccccccccccccca
abbbbbbbbbbbbbJbbbbbbbbbbbbbbjbbbbbbbbbbbtttttttttttBttttuuuuuuuuuuuuuuuuuuucccccdcccccccccccccccccccdccccccccdcccccccccccccdcccccccccccccca
abbbbbbbbjbbbbbbbbJbbbbbbbbbbbbbbbbbbbbbjttttttttttttttttuuuuuuuuuuuuvuuuuuucccccccccccccccccccccccccccccccccccccccccdcccccccccccccccccfccca
abbbbbbbbbbbbbbbbbbbbebbbbbbbbbbbbbbbbbbbttttttttttttttwtuuuuuuuuuuuuuuuuuuuccccccccccccccccccccccccccccccccccccccccccccccccccccccccccccccca
abbbbbbbbbbbbbbbbbbbbbbbbbbbbbbbgbbbbbbbbttttttttttttttttuuuuuuuuuuuuuuuuuuycccccccccccccccccccccccccccccdccccccccccccccccccccccchccccdcccca
abbbbbbbbbbbbJbbbbbJbbbbjbbbbbbbbbbbbbbbbbbebbbbbbbbbbbbbuuuuuuuuuuuuuuuuuuuccccccccccccccccccccccccccccccccfcccccccccccccccccccccccccccccca
abbbbbbbbbbbbbbbbbbbbbbbbbbbbbbbbbbbbbbbbbbbbbbbbbbbbbbbbccckcccccccccccccccccccccccccccccchccccccccicccccccccccciccccccccccccccccccccccccca
abbbbbbbbbebbbbbbbbbbbbbbbbbbbbbbbbbbbbbbbbbbbbbbbbbbbbbbccccccccccccccccccccdcccccccdcccccccdcccccccccccccccccccccdccccccccccccccccccccccca
abbbbbbbbbbbbbbbbJbbbbbbbbbbbbbbbbbebbbbbbbbbbbbbbbbbbbbbccccccchccfccccccccccccccccccccccccccccccccccccccccccccccccccccchcccdcccccccccdccca
abbbbbbbbbbbbbbbbbbbbbbbbbebbbbbbbbbbbbbbbbbbbbbbbbbbbbbbcccccccccccccccccccccccccccccccccccccccccccccccccccccccccccccccccccccccccccccccccca
abbbbbbbbbbbbbbbbbbbbbbbbbbbbbbbbbbbbbbbbbbgbbbbbbbbbbbbbcccccccccccccccccccccccccchccccccccccfcccccccccccccccccccccccccccccccccccccccccccca
abjbbbbbbbbbbbbbbbbbbbbbbbgbbbbbbbbbbbbbbbbbbbbbbbbbbbbbbccccccccccccccccccccccccccccccccccccccccccccdccccccccdccccccccccccccccccccccccchcca
aebbbbbbbbbbebbbbbbbbbbbbbbbbbbbbbbbbbbbbbbbebbbbbbbbbbbbhcccccccccccccccccccccccccccoccccccccccccccccccccccccccccccccccccccccccfcccccccccca
abbbbbbbbbbbbbbbbbbbbbbbbbbbbbbbbbbbbbbbbbbbbbbbbbbbbbbbbcccccdccccccccccdccccccccccccccccccccccccccccccchcccccccccccccccdccccccccccicccccca
abbbbbbbbbgbbbbbbbbbbbbbbbbbbbbbbbbbbbbbbbbbbbbbbbbbbbbebccccccccccccccccccccccfcccccccccccdcccccccccccccccccccccfccccccccccccccccccccccccca
abbbbbbbbbbbbbbbbbbbbgbbbbbbbbbbbbbbjbbbbbbbbbbbbbbbbbbbbcccccccccccccccccccccccccdccccccccccccccccccccccccccccdccccccccccccccccccccccccdcca
abbbbbbbbbbbbbbbbbbbbbbbbbbbbbbbbbbbbbbbbbbbbbbbbbbbbbbbbccccccccccccccccccccccccccccccccccccccccccccccccccccccccccccccccfccccccccccccccccca
abbbbbbbbbbbbbbbbbbbbbbebbbbbbbbbbbbbbbbbbbrbbbbbbbbbbbbbcccccchcccccccccccccccccccccccccccccccccccfcccccccccccccccccccccccccccccdccccccccca
abbbbbbbbbbbebbbbbbbbbbbbbbbbbbbbbbbebbbbbbbbbbjbbbbbbbbbcccccccccccccccscccccccchcccccccccccccccccccccccdcccccccccccccccccccchcccccccccccca
abbbbebbbbbbbbbbbbbbbbbbbbbbbbbnbbbbbbbbbbbbbbbbbbbbbbbbbccccccccdcccccccccccccccccccccccccccccccccccccccccccccccccccdcccccccccccccccccfccca
abbbbbbbbbbbbbbbbbbbbbbbbbbbbbbbbbbbbbbbbebbbbbbbbbbbebbbcccccccccccccccccccccccccccccccccccfcccccccccccccccccccccccccccccccccdcccccccccccca
abbqbbbbbbbbbbbbbbbbbbbbbbbbbbbbbbbebbbbbbbbbbbbbbbgbbbbbcccccccccccccccccccccccccccccdccccccchccccpppccccccccccccccccccccccccccccccccccccca
abbbbbbbbjbbbbblbbbbbbbbbbjbbbbbbbbbbbbbgbbbbbbbbbbbbbbbbcccccccccccccccdccccccccccccccccccccccccccpppccccccccccccccccccccccccccccfcccccccca
abbbbbbbbbbbbbbbbbbbbbbbbbbbbbbbbbbbbbbbbbbbbbbbbbbbbbbbbcccfccccccccccccccccccccccccccccccccccccccccccccccccdhccdccccccccfcccccccccccccccda
abbbbbbbbbbbbbbbbbbbebbbbbbbbbbbbbbbbbbbbbbbbbbbbbbbbbbbbcccccccccccccccccccccccccccccccccccccccccccccccccccccccccccccccccccccccccccccccccca
abbbbgbbbbbbbbbbbbbbbbbbbbbbbbbgbbbbbbbbbbbbbbbbbbbbbbbbbccccccccccccccccccccccccmcccccccccccccccccccdccccccccccccccccccccccccccccccccccccca
abbbbbbbbbbbbbbbbbbbbbbbbbbbbbbbbbbbbbbbbbbbbbbbbbbbbbbbbccccccdccccccccccchccccccccdccccccccccccccccccccccccccccccccccccccdccccccccccccdcca
abbbbbbbbbbbbbbbbbbbbbbbbbbbbbbbbbbbbbebbbbbbbbbbbjbbbbbbcccccccccccccccccccccccccccccccccccccccccccccccccccccccccccccccccccccccccccccccccca
abbbbbbbbbbbbbgbbbbbbbbbbbbbbbbbbbbbbbbbbbbbbebbbbbbbbbbbccccccccccccccccccccccccccccccccccccccccccccccccccccccdcccccccccccccccccdccccccccca
abbbbbbbbbbbbbbbbbbbbbbbbbbbbbbbbbbbbbbbbbbbbbbbbbbbbbbbbcccccccccccccccccccccccccccccccccccccccccccccccccccccccccccccccccccccccccccccccccca
abbbbbbbebbbbbbbbbbbbbbbbbbbbebbbbbbbbbbbbbbbbbbbbbbbbbbncccccccccccccccdcccccccccccccccccccccfcccccccccccccfccccccccccccccccccccccicchcccca
abbbbbbbbbbbebbbbbbbbbbjbbbbbbbbbbbbbbbbbbbbbbbbbbbbbbbbbdccccccccccccccccccccccccccccccccccccccccccdccccccccccccccccccccccchcccccccccccccca
abbbbbbbbbbbbbbbbbbbbbbbbbbbbbbbbbbbbbjbbbbebbbbbbbbbbbbbcccccccccccccccccccccccccccccccccccccccccccccccccccccccccccdcccccccccccccccccccccca
abbbbbbbbbbbbbbbbbbbbbbbbbbbbqbbbbbebbbbbbbbbbbbbbbbbbbbbcccchccccccccccccccccccccccccccccccccccccccccccccccccccccccccccccccccccccccccccccca
abbjbbbbbbbbbbbbbbbbbbbbbbbbbbbbbbbbbbbbbbbbbbbbbbbbbbbbbcccccccccdccccccccccccccccccccccccccccccccccccccccccccccccccccccccocccdccccccccccca
abbbbbbbbbbbbbbbbbbebbbbgbbbbbbbbbbbbbbbbbbbbgbbbbbbbbbbbcccccccccccccccccccccccccccccccccccccccccccccccccccccccccccccccccccccccccccccccccca
abbbbbbbbbbbbbbbbbbbbbbbbbbbbbbbbjbbbbbbbbbbbbbbbebbbbbbbcccccccccccccccccccccfcccdcccccchccccccccchcccccccccdcccccccccdccccccccccccccfcccca
abbbbbbbbebbbbbbbbbbbbbbbbbbbbbbbbbbbbebbbbbbbbbbbbbbbbbbccccccccccccccccccckcccccccccccccccccccccccccccccccccccchcccccccccccccfccccccccccca
abbbbbbbbbbbbbbjbbbbbbbbbbbbbbbbbbbbbbbbbbbbbbbbbbbbbbbbbccdcccccccccccdcccccccccccccccccccccdcccccccccccccccccccccccccccccccccccccccccccdca
abbbbbgbbbbbbbbbbbbbbbbbbbbbbbbbbbbbbbbbbbbbbbjbbbbbbbbbbccccccfcccccccccccccccccccccccccccccccccccccdcccccccccccccdccccccccccccccccccccccca
aaaaaaaaaaaaaaaaaaaaaaaaaaaaaaaaaaaaaaaaaaaaaaaaaaaaaaaaaaaaaaaaaaaaaaaaaaaaaaaaaaaaaaaaaaaaaaaaaaaaaaaaaaaaaaaaaaaaaaaaaaaaaaaaaaaaaaaaaaaa
"}
