//MAP CONVERTED BY dmm2tgm.py THIS HEADER COMMENT PREVENTS RECONVERSION, DO NOT REMOVE
"a" = (
/turf/simulated/floor/outdoors/snow/frozen_world,
/area/frozen_planet/ruins)
"j" = (
/turf/simulated/floor/frozen_world,
/area/frozen_planet/ruins)
"m" = (
/turf/simulated/wall/frozen_world,
/area/frozen_planet/ruins)
"z" = (
/obj/structure/fireplace{
	pixel_y = 19
	},
/turf/simulated/floor/frozen_world,
/area/frozen_planet/ruins)
"F" = (
/obj/random/mob/robotic/hivebot{
	mob_faction = "frozen"
	},
/turf/simulated/floor/frozen_world,
/area/frozen_planet/ruins)
"L" = (
/obj/structure/table/gamblingtable,
/obj/random/triumph/uncertain,
/turf/simulated/floor/carpet/purcarpet,
/area/frozen_planet/ruins)
"M" = (
/obj/structure/flora/tree/pine,
/turf/simulated/floor/outdoors/snow/frozen_world,
/area/frozen_planet/ruins)
"N" = (
/obj/structure/closet/crate/secure/loot,
/turf/simulated/floor/wood/frozen_world,
/area/frozen_planet/ruins)
"O" = (
/obj/structure/bed,
/turf/simulated/floor/carpet/purcarpet,
/area/frozen_planet/ruins)
"Q" = (
/obj/random/mob/robotic/hivebot{
	mob_faction = "frozen"
	},
/turf/simulated/floor/outdoors/snow/frozen_world,
/area/frozen_planet/ruins)
"S" = (
/turf/simulated/floor/carpet/purcarpet,
/area/frozen_planet/ruins)
"W" = (
/turf/simulated/floor/wood/frozen_world,
/area/frozen_planet/ruins)

(1,1,1) = {"
a
a
a
a
a
a
M
a
a
a
a
a
"}
(2,1,1) = {"
a
M
a
a
Q
a
a
a
a
a
M
a
"}
(3,1,1) = {"
a
a
a
M
a
a
a
a
M
a
a
a
"}
(4,1,1) = {"
a
a
a
m
m
m
m
m
a
a
M
M
"}
(5,1,1) = {"
a
M
a
m
z
W
N
m
m
a
m
a
"}
(6,1,1) = {"
a
a
M
m
W
j
F
j
a
a
a
a
"}
(7,1,1) = {"
a
a
a
m
S
S
j
a
a
a
a
a
"}
(8,1,1) = {"
a
M
a
m
O
L
W
m
m
m
a
a
"}
(9,1,1) = {"
a
a
a
m
m
m
m
m
a
a
a
a
"}
(10,1,1) = {"
a
M
Q
a
a
a
a
a
a
M
Q
a
"}
(11,1,1) = {"
a
a
a
a
M
a
a
a
M
a
a
a
"}
(12,1,1) = {"
a
M
a
a
a
a
a
a
a
a
a
M
"}
