//MAP CONVERTED BY dmm2tgm.py THIS HEADER COMMENT PREVENTS RECONVERSION, DO NOT REMOVE
"a" = (
/turf/simulated/floor/outdoors/snow/frozen_world,
/area/frozen_planet/ruins)
"f" = (
/obj/random/triumph/uncertain,
/turf/simulated/floor/outdoors/snow/frozen_world,
/area/frozen_planet/ruins)
"m" = (
/obj/structure/flora/tree/pine,
/turf/simulated/floor/outdoors/snow/frozen_world,
/area/frozen_planet/ruins)
"r" = (
/obj/structure/closet/crate/secure/loot,
/turf/simulated/floor/outdoors/snow/frozen_world,
/area/frozen_planet/ruins)
"v" = (
/turf/simulated/floor/old_tile/green/frozen_world{
	color = "#63A83A";
	icon = 'icons/turf/flooring/tiles_vr.dmi';
	icon_state = "tile_full"
	},
/area/frozen_planet/ruins)
"x" = (
/turf/simulated/wall/frozen_world,
/area/frozen_planet/ruins)
"E" = (
/turf/simulated/floor/frozen_world,
/area/frozen_planet/ruins)
"G" = (
/obj/item/reagent_containers/food/snacks/sliceable/pizza/margherita,
/obj/structure/table,
/turf/simulated/floor/frozen_world,
/area/frozen_planet/ruins)
"K" = (
/obj/random/mob/robotic/hivebot{

	mob_faction = "frozen"
	},
/turf/simulated/floor/frozen_world,
/area/frozen_planet/ruins)
"W" = (
/obj/structure/flora/tree/pine/xmas,
/turf/simulated/floor/outdoors/snow/frozen_world,
/area/frozen_planet/ruins)

(1,1,1) = {"
a
m
a
a
a
a
a
a
a
a
a
a
"}
(2,1,1) = {"
a
a
a
a
a
a
a
E
a
a
m
a
"}
(3,1,1) = {"
a
a
a
m
x
E
v
a
a
a
a
a
"}
(4,1,1) = {"
m
a
a
a
E
f
a
E
a
a
m
a
"}
(5,1,1) = {"
a
a
m
a
a
v
a
x
a
a
a
a
"}
(6,1,1) = {"
a
a
a
a
E
a
v
a
a
a
a
m
"}
(7,1,1) = {"
a
a
W
a
a
a
E
a
m
a
a
a
"}
(8,1,1) = {"
a
a
a
a
a
G
E
x
a
a
a
a
"}
(9,1,1) = {"
a
a
a
a
E
r
a
K
a
a
a
a
"}
(10,1,1) = {"
m
a
a
a
x
E
a
a
a
a
m
a
"}
(11,1,1) = {"
a
a
m
a
E
a
E
E
m
a
a
a
"}
(12,1,1) = {"
a
a
a
a
a
a
a
a
a
a
a
a
"}
