//MAP CONVERTED BY dmm2tgm.py THIS HEADER COMMENT PREVENTS RECONVERSION, DO NOT REMOVE
"a" = (
/turf/simulated/wall/frozen_world,
/area/frozen_planet/ruins)
"f" = (
/turf/simulated/floor/old_tile/green/frozen_world{
	color = "#63A83A";
	icon = 'icons/turf/flooring/tiles_vr.dmi';
	icon_state = "tile_full"
	},
/area/frozen_planet/ruins)
"i" = (
/turf/simulated/floor/outdoors/snow/frozen_world,
/area/frozen_planet/ruins)
"v" = (
/obj/structure/closet/crate/secure/loot,
/turf/simulated/floor/outdoors/snow/frozen_world,
/area/frozen_planet/ruins)
"B" = (
/obj/structure/loot_pile/mecha/gygax,
/turf/simulated/floor/outdoors/snow/frozen_world,
/area/frozen_planet/ruins)
"C" = (
/obj/random/mob/sif/hostile{
	mob_faction = "frozen"
	},
/turf/simulated/floor/outdoors/snow/frozen_world,
/area/frozen_planet/ruins)
"G" = (
/turf/simulated/floor/frozen_world,
/area/frozen_planet/ruins)
"R" = (
/obj/random/mob/sif/hostile{
	mob_faction = "frozen"
	},
/turf/simulated/floor/frozen_world,
/area/frozen_planet/ruins)

(1,1,1) = {"
a
i
i
i
i
a
"}
(2,1,1) = {"
i
v
f
G
i
a
"}
(3,1,1) = {"
i
f
R
f
B
a
"}
(4,1,1) = {"
G
G
i
f
G
i
"}
(5,1,1) = {"
i
C
f
i
G
G
"}
(6,1,1) = {"
i
a
i
i
i
a
"}
