//MAP CONVERTED BY dmm2tgm.py THIS HEADER COMMENT PREVENTS RECONVERSION, DO NOT REMOVE
"at" = (
/obj/machinery/power/terminal,
/obj/structure/cable/yellow,
/turf/simulated/floor/plating,
/area/space)
"bw" = (
/obj/machinery/computer/shuttle_control/explore/gecko_cr,
/turf/simulated/floor/tiled/techfloor,
/area/space)
"cL" = (
/obj/machinery/door/airlock/hatch{
	req_one_access = list()
	},
/turf/simulated/floor/tiled/techmaint,
/area/space)
"dv" = (
/obj/structure/cable{
	icon_state = "1-8"
	},
/turf/simulated/floor/tiled/techmaint,
/area/space)
"dZ" = (
/obj/machinery/atmospherics/component/unary/engine/biggest{
	dir = 1
	},
/turf/simulated/floor/airless,
/area/space)
"eF" = (
/obj/machinery/light,
/obj/effect/floor_decal/industrial/warning/corner,
/turf/simulated/floor/tiled/techfloor,
/area/space)
"eX" = (
/obj/machinery/door/airlock/hatch{
	req_one_access = list()
	},
/obj/machinery/airlock_sensor/airlock_exterior/shuttle{
	dir = 10;
	pixel_x = -8;
	pixel_y = 26
	},
/obj/map_helper/airlock/door/ext_door,
/obj/map_helper/airlock/sensor/ext_sensor,
/turf/simulated/floor/tiled/techmaint,
/area/space)
"fr" = (
/obj/machinery/atmospherics/pipe/simple/hidden,
/turf/simulated/floor/tiled/techmaint,
/area/space)
"fX" = (
/obj/structure/table/rack/shelf/steel,
/turf/simulated/floor/plating,
/area/space)
"id" = (
/obj/machinery/atmospherics/pipe/manifold/hidden/fuel,
/turf/simulated/floor/plating,
/area/space)
"ij" = (
/obj/structure/cable{
	icon_state = "0-8"
	},
/obj/machinery/power/apc/alarms_hidden/south_bump,
/turf/simulated/floor/tiled/techmaint,
/area/space)
"iI" = (
/turf/simulated/floor/tiled/techmaint,
/area/space)
"jS" = (
/turf/simulated/shuttle/wall/dark/hard_corner,
/area/space)
"kZ" = (
/turf/simulated/floor/tiled/techfloor,
/area/space)
"lq" = (
/obj/machinery/mech_recharger,
/turf/simulated/floor/reinforced,
/area/space)
"ls" = (
/obj/effect/floor_decal/industrial/warning,
/turf/simulated/floor/tiled/techmaint,
/area/space)
"lt" = (
/obj/machinery/light{
	dir = 8
	},
/turf/simulated/floor/plating,
/area/space)
"mq" = (
/obj/machinery/atmospherics/portables_connector/fuel,
/obj/machinery/portable_atmospherics/canister/phoron{
	start_pressure = 8000.25
	},
/turf/simulated/floor/plating,
/area/space)
"ni" = (
/obj/machinery/atmospherics/component/unary/vent_pump{
	dir = 8
	},
/obj/map_helper/airlock/atmos/chamber_pump,
/turf/simulated/floor/plating,
/area/space)
"nw" = (
/obj/structure/cable{
	icon_state = "2-4"
	},
/turf/simulated/floor/tiled/techmaint,
/area/space)
"qk" = (
/obj/structure/cable{
	icon_state = "4-8"
	},
/turf/simulated/floor/tiled/techmaint,
/area/space)
"qH" = (
/obj/machinery/light{
	dir = 4
	},
/turf/simulated/floor/plating,
/area/space)
"qP" = (
/obj/effect/decal/mecha_wreckage/gunpod,
/turf/simulated/floor/reinforced,
/area/space)
"rC" = (
/obj/structure/cable{
	icon_state = "1-2"
	},
/turf/simulated/floor/tiled/techmaint,
/area/space)
"sq" = (
/obj/machinery/door/airlock/hatch{
	req_one_access = list()
	},
/obj/structure/cable{
	icon_state = "4-8"
	},
/turf/simulated/floor/tiled/techmaint,
/area/space)
"su" = (
/obj/machinery/power/port_gen/pacman/mrs{
	anchored = 1
	},
/obj/structure/cable/yellow{
	icon_state = "0-8"
	},
/turf/simulated/floor/plating,
/area/space)
"sN" = (
/obj/machinery/airlock_sensor{
	pixel_x = 25;
	dir = 8
	},
/obj/map_helper/airlock/sensor/chamber_sensor,
/turf/simulated/floor/tiled/techmaint,
/area/space)
"sQ" = (
/obj/machinery/button/remote/blast_door{
	dir = 4;
	id = "paperclipper_hanger_hatch";
	name = "Starbard Hanger Hatch";
	pixel_x = -24
	},
/turf/simulated/floor/reinforced,
/area/space)
"tn" = (
/obj/mecha/combat/fighter/gunpod/recon{
	dir = 4
	},
/obj/machinery/mech_recharger,
/turf/simulated/floor/reinforced,
/area/space)
"uX" = (
/obj/machinery/shipsensors,
/turf/simulated/floor/reinforced/airless,
/area/space)
"we" = (
/turf/space/basic,
/area/space)
"wp" = (
/obj/structure/cable{
	icon_state = "2-8"
	},
/obj/structure/cable{
	icon_state = "4-8"
	},
/turf/simulated/floor/tiled/techmaint,
/area/space)
"wK" = (
/obj/machinery/atmospherics/component/unary/vent_pump,
/obj/map_helper/airlock/atmos/chamber_pump,
/turf/simulated/floor/plating,
/area/space)
"yd" = (
/obj/structure/cable{
	icon_state = "4-8"
	},
/turf/simulated/floor/plating,
/area/space)
"yF" = (
/turf/simulated/floor/reinforced/airless,
/area/space)
"yX" = (
/obj/random/crate{
	dir = 1
	},
/turf/simulated/floor/plating,
/area/space)
"Al" = (
/turf/simulated/shuttle/wall/dark,
/area/space)
"Aq" = (
/obj/structure/cable/yellow{
	icon_state = "2-4"
	},
/turf/simulated/floor/plating,
/area/space)
"Bl" = (
/obj/machinery/atmospherics/pipe/manifold4w/hidden/fuel,
/turf/simulated/floor/plating,
/area/space)
"BP" = (
/obj/machinery/power/apc/alarms_hidden/east_bump,
/obj/structure/cable{
	icon_state = "1-2"
	},
/obj/structure/cable{
	icon_state = "0-2"
	},
/turf/simulated/floor/plating,
/area/space)
"DJ" = (
/turf/simulated/floor/plating,
/area/space)
"Id" = (
/turf/simulated/floor/reinforced,
/area/space)
"Kr" = (
/turf/simulated/floor/airless,
/area/space)
"KI" = (
/obj/machinery/atmospherics/pipe/simple/hidden/fuel{
	dir = 9
	},
/turf/simulated/floor/plating,
/area/space)
"Lq" = (
/obj/structure/table/steel,
/obj/item/tool/wrench,
/obj/item/stack/material/tritium{
	amount = 25
	},
/turf/simulated/floor/plating,
/area/space)
"Lt" = (
/obj/spawner/window/borosillicate/reinforced/full/firelocks,
/turf/simulated/floor/plating,
/area/space)
"Lv" = (
/obj/structure/bed/chair/bay/comfy{
	dir = 1
	},
/turf/simulated/floor/tiled/techmaint,
/area/space)
"Ly" = (
/obj/machinery/atmospherics/pipe/manifold/hidden{
	dir = 8
	},
/turf/simulated/floor/plating,
/area/space)
"Ms" = (
/obj/structure/cable,
/obj/machinery/power/apc/alarms_hidden/west_bump,
/turf/simulated/floor/plating,
/area/space)
"Ne" = (
/obj/machinery/atmospherics/pipe/simple/hidden/fuel{
	dir = 4
	},
/turf/simulated/floor/plating,
/area/space)
"OS" = (
/obj/machinery/door/blast/regular{
	id = "paperclipper_hanger_hatch";
	name = "Starbard Hanger Hatch";
	dir = 4
	},
/obj/machinery/atmospheric_field_generator/perma,
/turf/simulated/floor/plating,
/area/space)
"OZ" = (
/obj/structure/cable/yellow{
	icon_state = "1-2"
	},
/turf/simulated/floor/tiled/techmaint,
/area/space)
"Ql" = (
/obj/machinery/atmospherics/pipe/manifold/hidden/fuel{
	dir = 8
	},
/turf/simulated/floor/plating,
/area/space)
"Rn" = (
/obj/structure/fuel_port/heavy{
	pixel_x = 28
	},
/obj/structure/cable{
	icon_state = "1-8"
	},
/turf/simulated/floor/plating,
/area/space)
"SW" = (
/obj/structure/cable/yellow{
	icon_state = "1-2"
	},
/turf/simulated/floor/plating,
/area/space)
"Ub" = (
/obj/machinery/atmospherics/pipe/simple/hidden,
/obj/structure/railing{
	dir = 1
	},
/turf/simulated/floor/plating,
/area/space)
"Uh" = (
/obj/structure/cable/yellow{
	icon_state = "4-8"
	},
/turf/simulated/floor/plating,
/area/space)
"Uq" = (
/obj/machinery/computer/ship/sensors,
/turf/simulated/floor/tiled/techfloor,
/area/space)
"VA" = (
/obj/machinery/power/smes/buildable,
/obj/structure/cable{
	icon_state = "0-4"
	},
/turf/simulated/floor/plating,
/area/space)
"Wx" = (
/obj/machinery/light,
/obj/effect/floor_decal/industrial/warning/corner{
	dir = 8
	},
/turf/simulated/floor/tiled/techfloor,
/area/space)
"Xg" = (
/obj/machinery/door/airlock/hatch{
	req_one_access = list()
	},
/obj/map_helper/airlock/door/int_door,
/obj/machinery/airlock_sensor{
	pixel_x = 25;
	dir = 8
	},
/obj/map_helper/airlock/sensor/int_sensor,
/turf/simulated/floor/tiled/techmaint,
/area/space)
"XI" = (
/obj/machinery/portable_atmospherics/canister/air,
/obj/machinery/atmospherics/portables_connector{
	dir = 1
	},
/turf/simulated/floor/plating,
/area/space)
"XU" = (
/obj/machinery/computer/ship/helm{
	req_one_access = list()
	},
/turf/simulated/floor/tiled/techfloor,
/area/space)
"Yp" = (
/obj/structure/cable{
	icon_state = "4-8"
	},
/obj/structure/cable{
	icon_state = "0-8"
	},
/obj/machinery/power/apc/alarms_hidden/north_bump,
/turf/simulated/floor/tiled/techmaint,
/area/space)
"YI" = (
/obj/machinery/atmospherics/pipe/simple/hidden/fuel,
/obj/spawner/window/borosillicate/reinforced/full/firelocks,
/turf/simulated/floor/plating,
/area/space)
"YJ" = (
/obj/machinery/door/airlock/hatch{
	req_one_access = list()
	},
/obj/structure/cable{
	icon_state = "1-2"
	},
/turf/simulated/floor/tiled/techmaint,
/area/space)
"Zh" = (
/obj/machinery/holopad/ship/starts_inactive,
/turf/simulated/floor/tiled/techmaint,
/area/space)

(1,1,1) = {"
we
we
we
we
we
we
we
we
we
we
we
we
we
we
we
we
we
we
we
we
we
we
we
we
we
we
we
we
we
we
we
we
we
we
we
we
we
we
we
we
we
we
we
we
we
we
we
we
we
we
we
we
we
we
we
we
we
we
we
we
we
"}
(2,1,1) = {"
we
we
we
we
we
we
we
we
we
we
we
we
we
we
we
we
we
we
we
we
we
we
Al
Al
Al
jS
Al
Al
Al
Al
Al
Al
Al
Al
Al
Al
jS
Al
Al
we
we
we
we
we
we
we
we
we
we
we
we
we
we
we
we
we
we
we
we
we
we
"}
(3,1,1) = {"
we
we
we
we
we
we
we
we
we
we
we
we
we
we
we
we
we
we
we
Al
Al
Al
Al
DJ
DJ
Al
DJ
DJ
DJ
DJ
DJ
DJ
DJ
jS
mq
Ql
YI
Kr
Kr
dZ
we
we
we
we
we
we
we
we
we
we
we
we
we
we
we
we
we
we
we
we
we
"}
(4,1,1) = {"
we
we
we
we
we
we
we
we
we
we
we
we
we
we
we
we
Al
Al
Al
Al
DJ
DJ
DJ
DJ
DJ
jS
DJ
DJ
DJ
DJ
DJ
DJ
DJ
jS
mq
id
jS
Kr
Kr
Kr
we
we
we
we
we
we
we
we
we
we
we
we
we
we
we
we
we
we
we
we
we
"}
(5,1,1) = {"
we
we
we
we
we
we
we
we
we
we
we
we
we
Al
Al
Al
jS
DJ
DJ
DJ
DJ
DJ
iI
iI
iI
cL
iI
iI
iI
iI
iI
iI
iI
cL
DJ
Ne
Lt
Kr
Kr
Kr
we
we
we
we
we
we
we
we
we
we
we
we
we
we
we
we
we
we
we
we
we
"}
(6,1,1) = {"
we
we
we
we
we
we
we
we
we
we
Al
Al
Al
Al
DJ
DJ
jS
DJ
DJ
DJ
DJ
DJ
iI
DJ
DJ
jS
DJ
DJ
Aq
SW
OZ
at
VA
jS
mq
Bl
YI
Kr
Kr
dZ
we
we
we
we
we
we
we
we
we
we
we
we
we
we
we
we
we
we
we
we
we
"}
(7,1,1) = {"
we
we
we
we
we
we
we
Al
Al
Al
Al
DJ
DJ
DJ
DJ
DJ
cL
iI
iI
iI
iI
iI
iI
DJ
DJ
Al
DJ
DJ
Uh
DJ
iI
DJ
yd
jS
mq
id
jS
Kr
Kr
Kr
we
we
we
we
we
we
we
we
we
we
we
we
we
we
we
we
we
we
we
we
we
"}
(8,1,1) = {"
we
we
we
we
Al
Al
Al
Al
DJ
DJ
DJ
DJ
DJ
DJ
DJ
DJ
jS
DJ
DJ
DJ
DJ
DJ
DJ
DJ
DJ
Al
Lq
qH
su
qH
nw
BP
Rn
jS
mq
KI
Lt
Kr
Kr
Kr
we
we
we
we
we
we
we
we
we
we
we
we
we
we
we
we
we
we
we
we
we
"}
(9,1,1) = {"
we
Al
Al
Al
Al
Al
Al
Al
Al
Al
Al
Al
Al
Al
Al
Al
jS
Al
Al
Al
Al
Al
Al
Al
Al
jS
Al
Al
Al
jS
sq
jS
Al
Al
Al
Al
jS
Al
Al
we
we
we
we
we
we
we
we
we
we
we
we
we
we
we
we
we
we
we
we
we
we
"}
(10,1,1) = {"
we
we
we
we
we
we
we
we
we
we
we
we
we
we
we
we
we
we
we
we
we
we
we
we
we
we
yF
Lt
kZ
kZ
qk
kZ
Al
Al
Al
we
we
we
we
we
we
we
we
we
we
we
we
we
we
we
we
we
we
we
we
we
we
we
we
we
we
"}
(11,1,1) = {"
we
we
we
we
we
we
we
we
we
we
we
we
we
we
we
we
we
we
we
we
we
we
we
we
we
we
yF
Lt
kZ
kZ
qk
kZ
Al
Al
we
we
we
we
we
we
we
we
we
we
we
we
we
we
we
we
we
we
we
we
we
we
we
we
we
we
we
"}
(12,1,1) = {"
we
we
we
we
we
we
we
we
we
we
we
we
we
we
we
we
we
we
we
we
we
we
we
we
we
we
Al
jS
kZ
kZ
qk
kZ
Al
we
we
we
we
we
we
we
we
we
we
we
we
we
we
we
we
we
we
we
we
we
we
we
we
we
we
we
we
"}
(13,1,1) = {"
we
we
we
we
we
we
we
we
we
we
we
we
we
we
we
we
we
we
we
we
we
we
we
we
we
Al
Al
Al
Al
jS
Yp
kZ
Al
we
we
we
we
we
we
we
we
we
we
we
we
we
we
we
we
we
we
we
we
we
we
we
we
we
we
we
we
"}
(14,1,1) = {"
we
we
we
we
we
we
we
we
we
we
we
we
we
we
we
we
we
we
we
we
we
we
we
we
we
Lt
XU
Zh
eF
Al
qk
kZ
Al
we
we
we
we
we
we
we
we
we
we
we
we
we
we
we
we
we
we
we
we
we
we
we
we
we
we
we
we
"}
(15,1,1) = {"
we
we
we
we
we
we
we
we
we
we
we
we
we
we
we
we
we
we
we
we
we
we
we
we
we
Lt
bw
Lv
ls
cL
qk
kZ
Al
we
we
we
we
we
we
we
we
we
we
we
we
we
we
we
we
we
we
we
we
we
we
we
we
we
we
we
we
"}
(16,1,1) = {"
we
we
we
we
we
we
we
we
we
we
we
we
we
we
we
we
we
we
we
we
we
we
we
we
we
Lt
Uq
iI
Wx
Al
qk
kZ
Al
we
we
we
we
we
we
we
we
we
we
we
we
we
we
we
we
we
we
we
we
we
we
we
we
we
we
we
we
"}
(17,1,1) = {"
we
we
we
we
we
we
we
we
we
we
we
we
we
we
we
we
we
we
we
we
we
we
we
we
we
Al
Al
Al
Al
jS
qk
kZ
Al
we
we
we
we
we
we
we
we
we
we
we
we
we
we
we
we
we
we
we
we
we
we
we
we
we
we
we
we
"}
(18,1,1) = {"
we
we
we
we
we
we
we
we
we
we
we
we
we
we
we
we
we
we
we
we
we
we
we
we
we
we
Al
jS
kZ
kZ
qk
kZ
Al
we
we
we
we
we
we
we
we
we
we
we
we
we
we
we
we
we
we
we
we
we
we
we
we
we
we
we
we
"}
(19,1,1) = {"
we
we
we
we
we
we
we
we
we
we
we
we
we
we
we
we
we
we
we
we
we
we
we
we
we
we
yF
Lt
kZ
kZ
qk
kZ
Al
Al
we
we
we
we
we
we
we
we
we
we
we
we
we
we
we
we
we
we
we
we
we
we
we
we
we
we
we
"}
(20,1,1) = {"
we
we
we
we
we
we
we
we
we
we
we
we
we
we
we
we
we
we
we
we
we
we
we
we
we
we
uX
Lt
kZ
kZ
qk
kZ
Al
Al
Al
we
we
we
we
we
we
we
we
we
we
we
we
we
we
we
we
we
we
we
we
we
we
we
we
we
we
"}
(21,1,1) = {"
we
we
we
we
we
we
we
we
we
we
we
we
we
we
we
we
we
we
we
we
we
we
Al
Al
Al
Al
jS
Al
Al
jS
sq
jS
Al
Al
Al
Al
Al
Al
Al
jS
Al
Al
Al
Al
Al
Al
Al
Al
jS
eX
jS
Al
Al
Al
Al
Al
Al
Al
Al
Al
we
"}
(22,1,1) = {"
we
we
we
we
we
we
we
we
we
we
we
we
we
we
we
we
we
we
we
we
we
Al
Al
lq
tn
Id
iI
Al
DJ
lt
wp
Ms
DJ
DJ
DJ
DJ
DJ
DJ
DJ
Al
yX
yX
yX
yX
fX
fX
fX
Lt
wK
fr
Ly
Ub
XI
Al
Al
Al
Al
we
we
we
we
"}
(23,1,1) = {"
we
we
we
we
we
we
we
we
we
we
we
we
we
we
we
we
we
we
we
we
we
OS
sQ
Id
Id
Id
iI
jS
DJ
DJ
qk
DJ
DJ
DJ
DJ
DJ
DJ
DJ
DJ
jS
DJ
DJ
DJ
DJ
DJ
DJ
iI
Xg
iI
sN
ni
Al
Al
Al
we
we
we
we
we
we
we
"}
(24,1,1) = {"
we
we
we
we
we
we
we
we
we
we
we
we
we
we
we
we
we
we
we
we
we
OS
Id
Id
Id
Id
nw
YJ
rC
rC
dv
iI
iI
iI
iI
iI
iI
iI
iI
cL
iI
iI
iI
iI
iI
iI
iI
jS
Al
Al
Al
Al
we
we
we
we
we
we
we
we
we
"}
(25,1,1) = {"
we
we
we
we
we
we
we
we
we
we
we
we
we
we
we
we
we
we
we
we
we
OS
Id
Id
Id
Id
ij
jS
DJ
DJ
DJ
DJ
DJ
DJ
DJ
DJ
DJ
DJ
DJ
jS
DJ
DJ
DJ
DJ
DJ
Al
Al
Al
Al
we
we
we
we
we
we
we
we
we
we
we
we
"}
(26,1,1) = {"
we
we
we
we
we
we
we
we
we
we
we
we
we
we
we
we
we
we
we
we
we
OS
Id
Id
qP
Id
iI
Al
DJ
DJ
DJ
DJ
DJ
DJ
DJ
DJ
DJ
DJ
DJ
Al
DJ
DJ
Al
Al
Al
Al
we
we
we
we
we
we
we
we
we
we
we
we
we
we
we
"}
(27,1,1) = {"
we
we
we
we
we
we
we
we
we
we
we
we
we
we
we
we
we
we
we
we
we
Al
Al
lq
lq
Id
iI
Al
DJ
DJ
DJ
DJ
DJ
DJ
DJ
DJ
DJ
DJ
DJ
jS
Al
Al
Al
we
we
we
we
we
we
we
we
we
we
we
we
we
we
we
we
we
we
"}
(28,1,1) = {"
we
we
we
we
we
we
we
we
we
we
we
we
we
we
we
we
we
we
we
we
we
we
Al
Al
Al
Al
jS
Al
Al
Al
Al
Al
Al
Al
Al
Al
Al
Al
Al
Al
we
we
we
we
we
we
we
we
we
we
we
we
we
we
we
we
we
we
we
we
we
"}
(29,1,1) = {"
we
we
we
we
we
we
we
we
we
we
we
we
we
we
we
we
we
we
we
we
we
we
we
we
we
we
we
we
we
we
we
we
we
we
we
we
we
we
we
we
we
we
we
we
we
we
we
we
we
we
we
we
we
we
we
we
we
we
we
we
we
"}
