//MAP CONVERTED BY dmm2tgm.py THIS HEADER COMMENT PREVENTS RECONVERSION, DO NOT REMOVE
"au" = (
/obj/structure/bed/chair/wood{
	dir = 8
	},
/obj/machinery/button/windowtint{
	id = "cruise_tint";
	pixel_x = -24;
	pixel_y = 28;
	req_access = null
	},
/obj/machinery/light_switch{
	pixel_y = 28
	},
/turf/simulated/floor/wood,
/area/shuttle/cruise_ship/bedroom)
"aN" = (
/obj/structure/bed/chair/sofa/black/right{
	dir = 8
	},
/turf/simulated/floor/gold,
/area/shuttle/cruise_ship)
"bl" = (
/obj/structure/cable/cyan{
	icon_state = "1-8"
	},
/turf/simulated/floor,
/area/shuttle/cruise_ship)
"dE" = (
/obj/structure/table/hardwoodtable,
/obj/item/storage/box/glasses,
/turf/simulated/floor/wood,
/area/shuttle/cruise_ship/bedroom)
"dF" = (
/obj/machinery/computer/shuttle_control/explore/cruise_ship{
	dir = 4
	},
/turf/simulated/floor/wood,
/area/shuttle/cruise_ship)
"eH" = (
/obj/machinery/door/firedoor/glass,
/obj/structure/curtain/black,
/turf/simulated/floor/wood,
/area/shuttle/cruise_ship)
"fa" = (
/obj/machinery/vending/sovietsoda,
/turf/simulated/floor/wood,
/area/shuttle/cruise_ship)
"fu" = (
/obj/structure/cable/cyan{
	icon_state = "4-8"
	},
/turf/simulated/floor/wood,
/area/shuttle/cruise_ship/bedroom)
"hF" = (
/turf/simulated/floor/gold,
/area/shuttle/cruise_ship)
"ig" = (
/obj/machinery/door/firedoor/glass,
/obj/machinery/door/airlock/gold{
	name = "Cockpit"
	},
/turf/simulated/floor/wood,
/area/shuttle/cruise_ship)
"iB" = (
/obj/machinery/airlock_sensor{
	frequency = 1380;
	pixel_y = 25
	},
/obj/map_helper/airlock/sensor/chamber_sensor,
/turf/simulated/floor/wood,
/area/shuttle/cruise_ship)
"ji" = (
/obj/structure/table/alien,
/obj/structure/dancepole{
	pixel_y = 15
	},
/turf/simulated/floor/gold,
/area/shuttle/cruise_ship)
"kv" = (
/obj/machinery/alarm/alarms_hidden{
	dir = 4;
	pixel_x = -27
	},
/turf/simulated/floor/wood,
/area/shuttle/cruise_ship)
"mC" = (
/obj/machinery/atmospherics/pipe/tank/phoron{
	dir = 4
	},
/obj/effect/floor_decal/industrial/outline/red,
/turf/simulated/floor,
/area/shuttle/cruise_ship)
"nd" = (
/obj/structure/bed/chair/sofa/black{
	dir = 8
	},
/obj/machinery/light{
	dir = 4
	},
/turf/simulated/floor/gold,
/area/shuttle/cruise_ship)
"nJ" = (
/obj/machinery/shower{
	dir = 8
	},
/obj/effect/floor_decal/steeldecal/steel_decals10{
	dir = 1
	},
/obj/effect/floor_decal/steeldecal/steel_decals10{
	dir = 8
	},
/obj/machinery/light/small{
	dir = 1;
	pixel_x = -2
	},
/turf/simulated/floor/tiled/white,
/area/shuttle/cruise_ship/bedroom)
"oa" = (
/obj/machinery/atmospherics/pipe/simple/hidden{
	dir = 6
	},
/turf/simulated/shuttle/wall/voidcraft/green,
/area/shuttle/cruise_ship)
"oI" = (
/obj/map_helper/airlock/door/int_door,
/obj/machinery/access_button/airlock_interior{
	dir = 8;
	frequency = 1380;
	master_tag = "aerondight_docker";
	pixel_x = -8;
	pixel_y = -26
	},
/obj/machinery/atmospherics/pipe/simple/hidden{
	dir = 4
	},
/obj/machinery/atmospherics/pipe/simple/hidden,
/obj/machinery/door/airlock/glass_external,
/turf/simulated/floor/wood,
/area/shuttle/cruise_ship)
"oX" = (
/obj/structure/table/hardwoodtable,
/turf/simulated/floor/wood,
/area/shuttle/cruise_ship/bedroom)
"pF" = (
/obj/machinery/computer/ship/engines{
	dir = 4
	},
/turf/simulated/floor,
/area/shuttle/cruise_ship)
"qk" = (
/obj/machinery/computer/ship/helm{
	dir = 4
	},
/turf/simulated/floor/wood,
/area/shuttle/cruise_ship)
"qq" = (
/obj/structure/bed/chair/sofa/black{
	dir = 1
	},
/turf/simulated/floor/gold,
/area/shuttle/cruise_ship)
"qu" = (
/obj/structure/flora/pottedplant/crystal,
/turf/simulated/floor/wood,
/area/shuttle/cruise_ship)
"qY" = (
/obj/machinery/door/firedoor/glass,
/obj/structure/grille,
/obj/structure/window/reinforced/full,
/turf/simulated/floor,
/area/shuttle/cruise_ship)
"rw" = (
/obj/machinery/atmospherics/pipe/tank/air{
	dir = 8
	},
/turf/simulated/floor,
/area/shuttle/cruise_ship)
"rZ" = (
/obj/machinery/door/firedoor/glass,
/obj/structure/grille,
/obj/structure/window/reinforced/polarized/full{
	id = "cruise_dance_tint"
	},
/turf/simulated/floor,
/area/shuttle/cruise_ship)
"tv" = (
/obj/machinery/atmospherics/pipe/manifold/hidden{
	dir = 4
	},
/turf/simulated/floor/wood,
/area/shuttle/cruise_ship)
"uo" = (
/turf/simulated/shuttle/wall/voidcraft/hard_corner,
/area/shuttle/cruise_ship/bedroom)
"ux" = (
/obj/machinery/atmospherics/pipe/simple/hidden{
	dir = 5
	},
/turf/simulated/shuttle/wall/voidcraft/hard_corner,
/area/shuttle/cruise_ship)
"vm" = (
/obj/machinery/atmospherics/pipe/simple/hidden{
	dir = 4
	},
/turf/simulated/floor/wood,
/area/shuttle/cruise_ship)
"vt" = (
/obj/structure/closet/secure_closet/personal/cabinet,
/turf/simulated/floor/carpet/purcarpet,
/area/shuttle/cruise_ship/bedroom)
"vx" = (
/obj/machinery/atmospherics/pipe/simple/hidden{
	dir = 6
	},
/obj/machinery/holopad/ship/starts_inactive,
/turf/simulated/floor/wood,
/area/shuttle/cruise_ship)
"wg" = (
/obj/structure/panic_button{
	pixel_x = -32
	},
/turf/simulated/floor/wood,
/area/shuttle/cruise_ship)
"wq" = (
/turf/simulated/shuttle/wall/voidcraft/green,
/area/shuttle/cruise_ship)
"xa" = (
/turf/space/basic,
/area/space)
"yT" = (
/obj/machinery/atmospherics/portables_connector{
	dir = 4
	},
/obj/machinery/portable_atmospherics/canister/phoron,
/obj/effect/floor_decal/industrial/outline/red,
/turf/simulated/floor,
/area/shuttle/cruise_ship)
"zA" = (
/obj/structure/flora/pottedplant/orientaltree,
/turf/simulated/floor/wood,
/area/shuttle/cruise_ship/bedroom)
"CT" = (
/obj/machinery/light,
/turf/simulated/floor/wood,
/area/shuttle/cruise_ship/bedroom)
"De" = (
/obj/effect/overmap/visitable/ship/landable/cruise_ship,
/obj/effect/shuttle_landmark/shuttle_initializer/cruise_ship,
/obj/machinery/embedded_controller/radio/airlock/docking_port{
	frequency = 1380;
	id_tag = "aerondight_docker";
	pixel_x = 28;
	pixel_y = -32;
	req_one_access = null
	},
/turf/simulated/floor/wood,
/area/shuttle/cruise_ship)
"EY" = (
/obj/structure/fuel_port{
	dir = 4;
	pixel_y = 32
	},
/obj/machinery/atmospherics/pipe/simple/hidden{
	dir = 4
	},
/obj/structure/cable/cyan{
	icon_state = "4-8"
	},
/turf/simulated/floor,
/area/shuttle/cruise_ship)
"FL" = (
/obj/machinery/button/windowtint{
	id = "cruise_dance_tint";
	pixel_x = -24
	},
/turf/simulated/floor/gold,
/area/shuttle/cruise_ship)
"FV" = (
/obj/machinery/atmospherics/pipe/simple/hidden,
/turf/simulated/shuttle/wall/voidcraft/hard_corner,
/area/shuttle/cruise_ship)
"Ga" = (
/turf/simulated/shuttle/wall/voidcraft/green,
/area/shuttle/cruise_ship/bedroom)
"Hv" = (
/obj/machinery/atmospherics/pipe/simple/hidden{
	dir = 10
	},
/turf/simulated/shuttle/wall/voidcraft/green,
/area/shuttle/cruise_ship)
"HM" = (
/obj/machinery/light,
/obj/machinery/atmospherics/pipe/simple/hidden{
	dir = 4
	},
/turf/simulated/floor/wood,
/area/shuttle/cruise_ship)
"HN" = (
/obj/structure/bed/chair/sofa/black/corner{
	dir = 8
	},
/turf/simulated/floor/gold,
/area/shuttle/cruise_ship)
"Iv" = (
/obj/structure/shuttle/engine/heater{
	dir = 4
	},
/obj/machinery/atmospherics/pipe/manifold/hidden,
/turf/simulated/shuttle/wall/voidcraft/green,
/area/shuttle/cruise_ship)
"IS" = (
/obj/structure/bed/double/padded,
/obj/item/bedsheet/rddouble,
/turf/simulated/floor/carpet/purcarpet,
/area/shuttle/cruise_ship/bedroom)
"Kt" = (
/obj/structure/shuttle/engine/heater{
	dir = 4
	},
/obj/machinery/atmospherics/pipe/simple/hidden{
	dir = 6
	},
/turf/simulated/shuttle/wall/voidcraft/green,
/area/shuttle/cruise_ship)
"KJ" = (
/obj/structure/shuttle/engine/heater{
	dir = 4
	},
/obj/machinery/atmospherics/pipe/manifold4w/hidden,
/turf/simulated/shuttle/wall/voidcraft/green,
/area/shuttle/cruise_ship)
"Lx" = (
/obj/structure/cable/cyan{
	icon_state = "0-4"
	},
/obj/machinery/power/rtg,
/turf/simulated/floor,
/area/shuttle/cruise_ship)
"Mi" = (
/obj/machinery/vending/snack{
	dir = 4
	},
/turf/simulated/floor/wood,
/area/shuttle/cruise_ship)
"Mt" = (
/obj/machinery/door/firedoor/glass,
/obj/structure/grille,
/obj/structure/window/reinforced/full,
/obj/machinery/door/blast/regular{
	density = 0;
	dir = 2;
	icon_state = "pdoor0";
	id = "cruise_blast";
	name = "Shuttle Blast Doors";
	opacity = 0
	},
/turf/simulated/floor,
/area/shuttle/cruise_ship)
"Mu" = (
/obj/map_helper/airlock/door/ext_door,
/obj/machinery/access_button/airlock_exterior{
	dir = 4;
	frequency = 1380;
	master_tag = "specops_docker";
	pixel_x = 8;
	pixel_y = 26
	},
/obj/machinery/access_button/airlock_exterior{
	dir = 4;
	frequency = 1380;
	master_tag = "aerondight_docker";
	pixel_x = 8;
	pixel_y = 26
	},
/obj/machinery/door/airlock/glass_external,
/turf/simulated/floor/wood,
/area/shuttle/cruise_ship)
"Nk" = (
/obj/effect/floor_decal/industrial/warning{
	dir = 4
	},
/turf/simulated/floor,
/area/shuttle/cruise_ship)
"NJ" = (
/obj/machinery/door/firedoor/glass,
/obj/structure/grille,
/obj/structure/window/reinforced/polarized/full{
	id = "cruise_dance_tint"
	},
/obj/machinery/door/blast/regular{
	density = 0;
	dir = 2;
	icon_state = "pdoor0";
	id = "cruise_blast";
	name = "Shuttle Blast Doors";
	opacity = 0
	},
/turf/simulated/floor,
/area/shuttle/cruise_ship)
"NU" = (
/obj/structure/bed/chair/shuttle{
	dir = 8
	},
/obj/machinery/button/remote/blast_door{
	dir = 1;
	id = "cruise_blast";
	name = "Shuttle Rear Hatch";
	pixel_y = -26
	},
/turf/simulated/floor/wood,
/area/shuttle/cruise_ship)
"Oj" = (
/obj/machinery/door/firedoor/glass,
/obj/structure/cable/green{
	icon_state = "4-8"
	},
/obj/machinery/atmospherics/pipe/simple/hidden{
	dir = 4
	},
/obj/machinery/door/airlock/gold{
	name = "Engine"
	},
/obj/structure/cable/cyan{
	icon_state = "4-8"
	},
/turf/simulated/floor/wood,
/area/shuttle/cruise_ship)
"Ov" = (
/obj/machinery/door/firedoor/glass,
/obj/structure/grille,
/obj/structure/window/reinforced/polarized/full{
	id = "cruise_tint"
	},
/obj/machinery/door/blast/regular{
	density = 0;
	dir = 2;
	icon_state = "pdoor0";
	id = "cruise_blast";
	name = "Shuttle Blast Doors";
	opacity = 0
	},
/turf/simulated/floor,
/area/shuttle/cruise_ship/bedroom)
"Pz" = (
/obj/machinery/light{
	dir = 8
	},
/turf/simulated/floor/wood,
/area/shuttle/cruise_ship)
"Qv" = (
/obj/machinery/atmospherics/pipe/simple/hidden{
	dir = 5
	},
/obj/structure/cable/cyan{
	icon_state = "4-8"
	},
/turf/simulated/floor/wood,
/area/shuttle/cruise_ship)
"QK" = (
/obj/structure/table/hardwoodtable,
/obj/machinery/chemical_dispenser/catering/bar_coffee{
	dir = 4
	},
/turf/simulated/floor/wood,
/area/shuttle/cruise_ship/bedroom)
"QL" = (
/turf/simulated/floor/wood,
/area/shuttle/cruise_ship/bedroom)
"QZ" = (
/obj/structure/cable/cyan{
	icon_state = "4-8"
	},
/obj/structure/cable/cyan{
	icon_state = "1-4"
	},
/turf/simulated/floor/wood,
/area/shuttle/cruise_ship)
"RA" = (
/obj/machinery/light/small{
	dir = 1
	},
/obj/machinery/atmospherics/pipe/simple/hidden{
	dir = 4
	},
/obj/structure/cable/cyan{
	icon_state = "2-8"
	},
/turf/simulated/floor,
/area/shuttle/cruise_ship)
"RF" = (
/turf/simulated/shuttle/wall/voidcraft/hard_corner,
/area/shuttle/cruise_ship)
"RL" = (
/obj/machinery/atmospherics/pipe/simple/hidden,
/turf/simulated/shuttle/wall/voidcraft/green,
/area/shuttle/cruise_ship)
"RN" = (
/obj/structure/bed/chair/sofa/black/left{
	dir = 1
	},
/turf/simulated/floor/gold,
/area/shuttle/cruise_ship)
"RV" = (
/turf/simulated/floor/carpet/purcarpet,
/area/shuttle/cruise_ship/bedroom)
"Sl" = (
/obj/machinery/light{
	dir = 4
	},
/turf/simulated/floor/carpet/purcarpet,
/area/shuttle/cruise_ship/bedroom)
"Sx" = (
/obj/machinery/power/apc/alarms_hidden/west_bump,
/obj/structure/cable/cyan{
	icon_state = "0-2"
	},
/turf/simulated/floor/wood,
/area/shuttle/cruise_ship)
"Ub" = (
/obj/machinery/atmospherics/component/unary/engine{
	dir = 8
	},
/turf/simulated/shuttle/plating/airless/carry,
/area/shuttle/cruise_ship)
"Ue" = (
/turf/simulated/floor/wood,
/area/shuttle/cruise_ship)
"UR" = (
/obj/machinery/atmospherics/pipe/simple/hidden,
/turf/simulated/floor/wood,
/area/shuttle/cruise_ship)
"Wd" = (
/obj/structure/cable/cyan{
	icon_state = "1-2"
	},
/turf/simulated/floor,
/area/shuttle/cruise_ship)
"Wj" = (
/obj/machinery/atmospherics/component/unary/vent_pump/high_volume{
	dir = 1;
	frequency = 1380
	},
/obj/map_helper/airlock/atmos/chamber_pump,
/turf/simulated/floor/wood,
/area/shuttle/cruise_ship)
"Xg" = (
/obj/structure/curtain/open/shower/engineering,
/turf/simulated/floor/tiled/white,
/area/shuttle/cruise_ship/bedroom)
"Xo" = (
/obj/machinery/light/small{
	dir = 1;
	pixel_x = -2
	},
/obj/machinery/atmospherics/component/unary/vent_pump/high_volume{
	frequency = 1380
	},
/obj/map_helper/airlock/atmos/chamber_pump,
/turf/simulated/floor/wood,
/area/shuttle/cruise_ship)
"Yh" = (
/obj/machinery/door/firedoor/glass,
/obj/structure/cable/cyan{
	icon_state = "4-8"
	},
/obj/machinery/door/airlock/gold{
	name = "Private Quarters"
	},
/turf/simulated/floor/wood,
/area/shuttle/cruise_ship/bedroom)
"Yx" = (
/obj/structure/flora/pottedplant/flower,
/turf/simulated/floor/wood,
/area/shuttle/cruise_ship)
"YK" = (
/obj/structure/table/hardwoodtable,
/obj/machinery/chemical_dispenser/catering/bar_alc{
	dir = 4
	},
/turf/simulated/floor/wood,
/area/shuttle/cruise_ship/bedroom)
"YT" = (
/obj/machinery/power/apc/alarms_hidden/south_bump,
/obj/structure/cable/cyan{
	icon_state = "0-4"
	},
/turf/simulated/floor/wood,
/area/shuttle/cruise_ship/bedroom)
"Za" = (
/obj/machinery/computer/ship/sensors{
	dir = 8
	},
/obj/machinery/light{
	dir = 4
	},
/turf/simulated/floor/wood,
/area/shuttle/cruise_ship)

(1,1,1) = {"
xa
xa
xa
xa
xa
xa
xa
xa
xa
xa
xa
xa
xa
"}
(2,1,1) = {"
xa
xa
xa
xa
xa
xa
Ga
Ov
Ov
Ov
Ga
xa
xa
"}
(3,1,1) = {"
xa
xa
xa
xa
xa
Ga
uo
QK
YK
dE
uo
Ga
xa
"}
(4,1,1) = {"
xa
xa
RF
Mt
Mt
Ga
oX
QL
QL
QL
zA
Ga
xa
"}
(5,1,1) = {"
xa
xa
Mt
dF
qk
Ga
au
QL
QL
QL
CT
Ga
xa
"}
(6,1,1) = {"
xa
xa
Mt
Ue
NU
Ga
vt
RV
YT
uo
Xg
Ga
xa
"}
(7,1,1) = {"
xa
xa
Mt
Ue
Za
Ga
IS
Sl
fu
Ga
nJ
Ga
xa
"}
(8,1,1) = {"
xa
wq
RF
ig
RF
wq
wq
RF
Yh
RF
wq
RF
xa
"}
(9,1,1) = {"
xa
Mt
qu
Ue
Pz
wg
kv
Sx
QZ
Pz
Yx
Mt
xa
"}
(10,1,1) = {"
xa
Mt
fa
Ue
Ue
Ue
vx
UR
Qv
Ue
Mi
Mt
xa
"}
(11,1,1) = {"
xa
RF
RF
eH
rZ
rZ
vm
RF
Oj
RF
qY
RF
xa
"}
(12,1,1) = {"
xa
NJ
FL
hF
RN
rZ
vm
wq
EY
pF
Lx
wq
xa
"}
(13,1,1) = {"
xa
NJ
hF
ji
qq
rZ
HM
wq
RA
Wd
bl
wq
xa
"}
(14,1,1) = {"
xa
NJ
aN
nd
HN
rZ
vm
wq
rw
Nk
Nk
wq
xa
"}
(15,1,1) = {"
xa
RF
wq
oa
RL
FV
oI
FV
ux
yT
mC
wq
xa
"}
(16,1,1) = {"
xa
wq
Kt
Iv
wq
Xo
tv
Wj
Hv
KJ
Iv
wq
xa
"}
(17,1,1) = {"
xa
wq
Ub
Ub
wq
iB
De
Ue
wq
Ub
Ub
wq
xa
"}
(18,1,1) = {"
xa
xa
xa
xa
wq
RF
Mu
RF
wq
xa
xa
xa
xa
"}
(19,1,1) = {"
xa
xa
xa
xa
xa
xa
xa
xa
xa
xa
xa
xa
xa
"}
