//MAP CONVERTED BY dmm2tgm.py THIS HEADER COMMENT PREVENTS RECONVERSION, DO NOT REMOVE
"a" = (
/turf/space/basic,
/area/space)
"b" = (
/obj/machinery/door/firedoor,
/obj/machinery/door/blast/regular{
	density = 0;
	dir = 4;
	icon_state = "pdoorc0";
	id = "adventurer1";
	name = "Spacenat Caravan Airlock";
	opacity = 0
	},
/obj/machinery/door/airlock/hatch{
	name = "Adventurer Airtight Hatch";
	req_one_access = null
	},
/obj/machinery/atmospheric_field_generator/perma,
/turf/simulated/floor/tiled/techfloor/monogrid,
/area/shuttle/auto/one_single_area)
"c" = (
/obj/machinery/atmospherics/pipe/manifold/hidden{
	dir = 1
	},
/turf/simulated/wall/prepainted,
/area/shuttle/auto/one_single_area)
"d" = (
/obj/structure/cable/green{
	icon_state = "4-8"
	},
/turf/simulated/wall/prepainted,
/area/shuttle/auto/one_single_area)
"e" = (
/turf/simulated/wall/prepainted,
/area/shuttle/auto/one_single_area)
"f" = (
/obj/machinery/atmospherics/pipe/simple/hidden/cyan{
	dir = 4
	},
/obj/machinery/sleeper/survival_pod,
/turf/simulated/floor/tiled/techfloor/monogrid,
/area/shuttle/auto/one_single_area)
"g" = (
/obj/structure/cable/green,
/obj/machinery/light,
/obj/structure/table/steel_reinforced,
/obj/machinery/computer/ship/sensors{
	dir = 4
	},
/obj/machinery/power/apc/alarms_hidden/south_mount{
	req_access = null
	},
/turf/simulated/floor/tiled/techfloor,
/area/shuttle/auto/one_single_area)
"h" = (
/obj/structure/closet/walllocker/emerglocker{
	pixel_y = -32
	},
/obj/machinery/light,
/turf/simulated/floor/tiled/techfloor/monogrid,
/area/shuttle/auto/one_single_area)
"i" = (
/obj/structure/closet/walllocker_double/east,
/obj/machinery/light{
	dir = 4;
	old_wall = 1
	},
/obj/machinery/space_heater,
/turf/simulated/floor/tiled/techfloor/monogrid,
/area/shuttle/auto/one_single_area)
"j" = (
/obj/structure/bed/chair/bay/chair/padded/black{
	dir = 8
	},
/obj/structure/panic_button{
	pixel_y = -28
	},
/obj/landmark/spawnpoint/auto_shuttle_start,
/turf/simulated/floor/tiled/techfloor,
/area/shuttle/auto/one_single_area)
"k" = (
/obj/structure/cable/green{
	icon_state = "2-4"
	},
/obj/structure/bed/chair/bay/chair/padded/black{
	dir = 8
	},
/obj/machinery/atmospherics/component/unary/vent_pump/on{
	dir = 1
	},
/turf/simulated/floor/tiled/techfloor,
/area/shuttle/auto/one_single_area)
"l" = (
/obj/machinery/light{
	dir = 1
	},
/obj/machinery/computer/shuttle_control,
/obj/item/gps/internal/base{
	name = "Adventurer Beacon";
	gps_tag = "ADVENTURER"
	},
/obj/structure/table/steel_reinforced,
/obj/machinery/atmospherics/pipe/simple/hidden/cyan{
	dir = 6
	},
/turf/simulated/floor/tiled/techfloor,
/area/shuttle/auto/one_single_area)
"m" = (
/turf/simulated/floor/tiled/techfloor/monogrid,
/area/shuttle/auto/one_single_area)
"n" = (
/obj/machinery/portable_atmospherics/canister/air/airlock,
/obj/machinery/atmospherics/portables_connector,
/obj/machinery/power/terminal{
	dir = 4
	},
/obj/structure/cable/orange{
	dir = 4
	},
/turf/simulated/floor/plating,
/area/shuttle/auto/one_single_area)
"o" = (
/turf/simulated/wall/prepainted/medical,
/area/shuttle/auto/one_single_area)
"p" = (
/obj/machinery/computer/ship/engines{
	dir = 1
	},
/obj/structure/table/steel_reinforced,
/turf/simulated/floor/tiled/techfloor,
/area/shuttle/auto/one_single_area)
"q" = (
/obj/spawner/window/low_wall/reinforced/firelocks,
/turf/simulated/floor/tiled/techfloor,
/area/shuttle/auto/one_single_area)
"r" = (
/obj/structure/cable/green{
	icon_state = "4-8"
	},
/obj/structure/cable/green{
	icon_state = "4-8"
	},
/obj/machinery/holopad/ship,
/turf/simulated/floor/tiled/techfloor,
/area/shuttle/auto/one_single_area)
"s" = (
/obj/structure/cable/green{
	icon_state = "4-8"
	},
/obj/structure/closet/walllocker_double/west,
/obj/item/reagent_containers/food/drinks/bottle/cola,
/obj/item/reagent_containers/food/drinks/bottle/cola,
/obj/item/storage/box/glasses/meta,
/obj/item/storage/single_use/mre/random,
/obj/item/storage/single_use/mre/random,
/obj/item/storage/single_use/mre/random,
/turf/simulated/floor/tiled/techfloor/monogrid,
/area/shuttle/auto/one_single_area)
"t" = (
/obj/machinery/door/firedoor,
/obj/machinery/button/remote/blast_door{
	id = "adventurer1";
	name = "Adventurer Back Door";
	pixel_x = 30
	},
/obj/machinery/door/blast/regular{
	density = 0;
	dir = 4;
	icon_state = "pdoorc0";
	id = "adventurer1";
	name = "Spacenat Caravan Airlock";
	opacity = 0
	},
/obj/machinery/door/airlock/hatch{
	name = "Adventurer Airtight Hatch";
	req_one_access = null
	},
/obj/machinery/atmospheric_field_generator/perma,
/turf/simulated/floor/tiled/techfloor/monogrid,
/area/shuttle/auto/one_single_area)
"u" = (
/obj/machinery/atmospherics/pipe/simple/hidden/cyan{
	dir = 4
	},
/obj/structure/bed/chair/sofa/black,
/turf/simulated/floor/tiled/techfloor/monogrid,
/area/shuttle/auto/one_single_area)
"v" = (
/obj/structure/cable/green{
	icon_state = "2-4"
	},
/obj/machinery/atmospherics/pipe/simple/hidden/cyan{
	dir = 9
	},
/turf/simulated/wall/prepainted,
/area/shuttle/auto/one_single_area)
"w" = (
/obj/structure/cable/green{
	icon_state = "4-8"
	},
/obj/machinery/atmospherics/component/unary/vent_pump/on{
	dir = 1
	},
/obj/structure/bed/chair/sofa/black/left{
	dir = 8
	},
/turf/simulated/floor/tiled/techfloor/monogrid,
/area/shuttle/auto/one_single_area)
"x" = (
/obj/machinery/atmospherics/pipe/simple/hidden/cyan{
	dir = 4
	},
/turf/simulated/wall/prepainted,
/area/shuttle/auto/one_single_area)
"y" = (
/obj/structure/table/steel_reinforced,
/obj/machinery/button/remote/blast_door{
	dir = 4;
	pixel_y = 9;
	id = "Adventurer2";
	name = "Adventurer Front Door"
	},
/obj/machinery/button/remote/blast_door{
	dir = 4;
	pixel_y = -8;
	id = "adventurer1";
	name = "Adventurer Back Door"
	},
/turf/simulated/floor/tiled/techfloor,
/area/shuttle/auto/one_single_area)
"z" = (
/obj/structure/table/steel_reinforced,
/obj/machinery/computer/ship/helm{
	req_one_access = null
	},
/turf/simulated/floor/tiled/techfloor,
/area/shuttle/auto/one_single_area)
"A" = (
/obj/machinery/door/firedoor,
/obj/machinery/button/remote/blast_door{
	id = "Adventurer2";
	name = "Adventurer Front Door";
	pixel_x = -26
	},
/obj/machinery/door/airlock/hatch{
	name = "Adventurer Airtight Hatch";
	req_one_access = null
	},
/obj/machinery/door/blast/regular{
	density = 0;
	dir = 4;
	icon_state = "pdoorc0";
	id = "Adventurer2";
	name = "Spacenat Caravan Airlock";
	opacity = 0
	},
/obj/machinery/atmospheric_field_generator/perma,
/turf/simulated/floor/plating,
/area/shuttle/auto/one_single_area)
"B" = (
/obj/structure/cable/green{
	icon_state = "4-8"
	},
/obj/structure/closet/walllocker_double/east,
/turf/simulated/floor/tiled/techfloor/monogrid,
/area/shuttle/auto/one_single_area)
"C" = (
/obj/structure/closet/walllocker/emerglocker{
	pixel_y = -32
	},
/turf/simulated/floor/tiled/techfloor/monogrid,
/area/shuttle/auto/one_single_area)
"D" = (
/obj/overmap/entity/visitable/ship/landable/trade/adventurer,
/turf/simulated/floor/tiled/techfloor/monogrid,
/area/shuttle/auto/one_single_area)
"F" = (
/obj/machinery/power/smes/buildable{
	charge = 15000;
	cur_coils = 3
	},
/obj/structure/cable/green{
	icon_state = "0-2"
	},
/turf/simulated/floor/plating,
/area/shuttle/auto/one_single_area)
"G" = (
/obj/spawner/window/low_wall/reinforced/firelocks,
/turf/simulated/floor/tiled/techfloor/monogrid,
/area/shuttle/auto/one_single_area)
"I" = (
/obj/machinery/telecomms/relay/preset/telecomms,
/obj/structure/cable/green{
	icon_state = "1-8"
	},
/turf/simulated/floor/plating,
/area/shuttle/auto/one_single_area)
"J" = (
/obj/structure/sink/kitchen{
	pixel_y = 17
	},
/obj/machinery/light_switch{
	dir = 1;
	pixel_y = -24
	},
/turf/simulated/floor/tiled/techfloor/monogrid,
/area/shuttle/auto/one_single_area)
"K" = (
/obj/machinery/atmospherics/pipe/simple/hidden{
	dir = 5
	},
/turf/simulated/wall/prepainted,
/area/shuttle/auto/one_single_area)
"L" = (
/obj/machinery/atmospherics/component/unary/engine{
	dir = 8
	},
/turf/simulated/shuttle/plating/airless/carry,
/area/shuttle/auto/one_single_area)
"M" = (
/obj/machinery/portable_atmospherics/canister/phoron,
/obj/machinery/atmospherics/portables_connector{
	dir = 1
	},
/turf/simulated/floor/plating,
/area/shuttle/auto/one_single_area)
"N" = (
/obj/machinery/atmospherics/pipe/simple/hidden{
	dir = 6
	},
/obj/structure/cable/green{
	icon_state = "4-8"
	},
/turf/simulated/wall/prepainted,
/area/shuttle/auto/one_single_area)
"O" = (
/obj/structure/cable/green{
	icon_state = "1-8"
	},
/obj/structure/shuttle/engine/heater{
	dir = 4
	},
/obj/machinery/atmospherics/pipe/simple/hidden{
	dir = 4
	},
/turf/simulated/wall/prepainted,
/area/shuttle/auto/one_single_area)
"P" = (
/obj/structure/cable/green{
	icon_state = "4-8"
	},
/obj/structure/window/reinforced/tinted{
	dir = 4
	},
/turf/simulated/floor/tiled/techfloor/monogrid,
/area/shuttle/auto/one_single_area)
"Q" = (
/obj/machinery/atmospherics/pipe/manifold/visible/cyan{
	dir = 1
	},
/obj/structure/shuttle_fuel_port{
	dir = 4;
	pixel_x = 29
	},
/obj/structure/bed/chair/sofa/black/corner,
/obj/machinery/light{
	dir = 1
	},
/obj/machinery/newscaster{
	pixel_y = 35
	},
/turf/simulated/floor/tiled/techfloor/monogrid,
/area/shuttle/auto/one_single_area)
"R" = (
/obj/structure/cable/orange{
	icon_state = "1-4"
	},
/turf/simulated/wall/prepainted/medical,
/area/shuttle/auto/one_single_area)
"S" = (
/obj/structure/cable/green{
	icon_state = "4-8"
	},
/turf/simulated/floor/tiled/techfloor/monogrid,
/area/shuttle/auto/one_single_area)
"T" = (
/obj/machinery/atmospherics/pipe/simple/hidden{
	dir = 4
	},
/turf/simulated/floor/tiled/techfloor/monogrid,
/area/shuttle/auto/one_single_area)
"U" = (
/obj/machinery/air_alarm/alarms_hidden/north_mount{
	req_one_access = null
	},
/obj/structure/window/reinforced/tinted{
	dir = 4
	},
/obj/machinery/atmospherics/valve{
	dir = 4
	},
/turf/simulated/floor/tiled/techfloor/monogrid,
/area/shuttle/auto/one_single_area)
"V" = (
/obj/machinery/atmospherics/pipe/simple/hidden/cyan{
	dir = 4
	},
/turf/simulated/floor/tiled/techfloor,
/area/shuttle/auto/one_single_area)
"W" = (
/obj/machinery/atmospherics/pipe/simple/hidden{
	dir = 10
	},
/obj/machinery/shipsensors,
/turf/simulated/floor/plating,
/area/shuttle/auto/one_single_area)
"X" = (
/obj/structure/cable/green{
	icon_state = "4-8"
	},
/obj/structure/table/bench/steel,
/turf/simulated/floor/tiled/techfloor/monogrid,
/area/shuttle/auto/one_single_area)
"Y" = (
/obj/machinery/atmospherics/pipe/simple/hidden/cyan{
	dir = 4
	},
/obj/structure/closet/crate/corporate/veymed,
/obj/structure/closet/walllocker_double/east,
/obj/machinery/light{
	dir = 4;
	old_wall = 1
	},
/turf/simulated/floor/tiled/techfloor/monogrid,
/area/shuttle/auto/one_single_area)
"Z" = (
/obj/machinery/atmospherics/portables_connector{
	dir = 1
	},
/obj/machinery/portable_atmospherics/canister/empty/phoron,
/turf/simulated/floor/plating,
/area/shuttle/auto/one_single_area)

(1,1,1) = {"
a
a
a
a
a
a
o
q
q
q
o
a
a
a
a
"}
(2,1,1) = {"
a
a
a
a
a
a
q
z
y
p
q
a
a
a
a
"}
(3,1,1) = {"
a
a
a
a
a
a
o
l
k
g
o
a
a
a
a
"}
(4,1,1) = {"
a
a
a
a
a
a
A
V
r
j
o
a
a
a
a
"}
(5,1,1) = {"
a
a
a
a
a
a
o
U
P
C
o
a
a
a
a
"}
(6,1,1) = {"
a
a
a
a
a
a
G
u
X
m
e
a
a
a
a
"}
(7,1,1) = {"
a
a
a
a
a
a
e
Q
w
h
e
a
a
a
a
"}
(8,1,1) = {"
a
a
a
a
a
a
e
x
d
J
e
a
a
a
a
"}
(9,1,1) = {"
a
a
a
a
a
a
e
f
s
D
b
a
a
a
a
"}
(10,1,1) = {"
a
a
a
a
a
a
e
T
S
m
t
a
a
a
a
"}
(11,1,1) = {"
a
a
a
a
a
a
e
Y
B
i
e
a
a
a
a
"}
(12,1,1) = {"
a
a
a
a
a
a
R
x
N
K
o
a
a
a
a
"}
(13,1,1) = {"
a
a
a
a
a
a
n
v
O
c
Z
a
a
a
a
"}
(14,1,1) = {"
a
a
a
a
a
a
F
I
L
W
M
a
a
a
a
"}
(15,1,1) = {"
a
a
a
a
a
a
a
a
a
a
a
a
a
a
a
"}
