//MAP CONVERTED BY dmm2tgm.py THIS HEADER COMMENT PREVENTS RECONVERSION, DO NOT REMOVE
"a" = (
/turf/space/basic,
/area/space)
"b" = (
/obj/machinery/atmospherics/component/unary/engine{
	dir = 8
	},
/turf/simulated/shuttle/plating/airless/carry,
/area/shuttle/auto/one_single_area)
"c" = (
/obj/machinery/computer/ship/sensors,
/obj/effect/floor_decal/techfloor{
	dir = 1
	},
/turf/simulated/floor/tiled/steel_dirty/red,
/area/shuttle/auto/one_single_area)
"d" = (
/obj/machinery/atmospherics/pipe/simple/hidden,
/turf/simulated/wall/r_wall/prepainted/command,
/area/shuttle/auto/one_single_area)
"f" = (
/obj/machinery/atmospherics/pipe/simple/hidden{
	dir = 5
	},
/turf/simulated/floor/tiled/techfloor/monogrid,
/area/shuttle/auto/one_single_area)
"g" = (
/obj/machinery/atmospherics/pipe/manifold/hidden{
	dir = 4
	},
/obj/structure/closet/walllocker_double/east,
/turf/simulated/floor/tiled/techfloor/monogrid,
/area/shuttle/auto/one_single_area)
"h" = (
/obj/machinery/power/smes/buildable{
	charge = 15000;
	cur_coils = 3
	},
/obj/structure/cable/green{
	icon_state = "0-4"
	},
/turf/simulated/floor/tiled/steel_dirty/dark,
/area/shuttle/auto/one_single_area)
"i" = (
/obj/machinery/portable_atmospherics/canister/empty/phoron,
/obj/machinery/light,
/obj/machinery/atmospherics/portables_connector{
	dir = 1
	},
/turf/simulated/floor/tiled/techfloor/monogrid,
/area/shuttle/auto/one_single_area)
"j" = (
/obj/machinery/shipsensors,
/turf/simulated/floor/tiled/techfloor/grid,
/area/shuttle/auto/one_single_area)
"k" = (
/obj/structure/cable/orange{
	icon_state = "1-2"
	},
/turf/simulated/floor/tiled/steel_dirty/dark,
/area/shuttle/auto/one_single_area)
"l" = (
/obj/machinery/atmospherics/pipe/simple/hidden{
	dir = 6
	},
/turf/simulated/floor/tiled/techfloor/monogrid,
/area/shuttle/auto/one_single_area)
"n" = (
/obj/machinery/atmospherics/pipe/manifold4w/visible,
/obj/machinery/power/apc/alarms_hidden/east_mount,
/obj/structure/cable/green{
	icon_state = "0-8"
	},
/turf/simulated/floor/tiled/techfloor/monogrid,
/area/shuttle/auto/one_single_area)
"o" = (
/obj/machinery/atmospherics/portables_connector,
/obj/machinery/portable_atmospherics/canister/empty/phoron,
/turf/simulated/floor/tiled/techfloor/monogrid,
/area/shuttle/auto/one_single_area)
"p" = (
/obj/machinery/computer/ship/engines,
/obj/effect/floor_decal/techfloor{
	dir = 1
	},
/turf/simulated/floor/tiled/steel_dirty/red,
/area/shuttle/auto/one_single_area)
"q" = (
/obj/structure/bed/chair/bay/shuttle{
	dir = 8
	},
/obj/machinery/atmospherics/pipe/simple/hidden/red{
	dir = 4
	},
/obj/landmark/spawnpoint/auto_shuttle_start,
/turf/simulated/floor/tiled/steel_dirty/red,
/area/shuttle/auto/one_single_area)
"r" = (
/obj/machinery/atmospherics/portables_connector{
	dir = 1
	},
/obj/machinery/portable_atmospherics/canister/empty/phoron,
/turf/simulated/floor/tiled/techfloor/monogrid,
/area/shuttle/auto/one_single_area)
"s" = (
/obj/structure/bed/chair/bay/shuttle{
	dir = 1
	},
/obj/machinery/computer/ship/navigation/telescreen{
	pixel_y = -33
	},
/turf/simulated/floor/tiled/steel_dirty/dark,
/area/shuttle/auto/one_single_area)
"t" = (
/turf/simulated/wall/r_wall/prepainted/command,
/area/shuttle/auto/one_single_area)
"u" = (
/obj/machinery/computer/ship/sensors{
	dir = 4
	},
/obj/structure/railing/grey,
/obj/structure/railing/grey{
	dir = 8
	},
/obj/machinery/light{
	dir = 1
	},
/turf/simulated/floor/tiled/steel_dirty/dark,
/area/shuttle/auto/one_single_area)
"v" = (
/obj/machinery/atmospherics/pipe/tank/air{
	dir = 8
	},
/obj/structure/cable/green{
	icon_state = "1-2"
	},
/obj/machinery/air_alarm/alarms_hidden/north_mount{
	req_one_access = null
	},
/turf/simulated/floor/tiled/techfloor/monogrid,
/area/shuttle/auto/one_single_area)
"x" = (
/obj/machinery/computer/shuttle_control{
	dir = 1
	},
/obj/item/gps/internal/base{
	name = "Arrowhead beacon";
	gps_tag = "ARROWHEAD"
	},
/turf/simulated/floor/tiled/steel_dirty/red,
/area/shuttle/auto/one_single_area)
"y" = (
/obj/structure/shuttle/engine/heater{
	dir = 4
	},
/obj/machinery/atmospherics/pipe/simple/hidden{
	dir = 6
	},
/turf/simulated/wall/r_wall/prepainted/command,
/area/shuttle/auto/one_single_area)
"z" = (
/turf/space,
/area/space)
"A" = (
/obj/structure/cable/green{
	icon_state = "1-4"
	},
/turf/simulated/wall/r_wall/prepainted/command,
/area/shuttle/auto/one_single_area)
"C" = (
/obj/structure/railing/grey,
/obj/machinery/atmospherics/pipe/simple/hidden/red{
	dir = 4
	},
/obj/effect/floor_decal/industrial/halfstair{
	dir = 8
	},
/turf/simulated/floor/tiled/steel_dirty/dark,
/area/shuttle/auto/one_single_area)
"D" = (
/obj/machinery/telecomms/relay/preset/telecomms,
/turf/simulated/floor/tiled/techfloor/grid,
/area/shuttle/auto/one_single_area)
"E" = (
/obj/structure/cable/green{
	icon_state = "2-8"
	},
/turf/simulated/wall/r_wall/prepainted/command,
/area/shuttle/auto/one_single_area)
"F" = (
/obj/structure/shuttle_fuel_port{
	dir = 4;
	pixel_x = 29
	},
/obj/structure/handrail{
	dir = 8
	},
/obj/machinery/atmospherics/pipe/simple/hidden/red{
	dir = 9
	},
/obj/structure/cable/orange{
	icon_state = "1-2"
	},
/turf/simulated/floor/tiled/steel_dirty/dark,
/area/shuttle/auto/one_single_area)
"G" = (
/obj/structure/shuttle/engine/heater{
	dir = 4
	},
/obj/machinery/atmospherics/pipe/manifold4w/visible,
/turf/simulated/wall/r_wall/prepainted/command,
/area/shuttle/auto/one_single_area)
"H" = (
/obj/machinery/atmospherics/pipe/manifold4w/visible,
/obj/structure/cable/green{
	icon_state = "4-8"
	},
/turf/simulated/floor/tiled/techfloor/monogrid,
/area/shuttle/auto/one_single_area)
"J" = (
/obj/machinery/computer/ship/helm{
	dir = 1
	},
/obj/item/reagent_containers/food/drinks/golden_cup{
	pixel_y = 7;
	pixel_x = -6
	},
/turf/simulated/floor/tiled/steel_dirty/red,
/area/shuttle/auto/one_single_area)
"K" = (
/obj/machinery/button/remote/blast_door{
	id = "Arrowhead Airlock";
	pixel_x = 25
	},
/obj/machinery/door/airlock/hatch{
	name = "Arrowhead Airtight Hatch";
	req_one_access = null
	},
/obj/machinery/door/blast/regular{
	id = "Arrowhead Airlock"
	},
/obj/structure/cable/orange{
	icon_state = "1-2"
	},
/obj/machinery/atmospheric_field_generator/perma,
/obj/shuttle_aligner/port/south/primary,
/turf/simulated/floor/tiled/steel_dirty/dark,
/area/shuttle/auto/one_single_area)
"L" = (
/obj/structure/handrail,
/turf/simulated/floor/tiled/techfloor/monogrid,
/area/shuttle/auto/one_single_area)
"M" = (
/obj/structure/railing/grey{
	dir = 8
	},
/obj/structure/bed/chair/bay/shuttle{
	dir = 1
	},
/obj/machinery/light,
/turf/simulated/floor/tiled/steel_dirty/dark,
/area/shuttle/auto/one_single_area)
"N" = (
/obj/machinery/atmospherics/portables_connector,
/obj/machinery/portable_atmospherics/canister/empty/phoron,
/obj/machinery/light{
	dir = 1
	},
/turf/simulated/floor/tiled/techfloor/monogrid,
/area/shuttle/auto/one_single_area)
"O" = (
/obj/machinery/atmospherics/component/unary/vent_pump/on{
	dir = 4
	},
/turf/simulated/floor/tiled/steel_dirty/red,
/area/shuttle/auto/one_single_area)
"P" = (
/obj/machinery/atmospherics/pipe/simple/hidden/red{
	dir = 6
	},
/obj/structure/cable/orange{
	dir = 1
	},
/obj/machinery/power/terminal{
	dir = 1
	},
/turf/simulated/floor/tiled/steel_dirty/dark,
/area/shuttle/auto/one_single_area)
"Q" = (
/obj/structure/shuttle/engine/heater{
	dir = 4
	},
/obj/machinery/atmospherics/pipe/manifold/hidden{
	dir = 8
	},
/turf/simulated/wall/r_wall/prepainted/command,
/area/shuttle/auto/one_single_area)
"R" = (
/obj/structure/railing/grey,
/obj/effect/floor_decal/techfloor{
	dir = 1
	},
/obj/machinery/atmospherics/valve{
	dir = 4
	},
/turf/simulated/floor/tiled/steel_dirty/red,
/area/shuttle/auto/one_single_area)
"S" = (
/obj/machinery/holopad/ship/starts_inactive,
/obj/machinery/atmospherics/pipe/simple/hidden/red{
	dir = 4
	},
/turf/simulated/floor/tiled/steel_dirty/red,
/area/shuttle/auto/one_single_area)
"T" = (
/obj/spawner/window/low_wall/reinforced/firelocks,
/turf/simulated/floor/tiled/steel_dirty/red,
/area/shuttle/auto/one_single_area)
"V" = (
/obj/structure/cable/green{
	icon_state = "4-8"
	},
/obj/machinery/atmospherics/portables_connector{
	dir = 4
	},
/obj/machinery/portable_atmospherics/canister/phoron,
/turf/simulated/floor/tiled/techfloor/monogrid,
/area/shuttle/auto/one_single_area)
"W" = (
/obj/structure/shuttle/engine/heater{
	dir = 4
	},
/obj/machinery/atmospherics/pipe/simple/hidden{
	dir = 5
	},
/turf/simulated/wall/r_wall/prepainted/command,
/area/shuttle/auto/one_single_area)
"X" = (
/obj/structure/railing/grey,
/obj/structure/bed/chair/bay/shuttle{
	dir = 8
	},
/obj/structure/panic_button{
	pixel_y = 32
	},
/turf/simulated/floor/tiled/steel_dirty/dark,
/area/shuttle/auto/one_single_area)
"Y" = (
/obj/spawner/window/low_wall/reinforced/firelocks,
/turf/simulated/floor/tiled/steel_dirty/dark,
/area/shuttle/auto/one_single_area)
"Z" = (
/obj/item/modular_computer/console/preset/civilian{
	dir = 4
	},
/turf/simulated/floor/tiled/steel_dirty/red,
/area/shuttle/auto/one_single_area)

(1,1,1) = {"
a
a
a
a
a
a
a
a
a
a
a
a
a
a
a
"}
(2,1,1) = {"
a
a
a
z
z
Y
T
T
z
z
a
a
a
a
a
"}
(3,1,1) = {"
a
a
a
z
z
T
Z
T
z
z
a
a
a
a
a
"}
(4,1,1) = {"
a
a
a
z
Y
T
O
T
T
z
a
a
a
a
a
"}
(5,1,1) = {"
a
a
a
z
Y
c
S
J
T
z
a
a
a
a
a
"}
(6,1,1) = {"
a
a
a
z
Y
p
q
x
T
z
a
a
a
a
a
"}
(7,1,1) = {"
a
a
a
j
Y
u
R
M
Y
D
a
a
a
a
a
"}
(8,1,1) = {"
a
a
a
t
t
X
C
s
t
t
a
a
a
a
a
"}
(9,1,1) = {"
a
a
a
t
h
P
F
k
k
K
a
a
a
a
a
"}
(10,1,1) = {"
a
a
a
t
E
v
A
L
t
t
a
a
a
a
a
"}
(11,1,1) = {"
a
a
a
t
o
f
V
l
r
t
a
a
a
a
a
"}
(12,1,1) = {"
a
a
a
t
N
g
H
g
i
t
a
a
a
a
a
"}
(13,1,1) = {"
a
a
a
y
Q
d
n
d
Q
W
a
a
a
a
a
"}
(14,1,1) = {"
a
a
a
b
b
y
G
W
b
b
a
a
a
a
a
"}
(15,1,1) = {"
a
a
a
z
z
b
b
b
z
z
a
a
a
a
a
"}
