//MAP CONVERTED BY dmm2tgm.py THIS HEADER COMMENT PREVENTS RECONVERSION, DO NOT REMOVE
"be" = (
/obj/structure/marker_beacon/yellow,
/obj/effect/floor_decal/borderfloorblack{
	dir = 1
	},
/turf/simulated/floor/tiled/old_tile/yellow,
/area/shuttle/auto/one_single_area)
"cO" = (
/obj/structure/cable/pink{
	icon_state = "2-4"
	},
/obj/machinery/airlock_component/cycler/hardmapped,
/obj/structure/airlock_interconnect/hardmapped,
/turf/simulated/floor/plating,
/area/shuttle/auto/one_single_area)
"eA" = (
/obj/effect/floor_decal/industrial/halfstair,
/obj/structure/handrail{
	dir = 8
	},
/turf/simulated/floor/plating,
/area/shuttle/auto/one_single_area)
"eL" = (
/obj/structure/cable/cyan{
	icon_state = "4-8"
	},
/turf/simulated/wall/prepainted/engineering,
/area/shuttle/auto/one_single_area)
"go" = (
/obj/effect/floor_decal/industrial/halfstair,
/obj/structure/handrail{
	dir = 4
	},
/obj/structure/poster{
	pixel_x = -32
	},
/obj/machinery/atmospherics/pipe/manifold/hidden/cyan{
	dir = 4
	},
/turf/simulated/floor/plating,
/area/shuttle/auto/one_single_area)
"gu" = (
/obj/effect/floor_decal/rust,
/turf/simulated/floor/plating,
/area/shuttle/auto/one_single_area)
"gC" = (
/obj/machinery/door/airlock/voidcraft/vertical,
/obj/structure/cable/pink{
	icon_state = "1-2"
	},
/obj/machinery/airlock_component/door_linker/outdoors/hardmapped,
/obj/structure/airlock_interconnect/hardmapped,
/obj/shuttle_aligner/port/two_wide/left_aligned/south/primary,
/turf/simulated/floor/plating,
/area/shuttle/auto/one_single_area)
"hb" = (
/obj/structure/cable/pink{
	icon_state = "4-8"
	},
/obj/machinery/atmospherics/pipe/manifold/hidden/cyan{
	dir = 1
	},
/obj/structure/curtain/open/shower/engineering,
/turf/simulated/floor/plating,
/area/shuttle/auto/one_single_area)
"hk" = (
/obj/machinery/atmospherics/pipe/simple/hidden/cyan{
	dir = 4
	},
/obj/structure/closet/largecardboard,
/obj/item/retail_scanner,
/turf/simulated/floor/plating,
/area/shuttle/auto/one_single_area)
"hN" = (
/obj/structure/railing/grey,
/obj/machinery/atmospherics/component/unary/vent_pump/on{
	dir = 8
	},
/obj/structure/handrail{
	dir = 1
	},
/obj/structure/cable/cyan{
	icon_state = "1-2"
	},
/obj/structure/bed/chair/shuttle{
	dir = 4
	},
/obj/machinery/computer/ship/navigation/telescreen{
	pixel_x = 32;
	pixel_y = -3
	},
/obj/effect/floor_decal/borderfloorblack{
	dir = 6
	},
/turf/simulated/floor/tiled/old_tile/yellow,
/area/shuttle/auto/one_single_area)
"iZ" = (
/obj/structure/railing/grey,
/obj/structure/bed/chair/shuttle{
	dir = 4
	},
/obj/effect/floor_decal/borderfloorblack,
/turf/simulated/floor/tiled/old_tile/yellow,
/area/shuttle/auto/one_single_area)
"jh" = (
/obj/machinery/door/airlock/voidcraft/vertical{
	name = "cockpit hatch"
	},
/turf/simulated/floor/plating,
/area/shuttle/auto/one_single_area)
"kf" = (
/obj/machinery/power/smes/buildable{
	charge = 1.5e+007;
	cur_coils = 3
	},
/obj/machinery/light{
	light_range = 12
	},
/obj/structure/cable/cyan{
	icon_state = "0-4"
	},
/turf/simulated/floor/plating,
/area/shuttle/auto/one_single_area)
"kJ" = (
/obj/machinery/atmospherics/pipe/manifold/hidden{
	dir = 8
	},
/turf/simulated/wall/prepainted/cargo,
/area/shuttle/auto/one_single_area)
"kS" = (
/obj/structure/catwalk,
/obj/structure/cable/pink{
	icon_state = "4-8"
	},
/obj/machinery/atmospherics/pipe/simple/hidden/universal{
	dir = 4
	},
/turf/simulated/wall,
/area/shuttle/auto/one_single_area)
"lR" = (
/obj/structure/cable/cyan{
	icon_state = "1-8"
	},
/obj/structure/closet/largecardboard,
/obj/item/instrument/guitar,
/obj/item/instrument/piano_synth,
/obj/item/instrument/glockenspiel,
/obj/item/instrument/violin,
/obj/item/instrument/saxophone,
/obj/item/instrument/harmonica,
/obj/item/instrument/eguitar,
/turf/simulated/floor/plating,
/area/shuttle/auto/one_single_area)
"nB" = (
/obj/effect/floor_decal/rust,
/obj/machinery/airlock_component/interface/shuttle/port/hardmapped,
/obj/structure/airlock_interconnect/hardmapped,
/turf/simulated/floor/plating,
/area/shuttle/auto/one_single_area)
"nJ" = (
/obj/machinery/atmospherics/component/unary/vent_pump/on{
	dir = 8
	},
/obj/structure/cable/cyan{
	icon_state = "1-2"
	},
/obj/effect/floor_decal/rust,
/obj/machinery/air_alarm/alarms_hidden/east_mount,
/turf/simulated/floor/plating,
/area/shuttle/auto/one_single_area)
"nP" = (
/obj/machinery/atmospherics/pipe/simple/hidden{
	dir = 10
	},
/obj/structure/shuttle/engine/heater{
	dir = 8
	},
/turf/simulated/wall,
/area/shuttle/auto/one_single_area)
"oj" = (
/obj/item/storage/toolbox/mechanical,
/obj/machinery/atmospherics/pipe/simple/hidden{
	dir = 9
	},
/obj/structure/cable/cyan,
/obj/machinery/power/apc/large_cell/tier_3/south_mount,
/turf/simulated/floor/plating,
/area/shuttle/auto/one_single_area)
"or" = (
/obj/machinery/computer/ship/engines{
	dir = 1
	},
/turf/simulated/floor/tiled/old_tile/gray,
/area/shuttle/auto/one_single_area)
"os" = (
/obj/structure/cable/cyan{
	icon_state = "2-8"
	},
/obj/structure/panic_button{
	pixel_x = -32
	},
/obj/machinery/holopad/ship/starts_inactive,
/obj/machinery/light{
	dir = 8;
	light_range = 12;
	old_wall = 1
	},
/turf/simulated/floor/tiled/old_tile/yellow,
/area/shuttle/auto/one_single_area)
"oL" = (
/obj/machinery/portable_atmospherics/canister/empty/phoron,
/obj/machinery/atmospherics/pipe/simple/hidden/cyan,
/obj/structure/handrail,
/obj/structure/window/reinforced/polarized{
	id = "udang_cargo";
	dir = 1
	},
/obj/structure/metal_edge{
	layer = 1
	},
/turf/simulated/floor/plating,
/area/shuttle/auto/one_single_area)
"oM" = (
/obj/machinery/atmospherics/component/unary/heater{
	dir = 1;
	icon_state = "heater_1";
	use_power = 1
	},
/turf/simulated/floor/plating,
/area/shuttle/auto/one_single_area)
"oN" = (
/obj/effect/floor_decal/rust,
/obj/effect/floor_decal/rust,
/obj/machinery/telecomms/relay/preset/telecomms,
/turf/simulated/floor/plating,
/area/shuttle/auto/one_single_area)
"pw" = (
/obj/structure/closet/crate/corporate/nanotrasen,
/obj/structure/handrail,
/obj/structure/window/reinforced/polarized{
	id = "udang_cargo";
	dir = 1
	},
/obj/structure/metal_edge{
	layer = 1
	},
/turf/simulated/floor/plating,
/area/shuttle/auto/one_single_area)
"pP" = (
/obj/structure/cable/pink{
	icon_state = "4-8"
	},
/obj/machinery/atmospherics/pipe/manifold/hidden/cyan{
	dir = 4
	},
/turf/simulated/floor/plating,
/area/shuttle/auto/one_single_area)
"qG" = (
/obj/structure/marker_beacon/yellow,
/obj/effect/floor_decal/borderfloorblack{
	dir = 1
	},
/turf/simulated/floor/tiled/old_tile/gray,
/area/shuttle/auto/one_single_area)
"qM" = (
/obj/machinery/atmospherics/pipe/simple/hidden/cyan,
/obj/machinery/suit_cycler/syndicate,
/turf/simulated/floor/plating,
/area/shuttle/auto/one_single_area)
"tj" = (
/obj/machinery/atmospherics/pipe/tank/air{
	dir = 8
	},
/turf/simulated/floor/plating,
/area/shuttle/auto/one_single_area)
"tk" = (
/obj/machinery/atmospherics/pipe/simple/hidden/cyan{
	dir = 4
	},
/turf/simulated/wall,
/area/shuttle/auto/one_single_area)
"tA" = (
/obj/structure/curtain/open/shower/engineering,
/obj/structure/railing/grey{
	dir = 8
	},
/obj/structure/window/reinforced/polarized{
	id = "udang_cargo";
	dir = 1
	},
/obj/structure/reagent_dispensers/beerkeg,
/obj/structure/metal_edge{
	layer = 1
	},
/turf/simulated/floor/plating,
/area/shuttle/auto/one_single_area)
"ui" = (
/obj/effect/floor_decal/rust,
/obj/machinery/recharge_station,
/turf/simulated/floor/plating,
/area/shuttle/auto/one_single_area)
"uR" = (
/obj/structure/handrail,
/obj/machinery/airlock_component/controller/vacuum_cycle/hardmapped,
/obj/machinery/airlock_peripheral/panel/hardmapped/north_mount,
/obj/map_helper/airlock_linker/preset/shuttle_main,
/obj/structure/airlock_interconnect/hardmapped,
/turf/simulated/floor/plating,
/area/shuttle/auto/one_single_area)
"uT" = (
/obj/machinery/door/airlock/voidcraft/vertical{
	name = "cockpit hatch"
	},
/obj/structure/cable/cyan{
	icon_state = "4-8"
	},
/obj/structure/curtain/open/shower/engineering,
/turf/simulated/floor/tiled/old_tile/yellow,
/area/shuttle/auto/one_single_area)
"vC" = (
/obj/structure/cable/cyan{
	icon_state = "1-2"
	},
/turf/simulated/floor/tiled/old_tile/yellow,
/area/shuttle/auto/one_single_area)
"vX" = (
/obj/structure/table/bench/wooden,
/obj/structure/flora/pottedplant/tall{
	pixel_y = 14
	},
/obj/structure/window/reinforced/polarized{
	dir = 4;
	id = "udang_cabin2";
	pixel_x = 5
	},
/obj/structure/cable/cyan{
	icon_state = "4-8"
	},
/turf/simulated/floor/carpet/patterened/brown,
/area/shuttle/auto/one_single_area)
"wm" = (
/obj/machinery/atmospherics/portables_connector,
/obj/structure/cable/cyan{
	icon_state = "2-8";
	dir = 4
	},
/turf/simulated/floor/plating,
/area/shuttle/auto/one_single_area)
"wR" = (
/obj/structure/handrail,
/obj/machinery/light{
	dir = 1
	},
/obj/effect/floor_decal/rust,
/obj/machinery/airlock_component/handler/hardmapped{
	dir = 4
	},
/obj/structure/airlock_interconnect/hardmapped,
/turf/simulated/floor/plating,
/area/shuttle/auto/one_single_area)
"xC" = (
/obj/structure/railing/grey,
/obj/machinery/atmospherics/pipe/simple/hidden/cyan{
	dir = 4
	},
/obj/structure/handrail{
	dir = 1
	},
/obj/structure/bed/chair/shuttle{
	dir = 4
	},
/obj/effect/floor_decal/borderfloorblack,
/turf/simulated/floor/tiled/old_tile/yellow,
/area/shuttle/auto/one_single_area)
"yQ" = (
/obj/structure/cable/cyan{
	icon_state = "0-4";
	dir = 4
	},
/obj/machinery/computer/shuttle_control{
	dir = 1
	},
/obj/machinery/power/apc/alarms_hidden/west_mount,
/turf/simulated/floor/tiled/old_tile/gray,
/area/shuttle/auto/one_single_area)
"zI" = (
/obj/machinery/door/airlock/voidcraft/vertical{
	name = "fire control hatch"
	},
/obj/structure/catwalk,
/obj/machinery/airlock_component/door_linker/indoors/hardmapped,
/obj/machinery/airlock_peripheral/sensor/button/interior/hardmapped/south_mount,
/obj/map_helper/airlock_linker/preset/shuttle_main,
/obj/structure/airlock_interconnect/hardmapped,
/turf/simulated/floor/plating,
/area/shuttle/auto/one_single_area)
"zQ" = (
/obj/structure/closet/walllocker/emergsuit_wall{
	pixel_y = 30
	},
/obj/effect/floor_decal/borderfloorblack{
	dir = 1
	},
/turf/simulated/floor/tiled/old_tile/yellow,
/area/shuttle/auto/one_single_area)
"At" = (
/obj/structure/bed/chair/sofa/beige/right{
	dir = 4
	},
/obj/structure/window/reinforced/polarized{
	dir = 8;
	id = "udang_cabin1"
	},
/obj/structure/window/reinforced/polarized{
	id = "udang_cabin1"
	},
/obj/machinery/button/windowtint{
	pixel_y = -12;
	pixel_x = 13;
	id = "udang_cabin1"
	},
/obj/structure/cable/cyan{
	icon_state = "4-8"
	},
/turf/simulated/floor/carpet/patterened/brown,
/area/shuttle/auto/one_single_area)
"Bw" = (
/obj/structure/bed/chair/sofa/beige/left,
/turf/simulated/floor/carpet/patterened/brown,
/area/shuttle/auto/one_single_area)
"CE" = (
/obj/machinery/shipsensors,
/turf/simulated/floor/plating,
/area/shuttle/auto/one_single_area)
"Dn" = (
/obj/machinery/atmospherics/pipe/simple/hidden{
	dir = 9
	},
/obj/structure/shuttle/engine/heater{
	dir = 8
	},
/turf/simulated/wall,
/area/shuttle/auto/one_single_area)
"EE" = (
/obj/structure/cable/cyan{
	icon_state = "1-2"
	},
/obj/structure/marker_beacon/yellow,
/obj/effect/floor_decal/borderfloorblack{
	dir = 5
	},
/turf/simulated/floor/tiled/old_tile/yellow,
/area/shuttle/auto/one_single_area)
"FI" = (
/obj/machinery/door/airlock/voidcraft/survival_pod,
/obj/structure/curtain/open/shower,
/obj/structure/cable/cyan{
	icon_state = "4-8"
	},
/turf/simulated/floor/tiled/old_tile/gray,
/area/shuttle/auto/one_single_area)
"Gt" = (
/turf/simulated/wall/prepainted/cargo,
/area/shuttle/auto/one_single_area)
"Gy" = (
/obj/machinery/computer/ship/navigation/telescreen{
	pixel_y = 24
	},
/obj/machinery/light{
	dir = 1
	},
/obj/structure/bed/chair/sofa/beige/corner{
	dir = 4
	},
/obj/structure/poster{
	pixel_x = -32
	},
/turf/simulated/floor/carpet/patterened/brown,
/area/shuttle/auto/one_single_area)
"HK" = (
/obj/structure/cable/pink{
	icon_state = "0-8"
	},
/obj/machinery/power/terminal,
/obj/machinery/atmospherics/pipe/simple/hidden/cyan{
	dir = 4
	},
/turf/simulated/floor/plating,
/area/shuttle/auto/one_single_area)
"HU" = (
/obj/effect/floor_decal/borderfloorblack,
/turf/simulated/floor/tiled/old_tile/yellow,
/area/shuttle/auto/one_single_area)
"IX" = (
/obj/structure/bed/chair/sofa/beige/left,
/obj/structure/window/reinforced/polarized{
	dir = 4;
	id = "udang_cabin2";
	pixel_x = 5
	},
/turf/simulated/floor/carpet/patterened/brown,
/area/shuttle/auto/one_single_area)
"Jn" = (
/obj/structure/cable/cyan{
	icon_state = "2-8"
	},
/obj/structure/window/wooden{
	dir = 8
	},
/obj/machinery/vending/coffee,
/obj/machinery/photocopier/faxmachine{
	department = "Udang Trade Shuttle";
	pixel_y = 18
	},
/obj/structure/cable/cyan{
	icon_state = "2-4"
	},
/turf/simulated/floor/tiled/old_tile/gray,
/area/shuttle/auto/one_single_area)
"Jt" = (
/obj/machinery/computer/ship/sensors{
	dir = 8
	},
/obj/item/gps/internal/base{
	name = "Udang beacon";
	gps_tag = "UDANG"
	},
/turf/simulated/floor/tiled/old_tile/gray,
/area/shuttle/auto/one_single_area)
"Lc" = (
/obj/machinery/atmospherics/portables_connector,
/obj/effect/floor_decal/rust,
/obj/machinery/portable_atmospherics/canister/phoron,
/turf/simulated/floor/plating,
/area/shuttle/auto/one_single_area)
"Lj" = (
/obj/effect/floor_decal/borderfloorblack{
	dir = 1
	},
/turf/simulated/floor/tiled/old_tile/yellow,
/area/shuttle/auto/one_single_area)
"LS" = (
/obj/structure/marker_beacon/yellow,
/obj/effect/floor_decal/borderfloorblack{
	dir = 9
	},
/turf/simulated/floor/tiled/old_tile/yellow,
/area/shuttle/auto/one_single_area)
"LU" = (
/obj/machinery/computer/ship/navigation/telescreen{
	pixel_y = 24
	},
/obj/machinery/light{
	dir = 1
	},
/obj/structure/bed/chair/sofa/beige/corner{
	dir = 4
	},
/obj/structure/window/reinforced/polarized{
	dir = 8;
	id = "udang_cabin1"
	},
/turf/simulated/floor/carpet/patterened/brown,
/area/shuttle/auto/one_single_area)
"Md" = (
/obj/spawner/window/low_wall/reinforced/firelocks,
/turf/simulated/floor/plating,
/area/shuttle/auto/one_single_area)
"MJ" = (
/obj/structure/cable/pink{
	icon_state = "4-8"
	},
/obj/effect/floor_decal/rust,
/obj/machinery/atmospherics/pipe/simple/hidden/cyan{
	dir = 5
	},
/obj/machinery/button/windowtint{
	pixel_y = -22;
	id = "udang_cargo"
	},
/turf/simulated/floor/plating,
/area/shuttle/auto/one_single_area)
"Nr" = (
/turf/space,
/area/space)
"NC" = (
/obj/structure/bed/chair/sofa/beige/right{
	dir = 4
	},
/obj/structure/window/reinforced/polarized{
	id = "udang_cabin2"
	},
/obj/machinery/button/windowtint{
	pixel_y = -12;
	pixel_x = 13;
	id = "udang_cabin2"
	},
/obj/structure/cable/cyan{
	icon_state = "4-8"
	},
/turf/simulated/floor/carpet/patterened/brown,
/area/shuttle/auto/one_single_area)
"NL" = (
/obj/machinery/atmospherics/pipe/simple/hidden,
/turf/simulated/wall/prepainted/cargo,
/area/shuttle/auto/one_single_area)
"NS" = (
/obj/machinery/door/airlock/voidcraft/vertical,
/obj/machinery/airlock_component/door_linker/outdoors/hardmapped,
/obj/machinery/airlock_peripheral/sensor/button/exterior/hardmapped/west_mount,
/obj/map_helper/airlock_linker/preset/shuttle_main,
/obj/structure/airlock_interconnect/hardmapped,
/turf/simulated/floor/plating,
/area/shuttle/auto/one_single_area)
"Oa" = (
/obj/structure/cable/cyan{
	icon_state = "4-8"
	},
/turf/simulated/wall,
/area/shuttle/auto/one_single_area)
"OR" = (
/obj/structure/railing/grey,
/obj/structure/handrail{
	dir = 1
	},
/obj/structure/bed/chair/shuttle{
	dir = 4
	},
/obj/effect/floor_decal/borderfloorblack,
/turf/simulated/floor/tiled/old_tile/yellow,
/area/shuttle/auto/one_single_area)
"PY" = (
/obj/structure/table/rack/shelf/steel,
/obj/item/clothing/head/helmet/space/void/explorer,
/obj/item/clothing/head/helmet/space/void/explorer,
/obj/item/clothing/suit/space/void/explorer,
/obj/item/clothing/suit/space/void/explorer,
/obj/item/tank/jetpack/oxygen,
/obj/item/tank/jetpack/oxygen,
/obj/structure/cable/cyan{
	icon_state = "1-2"
	},
/obj/machinery/light{
	dir = 1
	},
/obj/structure/window/reinforced/polarized{
	id = "udang_cargo";
	dir = 1
	},
/obj/structure/metal_edge{
	layer = 1
	},
/turf/simulated/floor/plating,
/area/shuttle/auto/one_single_area)
"Qk" = (
/turf/simulated/wall/prepainted/engineering,
/area/shuttle/auto/one_single_area)
"Qr" = (
/obj/structure/railing/grey,
/obj/machinery/atmospherics/pipe/simple/hidden/cyan{
	dir = 6
	},
/obj/structure/handrail{
	dir = 1
	},
/obj/structure/bed/chair/shuttle{
	dir = 4
	},
/obj/effect/floor_decal/borderfloorblack,
/turf/simulated/floor/tiled/old_tile/yellow,
/area/shuttle/auto/one_single_area)
"QP" = (
/obj/structure/bed/chair/bay/comfy/captain{
	dir = 4
	},
/obj/landmark/spawnpoint/auto_shuttle_start,
/turf/simulated/floor/tiled/old_tile/yellow,
/area/shuttle/auto/one_single_area)
"Rf" = (
/obj/machinery/computer/ship/helm{
	dir = 8
	},
/turf/simulated/floor/tiled/old_tile/gray,
/area/shuttle/auto/one_single_area)
"Sp" = (
/obj/machinery/portable_atmospherics/canister/empty/phoron,
/obj/structure/handrail,
/obj/structure/window/reinforced/polarized{
	id = "udang_cargo";
	dir = 1
	},
/obj/structure/metal_edge{
	layer = 1
	},
/turf/simulated/floor/plating,
/area/shuttle/auto/one_single_area)
"TO" = (
/obj/machinery/atmospherics/component/unary/engine{
	dir = 4
	},
/turf/simulated/shuttle/plating/airless/carry,
/area/shuttle/auto/one_single_area)
"Ua" = (
/obj/machinery/atmospherics/pipe/tank/phoron{
	volume = 20000
	},
/turf/simulated/floor/plating,
/area/shuttle/auto/one_single_area)
"Vm" = (
/obj/structure/toilet{
	dir = 4
	},
/obj/machinery/shower{
	dir = 8
	},
/obj/structure/poster{
	pixel_x = -32
	},
/obj/machinery/light{
	dir = 8;
	light_range = 12
	},
/turf/simulated/floor/tiled/old_tile/gray,
/area/shuttle/auto/one_single_area)
"VB" = (
/obj/structure/table/bench/wooden,
/obj/structure/flora/pottedplant/shoot{
	pixel_y = 15
	},
/obj/structure/cable/cyan{
	icon_state = "4-8"
	},
/turf/simulated/floor/carpet/patterened/brown,
/area/shuttle/auto/one_single_area)
"VG" = (
/obj/structure/handrail{
	dir = 1
	},
/obj/machinery/atmospherics/pipe/manifold/hidden,
/turf/simulated/floor/plating,
/area/shuttle/auto/one_single_area)
"Wo" = (
/turf/space/basic,
/area/space)
"Xp" = (
/obj/machinery/atmospherics/pipe/simple/hidden/cyan{
	dir = 6
	},
/turf/simulated/wall,
/area/shuttle/auto/one_single_area)
"Xq" = (
/obj/structure/cable/pink{
	icon_state = "4-8"
	},
/obj/machinery/atmospherics/pipe/simple/hidden/cyan{
	dir = 4
	},
/turf/simulated/floor/plating,
/area/shuttle/auto/one_single_area)
"Xt" = (
/obj/machinery/atmospherics/pipe/manifold/hidden,
/obj/structure/shuttle_fuel_port{
	dir = 4;
	pixel_y = -32
	},
/obj/machinery/light{
	light_range = 12
	},
/obj/effect/floor_decal/rust,
/obj/item/tank/phoron,
/turf/simulated/floor/plating,
/area/shuttle/auto/one_single_area)
"XL" = (
/obj/machinery/atmospherics/pipe/simple/hidden/cyan{
	dir = 5
	},
/obj/structure/curtain/open/shower/engineering,
/obj/machinery/light{
	light_range = 12
	},
/turf/simulated/floor/plating,
/area/shuttle/auto/one_single_area)
"YY" = (
/obj/structure/cable/pink{
	icon_state = "4-8"
	},
/obj/machinery/atmospherics/pipe/simple/hidden/cyan{
	dir = 4
	},
/obj/effect/floor_decal/rust,
/turf/simulated/floor/plating,
/area/shuttle/auto/one_single_area)
"Zy" = (
/obj/structure/closet/walllocker/emergsuit_wall{
	dir = 8;
	pixel_x = -32
	},
/obj/machinery/light{
	dir = 8;
	light_range = 12
	},
/obj/effect/floor_decal/borderfloorblack{
	dir = 10
	},
/obj/machinery/atmospherics/pipe/simple/hidden/cyan{
	dir = 10
	},
/turf/simulated/floor/tiled/old_tile/yellow,
/area/shuttle/auto/one_single_area)
"Zz" = (
/turf/simulated/wall,
/area/shuttle/auto/one_single_area)

(1,1,1) = {"
Wo
Wo
Wo
Wo
Wo
Wo
Wo
Wo
Wo
Wo
Wo
Wo
Wo
Wo
Wo
Wo
Wo
Wo
Wo
Wo
Wo
Wo
Wo
Wo
Wo
"}
(2,1,1) = {"
Wo
Wo
Wo
Wo
Wo
Wo
Wo
Wo
Wo
Wo
Wo
Wo
Wo
Wo
Wo
Wo
Wo
Wo
Wo
Wo
Wo
Wo
Wo
Wo
Wo
"}
(3,1,1) = {"
Wo
Wo
Wo
Wo
Wo
Wo
Wo
Wo
Wo
Wo
Wo
Wo
Wo
Wo
Wo
Wo
Wo
Wo
Wo
Wo
Wo
Wo
Wo
Wo
Wo
"}
(4,1,1) = {"
Wo
Wo
Wo
Wo
Wo
Wo
Wo
Wo
Wo
Wo
Wo
Wo
Wo
Wo
Wo
Wo
Wo
Wo
Wo
Wo
Wo
Wo
Wo
Wo
Wo
"}
(5,1,1) = {"
Wo
Wo
Wo
Wo
Wo
Wo
Wo
Wo
Nr
Nr
TO
Nr
Nr
Nr
TO
Nr
Nr
Wo
Wo
Wo
Wo
Wo
Wo
Wo
Wo
"}
(6,1,1) = {"
Wo
Wo
Wo
Wo
Wo
Wo
Wo
Wo
Nr
Gt
nP
kJ
NL
NL
Dn
Gt
Nr
Wo
Wo
Wo
Wo
Wo
Wo
Wo
Wo
"}
(7,1,1) = {"
Wo
Wo
Wo
Wo
Wo
Wo
Wo
Wo
Nr
Gt
Ua
Xt
Xp
qM
oM
Gt
Wo
Wo
Wo
Wo
Wo
Wo
Wo
Wo
Wo
"}
(8,1,1) = {"
Wo
Wo
Wo
Wo
Wo
Wo
Wo
Wo
Nr
Gt
Lc
VG
tk
uR
nB
NS
Wo
Wo
Wo
Wo
Wo
Wo
Wo
Wo
Wo
"}
(9,1,1) = {"
Wo
Wo
Wo
Wo
Wo
Wo
Wo
Wo
Nr
Gt
wm
oj
tk
wR
cO
gC
Wo
Wo
Wo
Wo
Wo
Wo
Wo
Wo
Wo
"}
(10,1,1) = {"
Wo
Wo
Wo
Wo
Wo
Wo
Wo
Wo
Gt
Gt
Oa
jh
tk
kS
zI
Gt
Wo
Wo
Wo
Wo
Wo
Wo
Wo
Wo
Wo
"}
(11,1,1) = {"
Wo
Wo
Wo
Wo
Wo
Wo
Wo
Wo
Gt
Vm
FI
LS
Zy
go
MJ
Gt
Gt
Wo
Wo
Wo
Wo
Wo
Wo
Wo
Wo
"}
(12,1,1) = {"
Wo
Wo
Wo
Wo
Wo
Wo
Wo
Wo
Gt
Zz
Oa
zQ
HU
eA
Xq
ui
Qk
Wo
Wo
Wo
Wo
Wo
Wo
Wo
Wo
"}
(13,1,1) = {"
Wo
Wo
Wo
Wo
Wo
Wo
Wo
Wo
Gt
Gy
NC
be
iZ
tA
hb
XL
Qk
Wo
Wo
Wo
Wo
Wo
Wo
Wo
Wo
"}
(14,1,1) = {"
Wo
Wo
Wo
Wo
Wo
Wo
Wo
Wo
Md
IX
vX
Lj
OR
Sp
YY
hk
Qk
Wo
Wo
Wo
Wo
Wo
Wo
Wo
Wo
"}
(15,1,1) = {"
Wo
Wo
Wo
Wo
Wo
Wo
Wo
Wo
Gt
LU
At
qG
Qr
oL
pP
tj
Qk
Wo
Wo
Wo
Wo
Wo
Wo
Wo
Wo
"}
(16,1,1) = {"
Wo
Wo
Wo
Wo
Wo
Wo
Wo
Wo
Md
Bw
VB
Lj
xC
pw
HK
kf
Qk
Wo
Wo
Wo
Wo
Wo
Wo
Wo
Wo
"}
(17,1,1) = {"
Wo
Wo
Wo
Wo
Wo
Wo
Wo
Wo
Gt
Gt
Jn
EE
hN
PY
nJ
lR
Qk
Wo
Wo
Wo
Wo
Wo
Wo
Wo
Wo
"}
(18,1,1) = {"
Wo
Wo
Wo
Wo
Wo
Wo
Wo
Wo
Nr
Gt
eL
uT
Qk
Qk
Qk
Qk
Qk
Wo
Wo
Wo
Wo
Wo
Wo
Wo
Wo
"}
(19,1,1) = {"
Wo
Wo
Wo
Wo
Wo
Wo
Wo
Wo
Nr
Md
os
vC
yQ
Md
Nr
CE
oN
Wo
Wo
Wo
Wo
Wo
Wo
Wo
Wo
"}
(20,1,1) = {"
Wo
Wo
Wo
Wo
Wo
Wo
Wo
Wo
Nr
Md
QP
QP
or
Md
Nr
gu
Nr
Wo
Wo
Wo
Wo
Wo
Wo
Wo
Wo
"}
(21,1,1) = {"
Wo
Wo
Wo
Wo
Wo
Wo
Wo
Wo
Nr
Md
Jt
Rf
Md
Md
Nr
Nr
Nr
Wo
Wo
Wo
Wo
Wo
Wo
Wo
Wo
"}
(22,1,1) = {"
Wo
Wo
Wo
Wo
Wo
Wo
Wo
Wo
Nr
Md
Md
Md
Md
Nr
Nr
Nr
Nr
Wo
Wo
Wo
Wo
Wo
Wo
Wo
Wo
"}
(23,1,1) = {"
Wo
Wo
Wo
Wo
Wo
Wo
Wo
Wo
Wo
Wo
Wo
Wo
Wo
Wo
Wo
Wo
Wo
Wo
Wo
Wo
Wo
Wo
Wo
Wo
Wo
"}
(24,1,1) = {"
Wo
Wo
Wo
Wo
Wo
Wo
Wo
Wo
Wo
Wo
Wo
Wo
Wo
Wo
Wo
Wo
Wo
Wo
Wo
Wo
Wo
Wo
Wo
Wo
Wo
"}
(25,1,1) = {"
Wo
Wo
Wo
Wo
Wo
Wo
Wo
Wo
Wo
Wo
Wo
Wo
Wo
Wo
Wo
Wo
Wo
Wo
Wo
Wo
Wo
Wo
Wo
Wo
Wo
"}
