//MAP CONVERTED BY dmm2tgm.py THIS HEADER COMMENT PREVENTS RECONVERSION, DO NOT REMOVE
"a" = (
/turf/template_noop,
/area/template_noop)
"d" = (
/obj/structure/fence/corner{
	dir = 4
	},
/turf/simulated/floor/outdoors/beach/sand/lowdesert,
/area/class_h/POIs/graveyard)
"e" = (
/obj/structure/closet/coffin,
/obj/item/clothing/gloves/ring/material/gold,
/obj/item/clothing/ears/earring/stud/silver,
/obj/item/clothing/ears/skrell/chain/bluejewels,
/obj/item/coin/gold,
/obj/item/coin/gold,
/obj/item/coin/gold,
/obj/item/bone/ribs,
/obj/item/bone/skull,
/obj/item/bone/arm,
/obj/item/bone/arm,
/obj/item/bone/leg,
/obj/item/bone/leg,
/turf/simulated/floor/wmarble,
/area/class_h/POIs/graveyard)
"i" = (
/obj/structure/fence/corner{
	dir = 1
	},
/turf/simulated/floor/outdoors/beach/sand/dirtlight,
/area/class_h/POIs/graveyard)
"j" = (
/obj/structure/fence/door/locked{
	dir = 8
	},
/turf/simulated/floor/outdoors/beach/sand/dirtlight,
/area/class_h/POIs/graveyard)
"k" = (
/obj/structure/fence/door/locked{
	dir = 1
	},
/turf/simulated/floor/outdoors/beach/sand/dirtlight,
/area/class_h/POIs/graveyard)
"l" = (
/obj/structure/fence/cut/large{
	dir = 8
	},
/turf/simulated/floor/outdoors/beach/sand/lowdesert,
/area/class_h/POIs/graveyard)
"n" = (
/obj/structure/simple_door/wood,
/turf/simulated/floor/wmarble,
/area/class_h/POIs/graveyard)
"s" = (
/turf/simulated/floor/outdoors/beach/sand/lowdesert,
/area/class_h/POIs/graveyard)
"v" = (
/obj/structure/fence/corner,
/turf/simulated/floor/outdoors/beach/sand/dirtlight,
/area/class_h/POIs/graveyard)
"y" = (
/obj/structure/closet/coffin,
/obj/item/clothing/gloves/ring/material/silver,
/obj/item/clothing/ears/earring/dangle/platinum,
/obj/item/clothing/ears/skrell/chain/redjewels,
/obj/item/coin/gold,
/obj/item/coin/gold,
/obj/item/coin/gold,
/obj/item/bone/ribs,
/obj/item/bone/skull,
/obj/item/bone/arm,
/obj/item/bone/arm,
/obj/item/bone/leg,
/obj/item/bone/leg,
/turf/simulated/floor/wmarble,
/area/class_h/POIs/graveyard)
"C" = (
/obj/structure/fence/corner{
	dir = 8
	},
/turf/simulated/floor/outdoors/beach/sand/lowdesert,
/area/class_h/POIs/graveyard)
"D" = (
/obj/item/material/gravemarker{
	material = MAT_WOOD
	},
/turf/simulated/floor/outdoors/beach/sand/dirtlight,
/area/class_h/POIs/graveyard)
"F" = (
/obj/item/flame/lighter/zippo/engraved,
/turf/simulated/floor/outdoors/beach/sand/dirtlight,
/area/class_h/POIs/graveyard)
"H" = (
/turf/simulated/wall/sandstone/classh,
/area/class_h/POIs/graveyard)
"K" = (
/obj/structure/fence{
	dir = 1
	},
/turf/simulated/floor/outdoors/beach/sand/dirtlight,
/area/class_h/POIs/graveyard)
"O" = (
/obj/structure/fence/cut/large{
	dir = 8
	},
/turf/simulated/floor/outdoors/beach/sand/dirtlight,
/area/class_h/POIs/graveyard)
"T" = (
/obj/item/shovel,
/turf/simulated/floor/outdoors/beach/sand/dirtlight,
/area/class_h/POIs/graveyard)
"U" = (
/obj/structure/fence{
	dir = 4
	},
/turf/simulated/floor/outdoors/beach/sand/dirtlight,
/area/class_h/POIs/graveyard)
"X" = (
/turf/simulated/floor/outdoors/beach/sand/dirtlight,
/area/class_h/POIs/graveyard)
"Y" = (
/obj/structure/fence{
	dir = 4
	},
/turf/simulated/floor/outdoors/beach/sand/lowdesert,
/area/class_h/POIs/graveyard)

(1,1,1) = {"
a
a
s
s
s
s
s
s
s
s
s
s
s
a
a
"}
(2,1,1) = {"
a
s
s
s
s
s
s
s
s
s
s
s
s
s
a
"}
(3,1,1) = {"
s
s
C
K
K
K
K
K
j
K
K
K
i
s
s
"}
(4,1,1) = {"
s
s
Y
H
H
H
X
D
X
D
X
D
U
s
s
"}
(5,1,1) = {"
s
s
Y
H
e
n
X
D
X
D
X
D
U
s
s
"}
(6,1,1) = {"
s
s
Y
H
H
H
X
D
X
D
X
D
O
s
s
"}
(7,1,1) = {"
s
s
Y
T
F
X
X
X
X
X
X
X
U
s
s
"}
(8,1,1) = {"
s
s
Y
H
H
H
X
D
D
D
D
X
k
s
s
"}
(9,1,1) = {"
s
s
Y
H
y
n
X
X
X
X
X
X
U
s
s
"}
(10,1,1) = {"
s
s
Y
H
H
H
X
D
X
D
X
D
U
s
s
"}
(11,1,1) = {"
s
s
l
X
X
X
X
D
X
D
X
D
U
s
s
"}
(12,1,1) = {"
s
s
Y
D
D
D
X
D
X
D
X
D
U
s
s
"}
(13,1,1) = {"
s
s
d
K
K
K
K
K
j
K
K
K
v
s
s
"}
(14,1,1) = {"
a
s
s
s
s
s
s
s
s
s
s
s
s
s
a
"}
(15,1,1) = {"
a
a
s
s
s
s
s
s
s
s
s
s
s
a
a
"}
