//MAP CONVERTED BY dmm2tgm.py THIS HEADER COMMENT PREVENTS RECONVERSION, DO NOT REMOVE
"aa" = (
/turf/simulated/wall,
/area/class_h/POIs/landing_pad)
"ab" = (
/obj/effect/debris/cleanable/dirt,
/obj/machinery/atmospherics/component/unary/vent_pump/high_volume,
/obj/machinery/light/small{
	dir = 1
	},
/turf/simulated/floor/tiled,
/area/class_h/POIs/landing_pad)
"ac" = (
/obj/effect/floor_decal/techfloor/orange{
	dir = 5
	},
/turf/simulated/floor/tiled/external,
/area/class_h/POIs/landing_pad)
"ad" = (
/obj/machinery/atmospherics/pipe/simple/hidden,
/obj/machinery/door/airlock/glass_external/public,
/turf/simulated/floor/tiled,
/area/class_h/POIs/landing_pad)
"ae" = (
/obj/effect/floor_decal/techfloor/orange{
	dir = 6
	},
/turf/simulated/floor/tiled/outdoors,
/area/class_h/POIs/landing_pad)
"af" = (
/obj/effect/floor_decal/techfloor/orange,
/turf/simulated/floor/tiled/outdoors,
/area/class_h/POIs/landing_pad)
"ag" = (
/obj/effect/floor_decal/rust,
/obj/machinery/atmospherics/pipe/manifold/hidden{
	dir = 4
	},
/obj/machinery/light/small{
	dir = 4
	},
/turf/simulated/floor/plating,
/area/class_h/POIs/landing_pad)
"ah" = (
/obj/effect/debris/cleanable/dirt,
/obj/structure/table/standard{
	name = "plastic table frame"
	},
/obj/machinery/microwave{
	pixel_y = 6
	},
/turf/simulated/floor/tiled,
/area/class_h/POIs/landing_pad)
"ai" = (
/obj/effect/debris/cleanable/dirt,
/obj/structure/loot_pile/surface/medicine_cabinet/fresh{
	pixel_y = -35
	},
/obj/structure/sink{
	pixel_y = 25
	},
/turf/simulated/floor/tiled/kafel_full,
/area/class_h/POIs/landing_pad)
"aj" = (
/obj/effect/floor_decal/techfloor/orange{
	dir = 6
	},
/turf/simulated/floor/tiled/external,
/area/class_h/POIs/landing_pad)
"ak" = (
/obj/effect/floor_decal/rust,
/obj/structure/closet/toolcloset,
/turf/simulated/floor/plating,
/area/class_h/POIs/landing_pad)
"al" = (
/obj/effect/floor_decal/techfloor/orange{
	dir = 9
	},
/turf/simulated/floor/tiled/external,
/area/class_h/POIs/landing_pad)
"am" = (
/obj/effect/wingrille_spawn/reinforced,
/turf/simulated/floor/tiled,
/area/class_h/POIs/landing_pad)
"an" = (
/turf/template_noop,
/area/template_noop)
"ao" = (
/obj/effect/debris/cleanable/dirt,
/obj/structure/bed/chair/comfy/black,
/turf/simulated/floor/tiled,
/area/class_h/POIs/landing_pad)
"ap" = (
/obj/effect/floor_decal/techfloor/orange{
	dir = 10
	},
/turf/simulated/floor/tiled/outdoors,
/area/class_h/POIs/landing_pad)
"aq" = (
/obj/effect/floor_decal/techfloor/orange{
	dir = 8
	},
/turf/simulated/floor/tiled/external,
/area/class_h/POIs/landing_pad)
"ar" = (
/turf/simulated/floor/tiled/external,
/area/class_h/POIs/landing_pad)
"as" = (
/obj/effect/debris/cleanable/dirt,
/obj/machinery/door/airlock/multi_tile,
/turf/simulated/floor/wood,
/area/class_h/POIs/landing_pad)
"at" = (
/obj/effect/debris/cleanable/dirt,
/obj/structure/table/rack,
/obj/item/clothing/mask/breath,
/obj/item/clothing/mask/breath,
/obj/item/tank/oxygen,
/obj/item/tank/oxygen,
/turf/simulated/floor/tiled,
/area/class_h/POIs/landing_pad)
"au" = (
/obj/effect/debris/cleanable/dirt,
/obj/structure/closet/cabinet,
/obj/item/clothing/under/color/grey,
/obj/item/clothing/under/color/grey,
/obj/item/clothing/under/color/grey,
/obj/item/clothing/shoes/black,
/obj/item/clothing/shoes/black,
/obj/item/clothing/shoes/black,
/obj/item/gun/ballistic/shotgun/pump/rifle,
/obj/item/ammo_magazine/clip/c762,
/obj/item/ammo_magazine/clip/c762,
/obj/item/ammo_magazine/clip/c762,
/turf/simulated/floor/wood,
/area/class_h/POIs/landing_pad)
"av" = (
/obj/effect/debris/cleanable/dirt,
/obj/machinery/door/airlock/multi_tile,
/turf/simulated/floor/tiled/kafel_full,
/area/class_h/POIs/landing_pad)
"aw" = (
/turf/simulated/floor/outdoors/beach/sand/lowdesert,
/area/class_h/POIs/landing_pad)
"ax" = (
/obj/effect/floor_decal/rust,
/obj/machinery/atmospherics/pipe/simple/hidden{
	dir = 6
	},
/turf/simulated/floor/plating,
/area/class_h/POIs/landing_pad)
"ay" = (
/turf/simulated/floor/tiled/outdoors,
/area/class_h/POIs/landing_pad)
"az" = (
/obj/effect/debris/cleanable/dirt,
/turf/simulated/floor/wood,
/area/class_h/POIs/landing_pad)
"aA" = (
/obj/effect/debris/cleanable/dirt,
/obj/machinery/atmospherics/pipe/manifold/hidden{
	dir = 8
	},
/turf/simulated/floor/tiled,
/area/class_h/POIs/landing_pad)
"aB" = (
/obj/effect/debris/cleanable/dirt,
/obj/machinery/atmospherics/component/unary/vent_pump/high_volume{
	dir = 8;
	frequency = 1379;
	id_tag = "rnd_s_airlock_pump"
	},
/turf/simulated/floor/tiled,
/area/class_h/POIs/landing_pad)
"aC" = (
/obj/effect/floor_decal/rust,
/obj/machinery/atmospherics/pipe/simple/hidden,
/turf/simulated/floor/plating,
/area/class_h/POIs/landing_pad)
"aD" = (
/obj/effect/debris/cleanable/dirt,
/obj/machinery/light/small{
	dir = 8
	},
/turf/simulated/floor/tiled,
/area/class_h/POIs/landing_pad)
"aE" = (
/obj/effect/floor_decal/techfloor/orange{
	dir = 4
	},
/turf/simulated/floor/tiled/external,
/area/class_h/POIs/landing_pad)
"aF" = (
/obj/effect/wingrille_spawn/reinforced,
/turf/simulated/wall,
/area/class_h/POIs/landing_pad)
"aG" = (
/obj/effect/debris/cleanable/dirt,
/obj/machinery/door/airlock,
/turf/simulated/floor/tiled/kafel_full,
/area/class_h/POIs/landing_pad)
"aH" = (
/obj/effect/debris/cleanable/dirt,
/obj/structure/closet/crate/freezer/rations,
/obj/item/storage/box/donkpockets,
/obj/item/storage/box/donkpockets,
/obj/item/storage/box/donkpockets,
/obj/item/reagent_containers/food/snacks/liquidvitamin,
/obj/item/reagent_containers/food/snacks/liquidvitamin,
/obj/item/reagent_containers/food/snacks/liquidvitamin,
/obj/item/reagent_containers/food/snacks/liquidprotein,
/obj/item/reagent_containers/food/snacks/liquidprotein,
/obj/item/reagent_containers/food/snacks/liquidprotein,
/obj/item/reagent_containers/food/snacks/liquidfood,
/obj/item/reagent_containers/food/snacks/liquidfood,
/obj/item/reagent_containers/food/snacks/liquidfood,
/turf/simulated/floor/tiled,
/area/class_h/POIs/landing_pad)
"aI" = (
/obj/effect/debris/cleanable/dirt,
/obj/machinery/suit_cycler/vintage,
/turf/simulated/floor/tiled,
/area/class_h/POIs/landing_pad)
"aJ" = (
/obj/effect/debris/cleanable/dirt,
/obj/structure/bed/chair/comfy/black{
	dir = 1
	},
/turf/simulated/floor/tiled,
/area/class_h/POIs/landing_pad)
"aK" = (
/obj/effect/debris/cleanable/dirt,
/obj/structure/curtain/open/shower,
/obj/machinery/shower{
	dir = 1
	},
/obj/machinery/light/small{
	dir = 8
	},
/turf/simulated/floor/tiled/kafel_full,
/area/class_h/POIs/landing_pad)
"aL" = (
/obj/effect/debris/cleanable/dirt,
/obj/machinery/atmospherics/pipe/simple/hidden,
/turf/simulated/floor/tiled,
/area/class_h/POIs/landing_pad)
"aM" = (
/obj/effect/floor_decal/techfloor/orange{
	dir = 10
	},
/turf/simulated/floor/tiled/external,
/area/class_h/POIs/landing_pad)
"aN" = (
/obj/machinery/door/airlock/glass_external/public,
/turf/simulated/floor/tiled,
/area/class_h/POIs/landing_pad)
"aO" = (
/obj/effect/floor_decal/techfloor/orange{
	dir = 8
	},
/turf/simulated/floor/tiled/outdoors,
/area/class_h/POIs/landing_pad)
"aP" = (
/obj/machinery/floodlight,
/turf/simulated/floor/outdoors/beach/sand/lowdesert,
/area/class_h/POIs/landing_pad)
"aQ" = (
/obj/effect/debris/cleanable/dirt,
/turf/simulated/floor/tiled,
/area/class_h/POIs/landing_pad)
"aR" = (
/obj/effect/floor_decal/techfloor/orange,
/turf/simulated/floor/tiled/external,
/area/class_h/POIs/landing_pad)
"aS" = (
/obj/effect/floor_decal/rust,
/obj/machinery/atmospherics/pipe/simple/hidden,
/obj/machinery/door/airlock/maintenance/common,
/turf/simulated/floor/plating,
/area/class_h/POIs/landing_pad)
"aT" = (
/obj/effect/debris/cleanable/dirt,
/obj/machinery/light/small{
	dir = 4
	},
/turf/simulated/floor/tiled,
/area/class_h/POIs/landing_pad)
"aU" = (
/obj/effect/floor_decal/techfloor/orange{
	dir = 1
	},
/turf/simulated/floor/tiled/external,
/area/class_h/POIs/landing_pad)
"aV" = (
/obj/machinery/light/spot{
	dir = 8
	},
/turf/simulated/floor/outdoors/beach/sand/lowdesert,
/area/class_h/POIs/landing_pad)
"aW" = (
/obj/effect/floor_decal/rust,
/obj/machinery/atmospherics/portables_connector{
	dir = 1
	},
/obj/machinery/portable_atmospherics/canister/air/airlock,
/turf/simulated/floor/plating,
/area/class_h/POIs/landing_pad)
"aX" = (
/obj/effect/debris/cleanable/dirt,
/obj/structure/table/standard{
	name = "plastic table frame"
	},
/obj/item/paper{
	info = "\[center]\[b] Greetings Brave Frontiersman \[/center]\[/b]\[br] Congratulations on your purchase of the \[i]Hephaestus Industries: Expedient Frontier Homestead\[/i]. Whether you are a private citizen buying just one or a government buying millions, we here at \[i]Hephaestus Industries\[/i] are happy to serve you in your missions to tame even the most remote regions of space. The model you are currently standing in is the \[i]Lone Frontiersmen\[/i] perfect for both those seeking a solitary exsistance among the stars and for groups looking to break ground on untamed worlds. \[br] This model's freatures include: \[br] \[list]\[*] Radioscoptic Power Capable of keeping the lights on for Centuries. \[*]A Small Landing Pad to that your personnel spacecraft has a easy place to land. \[*]A small kitchen containing rations that will last you months; plenty of time to secure food sources on an alien world. \[*]A bedroom with complimentary jumpsuits and spacious double bed. \[*]A full bathroom, with shower and sink. All liquids used are recycled so you will never run out. \[*] A simple robust rifle capable of firing in space with 20 rounds of ammunition. Perfect for keeping those carp at bay.\[*] 2 space suits and a hardsuit cycler are included with your purchase. \[/list]\[br] We once again congratulate you on your purchase and wish you luck on your quest to conquer the stars. Until we meet again this is \[i]Hephaestus Industries\[/i].";
	name = "Dusty Flier"
	},
/turf/simulated/floor/tiled,
/area/class_h/POIs/landing_pad)
"aY" = (
/obj/effect/debris/cleanable/dirt,
/obj/structure/table/rack,
/obj/item/clothing/suit/space,
/obj/item/clothing/head/helmet/space,
/obj/item/clothing/head/helmet/space,
/obj/item/clothing/suit/space,
/turf/simulated/floor/tiled,
/area/class_h/POIs/landing_pad)
"aZ" = (
/obj/effect/debris/cleanable/dirt,
/obj/structure/bed/double,
/obj/item/bedsheet/bluedouble,
/obj/machinery/light/small{
	dir = 4
	},
/turf/simulated/floor/wood,
/area/class_h/POIs/landing_pad)
"Cp" = (
/obj/effect/floor_decal/techfloor/orange{
	dir = 9
	},
/turf/simulated/floor/tiled/outdoors,
/area/class_h/POIs/landing_pad)
"FP" = (
/obj/effect/floor_decal/techfloor/orange{
	dir = 5
	},
/turf/simulated/floor/tiled/outdoors,
/area/class_h/POIs/landing_pad)
"PP" = (
/obj/effect/floor_decal/techfloor/orange{
	dir = 4
	},
/turf/simulated/floor/tiled/outdoors,
/area/class_h/POIs/landing_pad)
"SW" = (
/obj/effect/floor_decal/techfloor/orange{
	dir = 1
	},
/turf/simulated/floor/tiled/outdoors,
/area/class_h/POIs/landing_pad)
"Za" = (
/obj/effect/debris/cleanable/dirt,
/obj/machinery/door/airlock,
/turf/simulated/floor/wood,
/area/class_h/POIs/landing_pad)

(1,1,1) = {"
an
an
an
an
aa
aa
aa
aa
aa
aa
aa
aa
aa
aa
aa
"}
(2,1,1) = {"
an
aa
aa
aa
aa
aY
aI
at
aa
ak
ax
aW
aa
aK
aa
"}
(3,1,1) = {"
an
aa
ab
aA
ad
aL
aL
aL
aS
aC
ag
aW
aa
ai
aa
"}
(4,1,1) = {"
an
aa
aQ
aB
aN
aT
aQ
aQ
aa
aa
aa
aa
aa
aG
aa
"}
(5,1,1) = {"
an
aa
aN
aN
aa
aa
aQ
aQ
aQ
aD
aQ
Za
az
az
aa
"}
(6,1,1) = {"
an
aw
ay
ay
aw
aF
ah
aH
ao
aX
aJ
aa
au
aZ
aa
"}
(7,1,1) = {"
an
aw
ay
ay
aw
aa
am
am
am
am
aa
aa
aa
aa
aa
"}
(8,1,1) = {"
an
aP
ay
ay
aw
aV
aw
aw
aw
aw
aV
aw
aw
aw
an
"}
(9,1,1) = {"
an
Cp
aO
aO
aO
aO
aO
aO
aO
aO
aO
aO
aO
ap
an
"}
(10,1,1) = {"
an
SW
ay
ay
ay
ay
ay
ay
ay
ay
ay
ay
ay
af
an
"}
(11,1,1) = {"
an
SW
ay
ay
ay
ay
ay
ay
ay
ay
ay
ay
ay
af
an
"}
(12,1,1) = {"
an
SW
ay
ay
ay
ay
ay
ay
ay
ay
ay
ay
ay
af
an
"}
(13,1,1) = {"
an
SW
ay
ay
ay
ay
ay
ay
ay
ay
ay
ay
ay
af
an
"}
(14,1,1) = {"
an
SW
ay
ay
ay
ay
ay
ay
ay
ay
ay
ay
ay
af
an
"}
(15,1,1) = {"
an
FP
PP
PP
PP
PP
PP
PP
PP
PP
PP
PP
PP
ae
an
"}
