//MAP CONVERTED BY dmm2tgm.py THIS HEADER COMMENT PREVENTS RECONVERSION, DO NOT REMOVE
"a" = (
/turf/simulated/floor/tiled/asteroid_steel,
/area/sector/miaphus/beach/desert/poi/refinery)
"b" = (
/obj/structure/fence{
	dir = 8
	},
/turf/simulated/floor/outdoors/beach/sand/lowdesert,
/area/sector/miaphus/beach/desert/poi/refinery)
"d" = (
/obj/structure/sink/oil_well,
/turf/simulated/floor/outdoors/beach/sand/lowdesert,
/area/sector/miaphus/beach/desert/poi/refinery)
"e" = (
/turf/simulated/wall,
/area/sector/miaphus/beach/desert/poi/refinery)
"f" = (
/obj/structure/reagent_dispensers/fueltank/barrel,
/obj/machinery/light/small{
	dir = 4
	},
/turf/simulated/floor/tiled/asteroid_steel,
/area/sector/miaphus/beach/desert/poi/refinery)
"g" = (
/obj/machinery/conveyor,
/obj/structure/reagent_dispensers/fueltank/barrel,
/obj/machinery/light/small{
	dir = 4
	},
/turf/simulated/floor/tiled/asteroid_steel,
/area/sector/miaphus/beach/desert/poi/refinery)
"h" = (
/obj/structure/fence{
	dir = 1
	},
/turf/simulated/floor/outdoors/beach/sand/lowdesert,
/area/sector/miaphus/beach/desert/poi/refinery)
"i" = (
/obj/structure/fence/door/locked{
	dir = 4
	},
/turf/simulated/floor/tiled/asteroid_steel{
	outdoors = 1
	},
/area/sector/miaphus/beach/desert/poi/refinery)
"j" = (
/turf/simulated/floor/tiled/asteroid_steel{
	outdoors = 1
	},
/area/sector/miaphus/beach/desert/poi/refinery)
"k" = (
/obj/machinery/conveyor,
/obj/structure/reagent_dispensers/fueltank/barrel,
/turf/simulated/floor/tiled/asteroid_steel,
/area/sector/miaphus/beach/desert/poi/refinery)
"m" = (
/obj/machinery/conveyor{
	dir = 4
	},
/obj/structure/reagent_dispensers/fueltank/barrel,
/turf/simulated/floor/tiled/asteroid_steel,
/area/sector/miaphus/beach/desert/poi/refinery)
"n" = (
/obj/machinery/conveyor{
	dir = 9
	},
/obj/structure/reagent_dispensers/fueltank/barrel,
/turf/simulated/floor/tiled/asteroid_steel,
/area/sector/miaphus/beach/desert/poi/refinery)
"q" = (
/obj/structure/fence/door,
/turf/simulated/floor/tiled/asteroid_steel{
	outdoors = 1
	},
/area/sector/miaphus/beach/desert/poi/refinery)
"r" = (
/turf/simulated/floor/outdoors/beach/sand/lowdesert,
/area/sector/miaphus/beach/desert/poi/refinery)
"u" = (
/obj/item/storage/box/pillbottles,
/obj/item/storage/box/syringes,
/obj/item/radio/headset/headset_med,
/obj/item/storage/box/pillbottles,
/obj/item/storage/fancy/vials,
/obj/item/storage/fancy/vials,
/obj/structure/window/reinforced{
	dir = 4
	},
/obj/structure/closet/wardrobe/chemistry_white,
/turf/simulated/floor/tiled/asteroid_steel,
/area/sector/miaphus/beach/desert/poi/refinery)
"x" = (
/obj/machinery/conveyor,
/turf/simulated/floor/tiled/asteroid_steel,
/area/sector/miaphus/beach/desert/poi/refinery)
"y" = (
/obj/structure/window/reinforced{
	dir = 1
	},
/turf/simulated/floor/tiled/asteroid_steel,
/area/sector/miaphus/beach/desert/poi/refinery)
"z" = (
/obj/machinery/light/flamp/noshade,
/turf/simulated/floor/outdoors/beach/sand/lowdesert,
/area/sector/miaphus/beach/desert/poi/refinery)
"A" = (
/turf/simulated/floor/outdoors/beach/sand/lowdesert,
/area/template_noop)
"B" = (
/obj/machinery/door/airlock/maintenance/engi{
	req_one_access = null
	},
/obj/effect/debris/cleanable/liquid_fuel,
/turf/simulated/floor/tiled/asteroid_steel,
/area/sector/miaphus/beach/desert/poi/refinery)
"C" = (
/obj/structure/fence/corner{
	dir = 9
	},
/turf/simulated/floor/outdoors/beach/sand/lowdesert,
/area/sector/miaphus/beach/desert/poi/refinery)
"E" = (
/obj/machinery/chemical_analyzer,
/obj/structure/window/reinforced{
	dir = 4
	},
/obj/structure/window/reinforced{
	dir = 1
	},
/turf/simulated/floor/tiled/asteroid_steel,
/area/sector/miaphus/beach/desert/poi/refinery)
"F" = (
/obj/structure/fence/corner{
	dir = 10
	},
/turf/simulated/floor/outdoors/beach/sand/lowdesert,
/area/sector/miaphus/beach/desert/poi/refinery)
"I" = (
/turf/template_noop,
/area/template_noop)
"K" = (
/obj/structure/window/reinforced{
	dir = 4
	},
/obj/structure/table/rack/shelf,
/obj/item/reagent_containers/portable_fuelcan,
/obj/item/reagent_containers/portable_fuelcan,
/obj/item/reagent_containers/portable_fuelcan,
/turf/simulated/floor/tiled/asteroid_steel,
/area/sector/miaphus/beach/desert/poi/refinery)
"S" = (
/obj/machinery/light/small{
	dir = 8
	},
/turf/simulated/floor/tiled/asteroid_steel,
/area/sector/miaphus/beach/desert/poi/refinery)
"X" = (
/obj/machinery/conveyor{
	dir = 4
	},
/turf/simulated/floor/tiled/asteroid_steel,
/area/sector/miaphus/beach/desert/poi/refinery)
"Y" = (
/obj/machinery/chem_master,
/obj/structure/window/reinforced{
	dir = 4
	},
/turf/simulated/floor/tiled/asteroid_steel,
/area/sector/miaphus/beach/desert/poi/refinery)
"Z" = (
/obj/structure/reagent_dispensers/fueltank/barrel,
/turf/simulated/floor/tiled/asteroid_steel,
/area/sector/miaphus/beach/desert/poi/refinery)

(1,1,1) = {"
I
I
I
I
A
I
A
A
A
I
I
I
I
I
I
"}
(2,1,1) = {"
I
I
A
C
h
h
h
i
h
h
h
F
A
I
I
"}
(3,1,1) = {"
I
I
A
b
z
d
r
j
r
d
z
b
A
I
I
"}
(4,1,1) = {"
I
I
A
b
r
r
r
j
r
r
r
b
A
A
I
"}
(5,1,1) = {"
I
I
A
q
j
j
j
j
j
j
j
q
A
A
I
"}
(6,1,1) = {"
I
A
A
b
r
j
r
r
r
j
r
b
A
A
I
"}
(7,1,1) = {"
I
A
A
b
d
j
r
d
r
j
d
b
A
I
I
"}
(8,1,1) = {"
I
A
A
e
e
B
e
e
e
B
e
e
A
I
I
"}
(9,1,1) = {"
I
A
A
e
a
a
S
a
S
a
a
e
A
A
I
"}
(10,1,1) = {"
I
A
A
e
X
y
a
a
a
a
a
e
A
I
I
"}
(11,1,1) = {"
I
I
A
e
m
E
Y
K
u
Z
Z
e
A
I
I
"}
(12,1,1) = {"
I
I
A
e
n
g
k
k
x
f
Z
e
A
A
I
"}
(13,1,1) = {"
I
I
I
e
e
e
e
e
e
e
e
e
A
I
I
"}
(14,1,1) = {"
I
I
I
A
A
A
A
I
I
A
A
A
A
I
I
"}
(15,1,1) = {"
I
I
I
I
I
I
I
I
I
I
A
I
I
I
I
"}
