//MAP CONVERTED BY dmm2tgm.py THIS HEADER COMMENT PREVENTS RECONVERSION, DO NOT REMOVE
"a" = (
/obj/structure/sandbag,
/turf/simulated/floor/tiled/asteroid_steel,
/area/sector/miaphus/beach/desert/poi/turretnest)
"c" = (
/obj/structure/closet/crate/freezer/rations,
/turf/simulated/floor/tiled/asteroid_steel,
/area/sector/miaphus/beach/desert/poi/turretnest)
"e" = (
/obj/machinery/porta_turret/stationary/syndie,
/turf/simulated/floor/tiled/asteroid_steel,
/area/sector/miaphus/beach/desert/poi/turretnest)
"i" = (
/turf/simulated/floor/outdoors/beach/sand/lowdesert,
/area/sector/miaphus/beach/desert/poi/turretnest)
"k" = (
/turf/simulated/floor/outdoors/beach/sand/lowdesert,
/area/template_noop)
"p" = (
/turf/simulated/floor/tiled/asteroid_steel,
/area/sector/miaphus/beach/desert/poi/turretnest)
"s" = (
/obj/machinery/door/airlock/maintenance/engi{
	req_one_access = null
	},
/obj/effect/debris/cleanable/liquid_fuel,
/turf/simulated/floor/tiled/asteroid_steel,
/area/sector/miaphus/beach/desert/poi/turretnest)
"u" = (
/turf/simulated/wall/dungeon,
/area/sector/miaphus/beach/desert/poi/turretnest)
"A" = (
/turf/simulated/mineral/ignore_mapgen,
/area/sector/miaphus/beach/desert/poi/turretnest)
"I" = (
/obj/structure/table/rack/shelf/steel,
/obj/random/multiple/gun/projectile/handgun,
/obj/random/firstaid,
/turf/simulated/floor/tiled/asteroid_steel,
/area/sector/miaphus/beach/desert/poi/turretnest)
"N" = (
/obj/machinery/power/rtg/fake_gen,
/turf/simulated/floor/tiled/asteroid_steel,
/area/sector/miaphus/beach/desert/poi/turretnest)
"O" = (
/turf/simulated/mineral/ignore_mapgen,
/area/template_noop)
"V" = (
/turf/template_noop,
/area/template_noop)
"W" = (
/obj/structure/table/rack/shelf/steel,
/obj/random/multiple/gun/projectile/rifle,
/obj/random/firstaid,
/turf/simulated/floor/tiled/asteroid_steel,
/area/sector/miaphus/beach/desert/poi/turretnest)
"Z" = (
/turf/simulated/wall,
/area/sector/miaphus/beach/desert/poi/turretnest)

(1,1,1) = {"
V
V
V
V
V
V
V
V
V
V
V
V
V
V
V
V
V
V
V
V
"}
(2,1,1) = {"
V
k
k
O
O
O
O
V
V
k
k
k
k
k
k
k
k
V
V
V
"}
(3,1,1) = {"
V
k
O
O
O
O
O
k
k
k
k
O
O
O
O
O
k
k
V
V
"}
(4,1,1) = {"
V
O
O
A
A
i
i
i
i
A
A
O
O
O
O
O
O
k
V
V
"}
(5,1,1) = {"
V
O
O
A
i
i
i
i
i
A
A
u
u
u
u
u
O
O
k
V
"}
(6,1,1) = {"
V
O
O
A
i
i
A
A
A
A
A
u
N
p
W
u
O
O
k
V
"}
(7,1,1) = {"
V
k
O
A
i
i
A
Z
Z
Z
A
u
c
p
I
u
O
O
k
V
"}
(8,1,1) = {"
V
k
O
A
i
i
i
a
p
Z
Z
u
u
s
u
u
O
k
k
V
"}
(9,1,1) = {"
V
k
O
A
i
i
i
a
a
Z
Z
e
a
i
A
A
O
k
V
V
"}
(10,1,1) = {"
V
k
O
A
i
i
i
i
i
Z
Z
a
a
i
A
A
O
k
V
V
"}
(11,1,1) = {"
V
O
O
Z
a
a
Z
i
i
i
i
i
i
i
A
A
A
k
V
V
"}
(12,1,1) = {"
V
O
O
Z
e
p
Z
i
i
i
A
i
i
i
A
A
i
k
V
V
"}
(13,1,1) = {"
V
O
O
Z
Z
Z
Z
i
i
i
A
A
A
i
i
i
i
k
O
V
"}
(14,1,1) = {"
V
O
O
A
A
A
A
i
i
i
A
A
Z
a
a
i
i
O
O
V
"}
(15,1,1) = {"
V
k
O
O
O
k
i
i
a
a
Z
A
Z
e
a
i
A
O
O
V
"}
(16,1,1) = {"
V
k
O
O
k
k
i
i
a
e
Z
A
Z
Z
Z
i
A
O
O
V
"}
(17,1,1) = {"
V
V
O
O
k
k
A
A
Z
Z
Z
O
O
O
O
O
O
O
V
V
"}
(18,1,1) = {"
V
V
V
O
k
k
O
O
O
O
O
O
O
O
O
O
O
V
V
V
"}
(19,1,1) = {"
V
V
V
V
k
k
O
O
k
k
k
k
V
V
V
V
V
V
V
V
"}
(20,1,1) = {"
V
V
V
V
V
V
V
V
V
V
V
V
V
V
V
V
V
V
V
V
"}
