//MAP CONVERTED BY dmm2tgm.py THIS HEADER COMMENT PREVENTS RECONVERSION, DO NOT REMOVE
"a" = (
/turf/simulated/mineral/ignore_mapgen,
/area/sector/miaphus/beach/desert/poi/wastedump)
"d" = (
/obj/structure/fence{
	dir = 8
	},
/turf/simulated/mineral/floor/cave,
/area/sector/miaphus/beach/desert/poi/wastedump)
"e" = (
/obj/effect/debris/cleanable/greenglow,
/obj/structure/closet/crate/trashcart,
/obj/item/fuelrod/plutonium,
/obj/item/fuelrod/plutonium,
/obj/item/fuelrod/plutonium,
/obj/item/fuelrod/plutonium,
/turf/simulated/mineral/floor/cave,
/area/sector/miaphus/beach/desert/poi/wastedump)
"f" = (
/obj/random/junk,
/turf/simulated/mineral/floor/cave,
/area/sector/miaphus/beach/desert/poi/wastedump)
"k" = (
/obj/effect/map_effect/radiation_emitter/strong,
/turf/simulated/mineral/floor/cave,
/area/sector/miaphus/beach/desert/poi/wastedump)
"l" = (
/obj/structure/fence/cut/large{
	dir = 4
	},
/turf/simulated/mineral/floor/cave,
/area/sector/miaphus/beach/desert/poi/wastedump)
"n" = (
/obj/structure/sign/signnew/radiation,
/turf/simulated/wall/dungeon,
/area/sector/miaphus/beach/desert/poi/wastedump)
"o" = (
/turf/simulated/floor/outdoors/beach/sand/lowdesert,
/area/template_noop)
"p" = (
/turf/template_noop,
/area/template_noop)
"q" = (
/obj/structure/reagent_dispensers/fueltank/barrel,
/obj/effect/debris/cleanable/greenglow,
/turf/simulated/mineral/floor/cave,
/area/sector/miaphus/beach/desert/poi/wastedump)
"s" = (
/turf/simulated/wall/dungeon,
/area/sector/miaphus/beach/desert/poi/wastedump)
"t" = (
/obj/random/junk,
/obj/structure/closet/crate/trashcart,
/obj/item/fuelrod/uranium,
/obj/item/fuelrod/uranium,
/obj/item/fuelrod/uranium,
/obj/item/fuelrod/uranium,
/turf/simulated/mineral/floor/cave,
/area/sector/miaphus/beach/desert/poi/wastedump)
"u" = (
/turf/simulated/mineral/floor/cave,
/area/sector/miaphus/beach/desert/poi/wastedump)
"v" = (
/obj/structure/loot_pile/maint/junk,
/turf/simulated/mineral/floor/cave,
/area/sector/miaphus/beach/desert/poi/wastedump)
"x" = (
/obj/structure/sign/signnew/oxidants,
/turf/simulated/wall/dungeon,
/area/sector/miaphus/beach/desert/poi/wastedump)
"A" = (
/obj/structure/loot_pile/maint/junk,
/obj/random/junk,
/turf/simulated/mineral/floor/cave,
/area/sector/miaphus/beach/desert/poi/wastedump)
"B" = (
/obj/structure/reagent_dispensers/fueltank/barrel,
/turf/simulated/mineral/floor/cave,
/area/sector/miaphus/beach/desert/poi/wastedump)
"E" = (
/obj/structure/loot_pile/maint/junk,
/obj/effect/debris/cleanable/greenglow,
/turf/simulated/mineral/floor/cave,
/area/sector/miaphus/beach/desert/poi/wastedump)
"J" = (
/obj/item/fuelrod/plutonium,
/turf/simulated/mineral/floor/cave,
/area/sector/miaphus/beach/desert/poi/wastedump)
"K" = (
/obj/structure/fence/door/locked,
/turf/simulated/mineral/floor/cave,
/area/sector/miaphus/beach/desert/poi/wastedump)
"N" = (
/obj/structure/reagent_dispensers/fueltank/barrel,
/obj/effect/map_effect/radiation_emitter/strong,
/turf/simulated/mineral/floor/cave,
/area/sector/miaphus/beach/desert/poi/wastedump)
"Q" = (
/obj/effect/debris/cleanable/greenglow,
/obj/structure/closet/crate/trashcart,
/obj/item/fuelrod/uranium,
/obj/item/fuelrod/uranium,
/obj/item/fuelrod/uranium,
/obj/item/fuelrod/uranium,
/turf/simulated/mineral/floor/cave,
/area/sector/miaphus/beach/desert/poi/wastedump)
"U" = (
/obj/effect/debris/cleanable/greenglow,
/turf/simulated/mineral/floor/cave,
/area/sector/miaphus/beach/desert/poi/wastedump)
"W" = (
/obj/effect/map_effect/radiation_emitter,
/turf/simulated/mineral/floor/cave,
/area/sector/miaphus/beach/desert/poi/wastedump)
"X" = (
/turf/simulated/floor/outdoors/beach/sand/lowdesert,
/area/sector/miaphus/beach/desert/poi/wastedump)
"Y" = (
/obj/item/fuelrod/uranium,
/turf/simulated/mineral/floor/cave,
/area/sector/miaphus/beach/desert/poi/wastedump)

(1,1,1) = {"
p
p
o
o
o
o
o
o
o
o
o
o
p
p
p
"}
(2,1,1) = {"
p
o
o
o
a
a
a
a
a
a
a
o
o
p
p
"}
(3,1,1) = {"
p
o
a
a
a
a
a
a
a
a
a
a
o
o
p
"}
(4,1,1) = {"
o
o
a
a
a
a
a
a
a
a
a
a
a
o
p
"}
(5,1,1) = {"
o
a
a
a
a
a
t
v
q
a
a
a
a
o
o
"}
(6,1,1) = {"
o
n
s
a
E
N
u
U
u
A
a
a
a
a
o
"}
(7,1,1) = {"
o
X
d
u
u
U
f
J
W
u
v
a
a
a
o
"}
(8,1,1) = {"
o
X
K
u
u
U
u
u
f
U
B
a
a
a
o
"}
(9,1,1) = {"
o
X
l
U
f
u
u
U
u
u
e
a
a
a
o
"}
(10,1,1) = {"
o
x
s
a
U
W
Y
u
v
k
f
a
a
a
o
"}
(11,1,1) = {"
o
a
a
a
a
v
B
f
Q
B
a
a
a
a
o
"}
(12,1,1) = {"
o
o
a
a
a
a
a
a
a
a
a
a
a
o
o
"}
(13,1,1) = {"
p
o
a
a
a
a
a
a
a
a
a
a
a
o
p
"}
(14,1,1) = {"
p
o
o
a
a
a
a
a
a
a
a
a
o
o
p
"}
(15,1,1) = {"
p
p
o
o
o
o
o
o
o
o
o
o
o
p
p
"}
