//MAP CONVERTED BY dmm2tgm.py THIS HEADER COMMENT PREVENTS RECONVERSION, DO NOT REMOVE
"a" = (
/turf/space/basic,
/area/space)
"b" = (
/obj/machinery/atmospherics/pipe/simple/hidden,
/turf/simulated/wall/prepainted/science,
/area/space)
"c" = (
/obj/effect/floor_decal/techfloor{
	dir = 1
	},
/obj/machinery/computer/ship/sensors,
/obj/structure/railing/grey,
/obj/machinery/power/apc/alarms_hidden/north_mount{
	req_access = null
	},
/obj/structure/cable/green{
	icon_state = "0-2"
	},
/obj/machinery/light{
	dir = 1
	},
/turf/simulated/floor/tiled/monodark,
/area/space)
"d" = (
/turf/simulated/wall/prepainted/science,
/area/space)
"e" = (
/obj/spawner/window/borosillicate/full/firelocks,
/obj/machinery/atmospherics/pipe/simple/hidden/green{
	dir = 4
	},
/turf/simulated/floor/tiled/techfloor/grid,
/area/space)
"g" = (
/obj/effect/floor_decal/rust,
/obj/structure/cable/green{
	icon_state = "4-8"
	},
/obj/structure/bed/chair/bay/chair/padded/red/smallnest,
/obj/machinery/atmospherics/pipe/simple/hidden/green{
	dir = 10
	},
/obj/machinery/holopad/ship,
/obj/landmark/spawnpoint/auto_shuttle_start,
/turf/simulated/floor/tiled/techfloor/grid,
/area/space)
"h" = (
/obj/machinery/atmospherics/portables_connector,
/obj/machinery/portable_atmospherics/canister/phoron,
/turf/simulated/floor/tiled/techfloor/grid,
/area/space)
"j" = (
/obj/structure/shuttle/engine/heater{
	dir = 4
	},
/obj/machinery/atmospherics/pipe/simple/hidden{
	dir = 4
	},
/turf/simulated/wall/rshull,
/area/space)
"k" = (
/obj/overmap/entity/visitable/ship/landable/trade/runabout,
/obj/structure/cable/green{
	icon_state = "4-8"
	},
/turf/simulated/floor/tiled/techfloor,
/area/space)
"m" = (
/obj/machinery/telecomms/relay/preset/telecomms,
/turf/simulated/floor/tiled/techfloor/grid,
/area/space)
"o" = (
/obj/machinery/atmospherics/pipe/simple/hidden/green{
	dir = 4
	},
/turf/simulated/wall/rshull,
/area/space)
"p" = (
/obj/structure/cable/green{
	icon_state = "1-4"
	},
/obj/structure/bed/chair/bay/chair/padded/red/smallnest,
/obj/machinery/atmospherics/valve{
	dir = 4
	},
/obj/landmark/spawnpoint/auto_shuttle_start,
/turf/simulated/floor/tiled/techfloor/grid,
/area/space)
"q" = (
/obj/machinery/atmospherics/pipe/simple/hidden{
	dir = 6
	},
/turf/simulated/wall/prepainted/science,
/area/space)
"r" = (
/obj/effect/floor_decal/rust,
/obj/structure/bed/chair/bay/chair/padded/red/smallnest,
/obj/machinery/atmospherics/component/unary/vent_pump/on{
	dir = 4
	},
/turf/simulated/floor/tiled/techfloor/grid,
/area/space)
"s" = (
/obj/spawner/window/borosillicate/full/firelocks,
/turf/simulated/floor/reinforced,
/area/space)
"u" = (
/obj/effect/floor_decal/techfloor{
	dir = 1
	},
/obj/machinery/computer/ship/engines,
/obj/structure/railing/grey,
/obj/machinery/air_alarm/alarms_hidden/north_mount{
	req_one_access = null
	},
/turf/simulated/floor/tiled/monodark,
/area/space)
"w" = (
/obj/machinery/shipsensors,
/turf/simulated/floor/tiled/techfloor/grid,
/area/space)
"x" = (
/obj/machinery/atmospherics/pipe/simple/hidden/green{
	dir = 4
	},
/obj/machinery/atmospherics/pipe/simple/hidden,
/turf/simulated/wall/prepainted/science,
/area/space)
"y" = (
/obj/effect/floor_decal/techfloor{
	dir = 1
	},
/obj/machinery/computer/ship/helm{
	dir = 1;
	req_one_access = null
	},
/obj/structure/railing/grey{
	dir = 1
	},
/obj/structure/panic_button{
	pixel_y = -28
	},
/obj/machinery/light,
/turf/simulated/floor/tiled/monodark,
/area/space)
"z" = (
/obj/machinery/atmospherics/pipe/simple/hidden{
	dir = 9
	},
/obj/machinery/power/terminal,
/obj/structure/cable/orange{
	dir = 8
	},
/turf/simulated/floor/tiled/techfloor/grid,
/area/space)
"E" = (
/obj/structure/closet/walllocker_double/north,
/obj/structure/cable/green{
	icon_state = "4-8"
	},
/obj/machinery/atmospherics/pipe/manifold/hidden{
	dir = 8
	},
/obj/structure/shuttle_fuel_port{
	dir = 4;
	pixel_y = -32
	},
/turf/simulated/floor/tiled/techfloor,
/area/space)
"F" = (
/obj/machinery/atmospherics/pipe/simple/hidden{
	dir = 5
	},
/turf/simulated/wall/prepainted/science,
/area/space)
"H" = (
/obj/effect/floor_decal/rust,
/obj/machinery/atmospherics/portables_connector{
	dir = 8
	},
/obj/machinery/portable_atmospherics/canister/air/airlock,
/obj/structure/cable/green{
	icon_state = "1-4"
	},
/obj/machinery/light,
/turf/simulated/floor/tiled/techfloor/grid,
/area/space)
"I" = (
/obj/spawner/window/borosillicate/full/firelocks,
/turf/simulated/floor/tiled/techfloor/grid,
/area/space)
"K" = (
/obj/effect/floor_decal/rust,
/obj/structure/cable/green{
	icon_state = "4-8"
	},
/obj/machinery/door/airlock/silver,
/turf/simulated/floor/tiled/techfloor,
/area/space)
"L" = (
/obj/effect/floor_decal/techfloor{
	dir = 1
	},
/obj/machinery/computer/shuttle_control{
	dir = 1
	},
/obj/item/gps/internal/base{
	name = "Runabout Beacon";
	gps_tag = "RUNABOUT"
	},
/obj/structure/railing/grey{
	dir = 1
	},
/obj/machinery/atmospherics/pipe/simple/hidden/green{
	dir = 5
	},
/turf/simulated/floor/tiled/monodark,
/area/space)
"M" = (
/obj/machinery/power/smes/buildable{
	charge = 1.5e+007;
	cur_coils = 3
	},
/obj/structure/cable/green{
	icon_state = "0-8"
	},
/turf/simulated/floor/tiled/techfloor/grid,
/area/space)
"O" = (
/obj/machinery/atmospherics/pipe/manifold/hidden{
	dir = 1
	},
/turf/simulated/wall/prepainted/science,
/area/space)
"P" = (
/turf/simulated/floor/reinforced,
/area/space)
"R" = (
/turf/simulated/wall/rshull,
/area/space)
"U" = (
/obj/machinery/atmospherics/portables_connector,
/obj/machinery/portable_atmospherics/canister/phoron,
/obj/machinery/light{
	dir = 1
	},
/turf/simulated/floor/tiled/techfloor/grid,
/area/space)
"V" = (
/obj/effect/floor_decal/rust,
/obj/machinery/atmospherics/pipe/manifold/hidden,
/obj/structure/cable/green{
	icon_state = "2-8"
	},
/turf/simulated/floor/tiled/techfloor/grid,
/area/space)
"W" = (
/obj/machinery/atmospherics/component/unary/engine{
	dir = 8
	},
/turf/simulated/shuttle/plating/airless/carry,
/area/space)
"Y" = (
/obj/machinery/button/remote/blast_door{
	id = "Runabout'";
	name = "Runabout Door";
	pixel_y = 29
	},
/obj/machinery/door/airlock/hatch{
	name = "Runabout airtight Hatch";
	req_one_access = null
	},
/obj/structure/cable/orange{
	icon_state = "4-8"
	},
/obj/machinery/door/blast/regular{
	density = 0;
	id = "Runabout'";
	name = "Teshari Runabout Airlock";
	opacity = 0
	},
/obj/structure/fans/tiny,
/turf/simulated/floor/tiled/techfloor,
/area/space)
"Z" = (
/obj/machinery/atmospherics/pipe/manifold/hidden,
/turf/simulated/wall/prepainted/science,
/area/space)

(1,1,1) = {"
a
a
a
a
a
a
a
a
a
a
a
a
a
a
a
"}
(2,1,1) = {"
a
a
a
a
a
a
a
a
a
a
a
a
a
a
a
"}
(3,1,1) = {"
a
a
a
a
a
a
a
a
a
a
a
a
a
a
a
"}
(4,1,1) = {"
a
a
P
P
P
P
I
I
I
P
P
P
P
a
a
"}
(5,1,1) = {"
a
a
P
P
P
I
I
r
I
s
P
P
P
a
a
"}
(6,1,1) = {"
a
a
P
P
P
d
c
p
y
d
P
P
P
a
a
"}
(7,1,1) = {"
a
a
P
P
P
d
u
g
L
d
P
P
P
a
a
"}
(8,1,1) = {"
a
a
P
P
P
R
R
K
o
R
P
P
P
a
a
"}
(9,1,1) = {"
a
a
d
d
P
P
I
k
e
P
P
d
d
a
a
"}
(10,1,1) = {"
a
a
d
d
w
q
b
E
x
F
m
d
d
a
a
"}
(11,1,1) = {"
a
a
P
R
q
Z
U
V
H
O
F
R
P
a
a
"}
(12,1,1) = {"
a
a
P
P
j
j
h
z
M
j
j
P
P
a
a
"}
(13,1,1) = {"
a
a
P
P
W
W
R
Y
R
W
W
P
P
a
a
"}
(14,1,1) = {"
a
a
a
a
a
a
a
a
a
a
a
a
a
a
a
"}
(15,1,1) = {"
a
a
a
a
a
a
a
a
a
a
a
a
a
a
a
"}
