//MAP CONVERTED BY dmm2tgm.py THIS HEADER COMMENT PREVENTS RECONVERSION, DO NOT REMOVE
"a" = (
/turf/space/basic,
/area/space)
"b" = (
/turf/simulated/wall/wood,
/area/shuttle/auto/one_single_area)
"c" = (
/obj/structure/cable/green{
	icon_state = "2-4"
	},
/obj/machinery/atmospherics/pipe/simple/hidden/cyan{
	dir = 9
	},
/turf/simulated/wall/prepainted/cargo,
/area/shuttle/auto/one_single_area)
"d" = (
/obj/machinery/button/remote/blast_door{
	dir = 4;
	pixel_y = 9;
	id = "caravan2";
	name = "Caravan Front Door"
	},
/obj/machinery/button/remote/blast_door{
	dir = 4;
	pixel_y = -8;
	id = "caravan1";
	name = "Caravan Back Door"
	},
/obj/structure/table/steel_reinforced,
/turf/simulated/floor/tiled/old_tile/beige,
/area/shuttle/auto/one_single_area)
"e" = (
/obj/machinery/door/firedoor,
/obj/machinery/button/remote/blast_door{
	id = "caravan2";
	name = "Caravan Front Door";
	pixel_x = -25
	},
/obj/machinery/door/airlock/hatch{
	name = "Caravan Airtight Hatch";
	req_one_access = null
	},
/obj/machinery/door/blast/regular{
	density = 0;
	dir = 4;
	icon_state = "pdoorc0";
	id = "caravan2";
	name = "Spacenat Caravan Airlock";
	opacity = 0
	},
/obj/structure/fans/tiny,
/turf/simulated/floor/plating,
/area/shuttle/auto/one_single_area)
"f" = (
/obj/structure/table/steel,
/obj/machinery/computer/ship/navigation/telescreen{
	pixel_y = -33
	},
/turf/simulated/floor/carpet/patterened/blue,
/area/shuttle/auto/one_single_area)
"g" = (
/obj/structure/bed/chair/comfy/brown{
	dir = 8
	},
/obj/machinery/newscaster{
	pixel_y = -28
	},
/turf/simulated/floor/carpet/patterened/blue,
/area/shuttle/auto/one_single_area)
"h" = (
/obj/machinery/computer/ship/helm{
	req_one_access = null
	},
/obj/structure/table/steel_reinforced,
/turf/simulated/floor/tiled/old_tile/beige,
/area/shuttle/auto/one_single_area)
"i" = (
/obj/structure/cable/orange{
	icon_state = "1-4"
	},
/turf/simulated/wall/prepainted/cargo,
/area/shuttle/auto/one_single_area)
"j" = (
/obj/machinery/atmospherics/pipe/manifold/hidden{
	dir = 1
	},
/turf/simulated/wall/prepainted/cargo,
/area/shuttle/auto/one_single_area)
"k" = (
/obj/structure/table/steel,
/obj/machinery/light/small{
	dir = 1
	},
/obj/item/reagent_containers/glass/beaker{
	pixel_x = 5
	},
/obj/machinery/appliance/cooker/oven,
/turf/simulated/floor/tiled/old_tile/white,
/area/shuttle/auto/one_single_area)
"l" = (
/obj/machinery/portable_atmospherics/canister/phoron,
/obj/machinery/atmospherics/portables_connector{
	dir = 1
	},
/turf/simulated/floor/plating,
/area/shuttle/auto/one_single_area)
"m" = (
/obj/machinery/atmospherics/pipe/simple/hidden{
	dir = 5
	},
/obj/structure/bed/double/padded,
/obj/item/bedsheet/browndouble,
/turf/simulated/floor/carpet/patterened/brown,
/area/shuttle/auto/one_single_area)
"n" = (
/obj/structure/bed/chair/comfy/brown{
	dir = 8
	},
/obj/structure/cable/green{
	icon_state = "2-4"
	},
/obj/landmark/spawnpoint/auto_shuttle_start,
/turf/simulated/floor/tiled/old_tile/beige,
/area/shuttle/auto/one_single_area)
"q" = (
/obj/machinery/atmospherics/pipe/simple/hidden{
	dir = 6
	},
/obj/structure/table/bench/wooden,
/obj/machinery/light/small{
	dir = 4
	},
/obj/structure/cable/green{
	icon_state = "4-8"
	},
/turf/simulated/floor/carpet/patterened/brown,
/area/shuttle/auto/one_single_area)
"r" = (
/obj/structure/curtain/black,
/obj/structure/cable/green{
	icon_state = "4-8"
	},
/turf/simulated/floor/carpet/patterened/blue,
/area/shuttle/auto/one_single_area)
"s" = (
/obj/structure/table/steel_reinforced,
/obj/machinery/computer/shuttle_control,
/obj/item/gps/internal/base{
	name = "Caravan Beacon";
	gps_tag = "CARAVAN"
	},
/turf/simulated/floor/tiled/old_tile/beige,
/area/shuttle/auto/one_single_area)
"t" = (
/obj/machinery/telecomms/relay/preset/telecomms,
/obj/structure/cable/green{
	icon_state = "1-8"
	},
/turf/simulated/floor/plating,
/area/shuttle/auto/one_single_area)
"u" = (
/turf/simulated/wall/prepainted/cargo,
/area/shuttle/auto/one_single_area)
"v" = (
/turf/simulated/floor/carpet/patterened/blue,
/area/shuttle/auto/one_single_area)
"w" = (
/obj/machinery/computer/ship/navigation/telescreen{
	pixel_x = 32
	},
/turf/simulated/floor/carpet/patterened/blue,
/area/shuttle/auto/one_single_area)
"x" = (
/obj/machinery/atmospherics/pipe/simple/hidden/cyan{
	dir = 4
	},
/turf/simulated/wall/wood,
/area/shuttle/auto/one_single_area)
"y" = (
/obj/structure/table/steel,
/obj/structure/sink/kitchen,
/turf/simulated/floor/tiled/old_tile/white,
/area/shuttle/auto/one_single_area)
"z" = (
/obj/structure/cable/green{
	icon_state = "4-8"
	},
/obj/machinery/atmospherics/pipe/simple/hidden/cyan{
	dir = 9
	},
/turf/simulated/floor/carpet/patterened/blue,
/area/shuttle/auto/one_single_area)
"B" = (
/obj/structure/cable/green,
/obj/structure/table/steel_reinforced,
/obj/machinery/computer/ship/sensors{
	dir = 1
	},
/obj/machinery/power/apc/alarms_hidden/south_mount{
	req_access = null
	},
/turf/simulated/floor/tiled/old_tile/beige,
/area/shuttle/auto/one_single_area)
"C" = (
/obj/structure/cable/green{
	icon_state = "4-8"
	},
/obj/machinery/atmospherics/valve{
	dir = 4
	},
/turf/simulated/floor/carpet/patterened/blue,
/area/shuttle/auto/one_single_area)
"D" = (
/obj/structure/cable/green{
	icon_state = "4-8"
	},
/obj/machinery/atmospherics/component/unary/vent_pump/on{
	dir = 4
	},
/turf/simulated/floor/carpet/patterened/blue,
/area/shuttle/auto/one_single_area)
"E" = (
/obj/structure/cable/green{
	icon_state = "1-8"
	},
/obj/structure/shuttle/engine/heater{
	dir = 4
	},
/obj/machinery/atmospherics/pipe/simple/hidden{
	dir = 4
	},
/turf/simulated/wall/prepainted/cargo,
/area/shuttle/auto/one_single_area)
"F" = (
/obj/machinery/portable_atmospherics/canister/air/airlock,
/obj/machinery/atmospherics/portables_connector,
/obj/machinery/power/terminal{
	dir = 4
	},
/obj/structure/cable/orange{
	dir = 4
	},
/turf/simulated/floor/plating,
/area/shuttle/auto/one_single_area)
"G" = (
/obj/machinery/door/firedoor,
/obj/machinery/button/remote/blast_door{
	id = "caravan1";
	name = "Caravan Back Door";
	pixel_x = 26
	},
/obj/machinery/door/blast/regular{
	density = 0;
	dir = 4;
	icon_state = "pdoorc0";
	id = "caravan1";
	name = "Spacenat Caravan Airlock";
	opacity = 0
	},
/obj/machinery/door/airlock/hatch{
	name = "Caravan Airtight Hatch";
	req_one_access = null
	},
/obj/structure/fans/tiny,
/obj/shuttle_aligner/port/south/primary,
/turf/simulated/floor/plating,
/area/shuttle/auto/one_single_area)
"H" = (
/obj/structure/cable/green{
	icon_state = "4-8"
	},
/turf/simulated/floor/carpet/patterened/blue,
/area/shuttle/auto/one_single_area)
"I" = (
/obj/spawner/window/low_wall/reinforced/firelocks,
/turf/simulated/floor/tiled/old_tile/beige,
/area/shuttle/auto/one_single_area)
"J" = (
/obj/machinery/atmospherics/component/unary/engine{
	dir = 8
	},
/turf/simulated/shuttle/plating/airless/carry,
/area/shuttle/auto/one_single_area)
"K" = (
/obj/machinery/atmospherics/pipe/simple/hidden/cyan{
	dir = 4
	},
/turf/simulated/wall/prepainted/cargo,
/area/shuttle/auto/one_single_area)
"L" = (
/obj/machinery/door/window/westright{
	dir = 1
	},
/obj/structure/cable/green{
	icon_state = "4-8"
	},
/turf/simulated/floor/carpet/patterened/brown,
/area/shuttle/auto/one_single_area)
"M" = (
/obj/structure/sink{
	dir = 8;
	pixel_x = -12;
	pixel_y = 2
	},
/obj/structure/toilet{
	pixel_y = 10
	},
/obj/machinery/shower{
	dir = 8
	},
/obj/machinery/atmospherics/pipe/simple/hidden{
	dir = 4
	},
/obj/structure/curtain/black,
/turf/simulated/floor/tiled/old_tile/yellow,
/area/shuttle/auto/one_single_area)
"N" = (
/obj/structure/closet/walllocker_double/south,
/turf/simulated/floor/carpet/patterened/brown,
/area/shuttle/auto/one_single_area)
"O" = (
/obj/machinery/atmospherics/pipe/simple/hidden{
	dir = 10
	},
/obj/machinery/shipsensors,
/turf/simulated/floor/plating,
/area/shuttle/auto/one_single_area)
"P" = (
/obj/machinery/atmospherics/portables_connector{
	dir = 1
	},
/obj/machinery/portable_atmospherics/canister/empty/phoron,
/turf/simulated/floor/plating,
/area/shuttle/auto/one_single_area)
"Q" = (
/obj/structure/table/steel,
/obj/machinery/microwave,
/obj/machinery/light/small{
	dir = 1
	},
/obj/machinery/air_alarm/alarms_hidden/north_mount{
	req_one_access = null
	},
/turf/simulated/floor/tiled/old_tile/white,
/area/shuttle/auto/one_single_area)
"R" = (
/obj/machinery/power/smes/buildable{
	charge = 15000;
	cur_coils = 3
	},
/obj/structure/cable/green{
	icon_state = "0-2"
	},
/turf/simulated/floor/plating,
/area/shuttle/auto/one_single_area)
"S" = (
/obj/structure/bed/chair/comfy/brown{
	dir = 4
	},
/obj/structure/panic_button{
	pixel_y = -28
	},
/turf/simulated/floor/carpet/patterened/blue,
/area/shuttle/auto/one_single_area)
"T" = (
/obj/machinery/light_switch{
	dir = 1;
	pixel_y = -24
	},
/obj/structure/bed/chair/sofa/beige/right{
	dir = 1
	},
/turf/simulated/floor/carpet/patterened/blue,
/area/shuttle/auto/one_single_area)
"V" = (
/obj/machinery/computer/ship/engines{
	dir = 1
	},
/obj/structure/table/steel_reinforced,
/turf/simulated/floor/tiled/old_tile/beige,
/area/shuttle/auto/one_single_area)
"W" = (
/obj/structure/closet/secure_closet/freezer/meat,
/obj/item/reagent_containers/food/drinks/soymilk,
/obj/item/reagent_containers/food/drinks/soymilk,
/obj/item/reagent_containers/food/drinks/bottle/milk,
/obj/item/reagent_containers/food/drinks/bottle/milk,
/obj/item/reagent_containers/food/drinks/bottle/cola,
/obj/item/reagent_containers/food/drinks/bottle/cola,
/obj/item/reagent_containers/food/drinks/bottle/cola,
/obj/item/reagent_containers/food/drinks/bottle/cola,
/obj/item/reagent_containers/food/drinks/bottle/cola,
/obj/item/reagent_containers/food/drinks/bottle/cola,
/obj/item/reagent_containers/food/drinks/bottle/cola,
/obj/item/reagent_containers/food/drinks/bottle/cola,
/obj/item/reagent_containers/food/drinks/bottle/cola,
/obj/item/reagent_containers/food/drinks/bottle/cola,
/obj/item/reagent_containers/food/drinks/bottle/cola,
/obj/item/reagent_containers/food/drinks/bottle/cola,
/obj/item/reagent_containers/food/drinks/bottle/cola,
/obj/item/reagent_containers/food/drinks/bottle/cola,
/obj/item/storage/box/glasses/meta,
/turf/simulated/floor/tiled/old_tile/white,
/area/shuttle/auto/one_single_area)
"X" = (
/obj/structure/cable/green{
	icon_state = "4-8"
	},
/obj/structure/cable/green{
	icon_state = "4-8"
	},
/obj/machinery/holopad/ship,
/turf/simulated/floor/carpet/patterened/blue,
/area/shuttle/auto/one_single_area)
"Y" = (
/obj/structure/bed/chair/sofa/beige/left{
	dir = 1
	},
/obj/structure/closet/walllocker/emerglocker{
	pixel_y = -32
	},
/turf/simulated/floor/carpet/patterened/blue,
/area/shuttle/auto/one_single_area)
"Z" = (
/obj/structure/shuttle_fuel_port{
	dir = 4;
	pixel_x = 29
	},
/obj/structure/closet/secure_closet/personal,
/obj/machinery/atmospherics/pipe/simple/hidden/cyan{
	dir = 6
	},
/turf/simulated/floor/carpet/patterened/blue,
/area/shuttle/auto/one_single_area)

(1,1,1) = {"
a
a
a
a
a
a
a
a
a
a
a
a
a
a
a
"}
(2,1,1) = {"
a
a
a
a
a
a
b
I
I
I
b
a
a
a
a
"}
(3,1,1) = {"
a
a
a
a
a
a
I
s
d
V
I
a
a
a
a
"}
(4,1,1) = {"
a
a
a
a
a
a
u
h
n
B
b
a
a
a
a
"}
(5,1,1) = {"
a
a
a
a
a
a
e
v
X
S
b
a
a
a
a
"}
(6,1,1) = {"
a
a
a
a
a
a
b
Q
H
f
b
a
a
a
a
"}
(7,1,1) = {"
a
a
a
a
a
a
I
y
H
g
b
a
a
a
a
"}
(8,1,1) = {"
a
a
a
a
a
a
b
k
D
Y
b
a
a
a
a
"}
(9,1,1) = {"
a
a
a
a
a
a
I
W
C
T
b
a
a
a
a
"}
(10,1,1) = {"
a
a
a
a
a
a
b
Z
z
w
G
a
a
a
a
"}
(11,1,1) = {"
a
a
a
a
a
a
u
x
r
b
u
a
a
a
a
"}
(12,1,1) = {"
a
a
a
a
a
a
u
M
L
N
u
a
a
a
a
"}
(13,1,1) = {"
a
a
a
a
a
a
i
K
q
m
u
a
a
a
a
"}
(14,1,1) = {"
a
a
a
a
a
a
F
c
E
j
P
a
a
a
a
"}
(15,1,1) = {"
a
a
a
a
a
a
R
t
J
O
l
a
a
a
a
"}
