//MAP CONVERTED BY dmm2tgm.py THIS HEADER COMMENT PREVENTS RECONVERSION, DO NOT REMOVE
"a" = (
/turf/space/basic,
/area/space)
"b" = (
/turf/simulated/floor,
/area/space)
"d" = (
/turf/simulated/wall/r_wall/prepainted,
/area/space)
"K" = (
/obj/structure/lattice,
/turf/space/basic,
/area/space)

(1,1,1) = {"
a
a
a
a
a
a
a
a
a
a
a
a
b
b
"}
(2,1,1) = {"
a
a
a
a
a
a
a
a
a
a
b
b
b
b
"}
(3,1,1) = {"
a
a
a
a
a
a
a
a
a
b
b
b
a
a
"}
(4,1,1) = {"
a
a
a
a
a
a
a
b
K
K
b
b
K
a
"}
(5,1,1) = {"
a
a
a
a
a
K
K
a
a
a
a
a
K
a
"}
(6,1,1) = {"
a
a
b
b
K
K
b
b
b
a
a
b
K
a
"}
(7,1,1) = {"
a
b
b
d
a
a
a
b
b
a
a
b
b
a
"}
(8,1,1) = {"
a
b
d
d
a
a
a
a
a
a
a
b
a
a
"}
(9,1,1) = {"
a
b
d
d
d
K
K
K
b
b
a
a
a
a
"}
(10,1,1) = {"
a
a
b
d
d
b
a
a
b
b
b
a
a
a
"}
(11,1,1) = {"
a
a
b
d
b
a
a
a
b
b
a
a
a
a
"}
(12,1,1) = {"
a
a
a
b
b
a
a
a
b
a
a
a
a
a
"}
(13,1,1) = {"
a
a
a
a
a
b
b
a
a
a
a
a
a
a
"}
(14,1,1) = {"
a
a
a
a
a
b
b
a
a
a
a
a
a
a
"}
