//MAP CONVERTED BY dmm2tgm.py THIS HEADER COMMENT PREVENTS RECONVERSION, DO NOT REMOVE
"a" = (
/turf/template_noop,
/area/template_noop)
"b" = (
/turf/simulated/wall/r_wall/prepainted/engineering,
/area/template_noop)
"O" = (
/obj/structure/lattice,
/turf/template_noop,
/area/template_noop)
"R" = (
/turf/simulated/floor,
/area/template_noop)

(1,1,1) = {"
b
b
b
a
a
a
a
a
a
a
a
a
a
a
a
a
"}
(2,1,1) = {"
a
b
b
a
a
a
a
a
a
a
a
a
a
a
a
a
"}
(3,1,1) = {"
a
b
b
a
a
a
a
a
a
a
a
a
a
a
a
a
"}
(4,1,1) = {"
a
O
a
a
a
a
a
a
O
O
O
a
O
a
a
a
"}
(5,1,1) = {"
a
O
a
a
a
b
a
a
O
O
O
b
b
a
a
a
"}
(6,1,1) = {"
a
O
a
a
a
b
b
b
O
O
O
b
R
b
a
a
"}
(7,1,1) = {"
a
b
a
O
a
b
R
R
O
O
O
b
R
b
b
a
"}
(8,1,1) = {"
a
b
b
O
a
R
a
R
a
O
O
O
a
b
b
a
"}
(9,1,1) = {"
a
b
a
O
a
R
a
a
a
O
a
O
a
a
a
a
"}
(10,1,1) = {"
a
a
a
O
a
a
a
b
a
O
O
R
a
a
a
a
"}
(11,1,1) = {"
a
a
a
b
b
b
O
R
R
a
R
b
b
a
a
a
"}
(12,1,1) = {"
a
a
a
a
b
b
O
a
R
R
b
b
b
b
a
a
"}
(13,1,1) = {"
a
a
a
a
a
a
O
a
b
a
a
b
b
b
a
a
"}
(14,1,1) = {"
a
a
a
a
a
a
a
a
b
a
a
a
a
a
a
a
"}
(15,1,1) = {"
a
a
a
a
a
a
a
a
a
a
a
a
a
a
b
a
"}
(16,1,1) = {"
a
a
a
a
a
a
a
a
a
a
a
a
b
b
b
b
"}
