//MAP CONVERTED BY dmm2tgm.py THIS HEADER COMMENT PREVENTS RECONVERSION, DO NOT REMOVE
"a" = (
/turf/simulated/wall/r_wall/prepainted,
/area/submap/osiris_field/cargo_shuttle2)
"g" = (
/turf/template_noop,
/area/template_noop)
"h" = (
/obj/structure/lattice,
/turf/template_noop,
/area/template_noop)
"j" = (
/obj/machinery/door/blast/shutters,
/turf/simulated/floor/plating/indoors,
/area/submap/osiris_field/cargo_shuttle2)
"k" = (
/obj/structure/largecrate/animal/cow,
/turf/simulated/floor/plating/indoors,
/area/submap/osiris_field/cargo_shuttle2)
"l" = (
/turf/simulated/floor/plating/indoors,
/area/submap/osiris_field/cargo_shuttle2)
"m" = (
/obj/item/material/shard,
/turf/simulated/floor/plating/indoors,
/area/submap/osiris_field/cargo_shuttle2)
"n" = (
/obj/spawner/corpse/safari,
/obj/effect/debris/cleanable/blood,
/turf/simulated/floor/plating/indoors,
/area/submap/osiris_field/cargo_shuttle2)
"t" = (
/obj/item/material/shard,
/turf/simulated/floor/tiled/steel_dirty/silver,
/area/submap/osiris_field/cargo_shuttle2)
"u" = (
/obj/structure/lattice,
/turf/template_noop,
/area/submap/osiris_field/cargo_shuttle2)
"w" = (
/turf/simulated/floor/tiled/steel_dirty/silver,
/area/submap/osiris_field/cargo_shuttle2)
"y" = (
/obj/spawner/corpse/safari,
/mob/living/simple_mob/animal/space/carp/large/huge,
/turf/simulated/floor/plating/indoors,
/area/submap/osiris_field/cargo_shuttle2)
"z" = (
/obj/machinery/atmospherics/component/unary/engine{
	dir = 1
	},
/turf/template_noop,
/area/template_noop)
"B" = (
/obj/effect/debris/cleanable/blood,
/turf/simulated/floor/plating/indoors,
/area/submap/osiris_field/cargo_shuttle2)
"E" = (
/obj/structure/largecrate/animal/carp,
/turf/simulated/floor/plating/indoors,
/area/submap/osiris_field/cargo_shuttle2)
"F" = (
/turf/simulated/floor/plating/indoors,
/area/template_noop)
"H" = (
/obj/machinery/portable_atmospherics/canister/empty/phoron,
/turf/simulated/floor/plating/indoors,
/area/submap/osiris_field/cargo_shuttle2)
"I" = (
/obj/structure/lattice,
/mob/living/simple_mob/animal/space/carp,
/turf/template_noop,
/area/submap/osiris_field/cargo_shuttle2)
"K" = (
/obj/structure/largecrate/animal/dangerous,
/turf/simulated/floor/plating/indoors,
/area/submap/osiris_field/cargo_shuttle2)
"L" = (
/obj/structure/salvageable/console_broken_os{
	dir = 1
	},
/turf/simulated/floor/tiled/steel_dirty/silver,
/area/submap/osiris_field/cargo_shuttle2)
"O" = (
/obj/structure/bed/chair/bay/comfy/captain,
/turf/simulated/floor/tiled/steel_dirty/silver,
/area/submap/osiris_field/cargo_shuttle2)
"P" = (
/obj/structure/salvageable/console_broken_os{
	dir = 8
	},
/turf/simulated/floor/tiled/steel_dirty/silver,
/area/submap/osiris_field/cargo_shuttle2)
"Q" = (
/obj/structure/closet/crate,
/obj/random/gun/random,
/obj/random/weapon/guarenteed,
/turf/simulated/floor/plating/indoors,
/area/submap/osiris_field/cargo_shuttle2)
"S" = (
/obj/machinery/door/airlock/hatch,
/turf/simulated/floor/tiled/steel_dirty/silver,
/area/submap/osiris_field/cargo_shuttle2)
"U" = (
/mob/living/simple_mob/animal/space/carp,
/turf/simulated/floor/plating/indoors,
/area/submap/osiris_field/cargo_shuttle2)
"V" = (
/obj/structure/bed/chair/bay/comfy/captain{
	dir = 1
	},
/obj/item/material/shard,
/obj/spawner/corpse/safari,
/turf/simulated/floor/tiled/steel_dirty/silver,
/area/submap/osiris_field/cargo_shuttle2)
"W" = (
/obj/spawner/window/low_wall/reinforced/firelocks,
/turf/simulated/floor/tiled/steel_dirty/silver,
/area/submap/osiris_field/cargo_shuttle2)

(1,1,1) = {"
g
g
g
g
a
a
a
j
j
j
j
a
a
a
a
"}
(2,1,1) = {"
g
g
a
a
a
k
K
l
l
n
l
E
E
E
u
"}
(3,1,1) = {"
a
a
a
K
U
l
l
l
l
l
u
I
u
u
u
"}
(4,1,1) = {"
j
l
l
l
l
y
l
B
l
u
u
u
l
l
l
"}
(5,1,1) = {"
j
l
E
E
B
l
Q
l
u
l
l
l
l
B
j
"}
(6,1,1) = {"
a
a
a
a
a
a
a
a
S
a
a
S
a
a
a
"}
(7,1,1) = {"
g
g
g
g
a
a
w
m
t
S
l
w
a
h
g
"}
(8,1,1) = {"
g
g
g
g
h
h
V
O
L
a
H
h
h
g
g
"}
(9,1,1) = {"
g
g
g
g
h
F
P
P
w
h
h
h
l
a
z
"}
(10,1,1) = {"
g
g
g
g
W
W
h
h
W
a
a
a
a
g
g
"}
