//MAP CONVERTED BY dmm2tgm.py THIS HEADER COMMENT PREVENTS RECONVERSION, DO NOT REMOVE
"a" = (
/turf/template_noop,
/area/template_noop)
"b" = (
/turf/simulated/wall/r_wall/prepainted/cargo,
/area/template_noop)
"c" = (
/turf/simulated/floor/plating,
/area/tether_away/debrisfield_vr/shuttle_buffer)
"d" = (
/turf/template_noop,
/area/tether_away/debrisfield_vr/shuttle_buffer)
"e" = (
/obj/tether_away_spawner/debrisfield/carp,
/turf/template_noop,
/area/tether_away/debrisfield_vr/shuttle_buffer)
"g" = (
/obj/effect/decal/mecha_wreckage/durand,
/turf/simulated/floor/plating,
/area/template_noop)
"m" = (
/obj/effect/decal/mecha_wreckage/cludge,
/turf/template_noop,
/area/template_noop)
"I" = (
/turf/simulated/wall/r_wall/prepainted/cargo,
/area/tether_away/debrisfield_vr/shuttle_buffer)
"X" = (
/turf/simulated/floor/plating,
/area/template_noop)

(1,1,1) = {"
a
a
b
b
a
a
a
a
a
a
a
"}
(2,1,1) = {"
a
X
X
X
X
a
a
a
X
b
a
"}
(3,1,1) = {"
a
a
c
c
I
I
d
d
c
b
b
"}
(4,1,1) = {"
a
m
d
I
d
d
d
c
c
X
b
"}
(5,1,1) = {"
a
a
d
d
d
d
d
c
c
X
X
"}
(6,1,1) = {"
a
b
I
d
d
e
d
c
c
g
X
"}
(7,1,1) = {"
b
X
c
c
d
d
d
d
c
X
a
"}
(8,1,1) = {"
b
X
c
I
d
d
d
d
d
a
a
"}
(9,1,1) = {"
b
X
I
d
d
c
c
d
d
a
a
"}
(10,1,1) = {"
b
b
a
a
X
X
X
a
a
a
a
"}
(11,1,1) = {"
a
a
a
a
X
X
b
b
a
a
a
"}
