//MAP CONVERTED BY dmm2tgm.py THIS HEADER COMMENT PREVENTS RECONVERSION, DO NOT REMOVE
"a" = (
/obj/structure/lattice,
/turf/template_noop,
/area/tether_away/debrisfield_vr/shuttle_buffer)
"b" = (
/obj/structure/lattice,
/turf/template_noop,
/area/template_noop)
"c" = (
/turf/template_noop,
/area/template_noop)

(1,1,1) = {"
b
b
c
"}
(2,1,1) = {"
b
a
b
"}
(3,1,1) = {"
b
b
c
"}
