//MAP CONVERTED BY dmm2tgm.py THIS HEADER COMMENT PREVENTS RECONVERSION, DO NOT REMOVE
"a" = (
/obj/item/material/shard/shrapnel,
/obj/machinery/fire_alarm/alarms_hidden/east_mount{
	pixel_x = -24
	},
/turf/simulated/floor/airless,
/area/tether_away/debrisfield_vr/shuttle_buffer)
"b" = (
/obj/structure/girder,
/turf/simulated/floor/airless,
/area/tether_away/debrisfield_vr/shuttle_buffer)
"c" = (
/turf/template_noop,
/area/tether_away/debrisfield_vr/shuttle_buffer)
"d" = (
/turf/simulated/floor/airless,
/area/tether_away/debrisfield_vr/shuttle_buffer)
"e" = (
/obj/structure/lattice,
/turf/template_noop,
/area/template_noop)
"f" = (
/obj/item/stack/rods,
/turf/simulated/floor/airless,
/area/tether_away/debrisfield_vr/shuttle_buffer)
"g" = (
/obj/structure/lattice,
/obj/item/stack/rods,
/turf/template_noop,
/area/tether_away/debrisfield_vr/shuttle_buffer)
"h" = (
/obj/structure/lattice,
/turf/template_noop,
/area/tether_away/debrisfield_vr/shuttle_buffer)
"i" = (
/obj/item/material/shard/shrapnel,
/turf/simulated/floor/airless,
/area/tether_away/debrisfield_vr/shuttle_buffer)
"k" = (
/turf/template_noop,
/area/template_noop)
"l" = (
/turf/simulated/wall,
/area/tether_away/debrisfield_vr/shuttle_buffer)

(1,1,1) = {"
b
l
h
h
e
"}
(2,1,1) = {"
c
a
f
h
k
"}
(3,1,1) = {"
i
d
d
h
k
"}
(4,1,1) = {"
k
h
g
h
k
"}
