//MAP CONVERTED BY dmm2tgm.py THIS HEADER COMMENT PREVENTS RECONVERSION, DO NOT REMOVE
"aY" = (
/obj/structure/cable/green{
	icon_state = "4-8"
	},
/turf/simulated/wall/prepainted,
/area/template_noop)
"bl" = (
/obj/structure/cable/green{
	icon_state = "4-8"
	},
/obj/machinery/atmospherics/component/unary/vent_pump/on{
	dir = 4
	},
/obj/structure/bed/chair/sofa/brown/right{
	dir = 8
	},
/turf/simulated/floor/tiled/monotechmaint,
/area/template_noop)
"bG" = (
/obj/machinery/atmospherics/pipe/simple/hidden/cyan{
	dir = 4
	},
/obj/structure/bed/chair/wood{
	dir = 8
	},
/turf/simulated/floor/tiled/kafel_full/white,
/area/template_noop)
"eZ" = (
/turf/simulated/floor/tiled/techfloor,
/area/template_noop)
"fj" = (
/obj/structure/cable/green{
	icon_state = "4-8"
	},
/obj/effect/floor_decal/corner_techfloor_grid/full{
	dir = 4
	},
/turf/simulated/floor/tiled/kafel_full/white,
/area/template_noop)
"gl" = (
/obj/machinery/door/airlock/hatch{
	name = "Caravan Airtight Hatch";
	req_one_access = null
	},
/turf/simulated/floor/wood,
/area/template_noop)
"gp" = (
/obj/machinery/atmospherics/pipe/simple/hidden/cyan{
	dir = 4
	},
/turf/simulated/wall/prepainted,
/area/template_noop)
"hT" = (
/obj/machinery/door/firedoor,
/obj/machinery/button/remote/blast_door{
	id = "Bcaravan1";
	name = "Caravan Front Door";
	pixel_x = -25
	},
/obj/machinery/door/airlock/hatch{
	name = "Caravan Airtight Hatch";
	req_one_access = null
	},
/obj/machinery/door/blast/regular{
	density = 0;
	dir = 4;
	icon_state = "pdoorc0";
	id = "Bcaravan2";
	name = "Spacenat Caravan Airlock";
	opacity = 0
	},
/obj/structure/fans/tiny,
/obj/machinery/door/firedoor,
/turf/simulated/floor/tiled/techfloor,
/area/template_noop)
"ix" = (
/obj/machinery/atmospherics/pipe/simple/hidden{
	dir = 10
	},
/obj/machinery/shipsensors,
/turf/simulated/floor/plating,
/area/template_noop)
"iz" = (
/obj/machinery/portable_atmospherics/canister/air/airlock,
/obj/machinery/atmospherics/portables_connector,
/obj/machinery/power/terminal{
	dir = 4
	},
/obj/structure/cable/orange{
	dir = 4
	},
/turf/simulated/floor/plating,
/area/template_noop)
"jZ" = (
/obj/structure/closet/walllocker/emergsuit_wall{
	pixel_y = 30
	},
/turf/simulated/floor/tiled/techfloor,
/area/template_noop)
"kt" = (
/obj/structure/cable/orange{
	icon_state = "1-2"
	},
/turf/simulated/wall/prepainted,
/area/template_noop)
"kD" = (
/obj/structure/cable/green{
	icon_state = "1-8"
	},
/turf/simulated/wall/prepainted,
/area/template_noop)
"lI" = (
/obj/machinery/computer/ship/navigation/telescreen{
	pixel_y = -33
	},
/obj/structure/bed/chair/sofa/brown/right{
	dir = 4
	},
/turf/simulated/floor/tiled/monotechmaint,
/area/template_noop)
"lS" = (
/obj/structure/cable/green{
	icon_state = "2-4"
	},
/obj/machinery/atmospherics/pipe/simple/hidden/cyan{
	dir = 9
	},
/turf/simulated/wall/prepainted,
/area/template_noop)
"mi" = (
/obj/structure/cable/green{
	icon_state = "4-8"
	},
/obj/structure/table/wooden_reinforced,
/obj/effect/floor_decal/corner_techfloor_grid{
	dir = 10
	},
/turf/simulated/floor/tiled/kafel_full/white,
/area/template_noop)
"mQ" = (
/obj/structure/fuel_port{
	pixel_x = -27
	},
/obj/overmap/entity/visitable/ship/landable/trade/cargoravana,
/turf/simulated/floor/tiled/techfloor,
/area/template_noop)
"nh" = (
/obj/item/reagent_containers/glass/beaker{
	pixel_x = 5
	},
/obj/machinery/appliance/cooker/oven,
/obj/effect/floor_decal/corner_techfloor_grid{
	dir = 5
	},
/turf/simulated/floor/tiled/old_tile/white,
/area/template_noop)
"nG" = (
/obj/machinery/light/small{
	dir = 4
	},
/turf/simulated/floor/wood,
/area/template_noop)
"ov" = (
/obj/machinery/button/remote/blast_door{
	dir = 4;
	pixel_y = -8;
	id = "Bcaravan1";
	name = "Caravan Back Door"
	},
/obj/structure/table/steel_reinforced,
/turf/simulated/floor/tiled/techfloor,
/area/template_noop)
"oI" = (
/obj/structure/cable/green{
	icon_state = "4-8"
	},
/obj/structure/bed/chair/sofa/brown/left{
	dir = 4
	},
/turf/simulated/floor/tiled/monotechmaint,
/area/template_noop)
"pq" = (
/obj/machinery/atmospherics/pipe/simple/hidden/cyan{
	dir = 6
	},
/turf/simulated/floor/tiled/techfloor,
/area/template_noop)
"qc" = (
/obj/machinery/atmospherics/pipe/simple/hidden/cyan{
	dir = 4
	},
/turf/simulated/floor/tiled/techfloor/monogrid,
/area/template_noop)
"qi" = (
/obj/effect/floor_decal/industrial/outline/yellow,
/obj/structure/closet/walllocker_double/east,
/turf/simulated/floor/tiled/techfloor,
/area/template_noop)
"sd" = (
/obj/machinery/atmospherics/pipe/manifold/hidden{
	dir = 1
	},
/turf/simulated/wall/prepainted,
/area/template_noop)
"tf" = (
/obj/machinery/atmospherics/pipe/simple/hidden{
	dir = 6
	},
/obj/machinery/light/small{
	dir = 4
	},
/obj/structure/cable/green{
	icon_state = "4-8"
	},
/obj/effect/floor_decal/corner_techfloor_grid/full{
	dir = 1
	},
/turf/simulated/floor/tiled/steel_ridged,
/area/template_noop)
"uj" = (
/obj/effect/floor_decal/corner_techfloor_grid{
	dir = 6
	},
/turf/simulated/floor/tiled/kafel_full/white,
/area/template_noop)
"vh" = (
/obj/structure/cable/green{
	icon_state = "4-8"
	},
/obj/structure/cable/green{
	icon_state = "4-8"
	},
/obj/machinery/holopad/ship,
/turf/simulated/floor/tiled/monotechmaint,
/area/template_noop)
"vN" = (
/turf/template_noop,
/area/template_noop)
"wq" = (
/obj/structure/cable/green{
	icon_state = "4-8"
	},
/obj/effect/floor_decal/corner_techfloor_grid/diagonal{
	dir = 8
	},
/turf/simulated/floor/tiled/steel_ridged,
/area/template_noop)
"wN" = (
/obj/machinery/atmospherics/pipe/simple/hidden{
	dir = 5
	},
/turf/simulated/wall/prepainted,
/area/template_noop)
"wR" = (
/obj/machinery/light_switch{
	dir = 1;
	pixel_y = -24
	},
/turf/simulated/floor/tiled/techfloor,
/area/template_noop)
"xf" = (
/obj/spawner/window/low_wall/reinforced/full/firelocks,
/turf/simulated/floor/tiled/old_tile/beige,
/area/template_noop)
"xJ" = (
/obj/spawner/window/low_wall/reinforced/full/firelocks,
/turf/simulated/floor/tiled/old_tile/blue,
/area/template_noop)
"zm" = (
/obj/structure/bed/chair/comfy/brown{
	dir = 8
	},
/obj/structure/cable/green{
	icon_state = "2-4"
	},
/turf/simulated/floor/tiled/techfloor,
/area/template_noop)
"Aj" = (
/obj/structure/cable/green{
	icon_state = "2-4"
	},
/turf/simulated/wall/prepainted,
/area/template_noop)
"Cg" = (
/obj/machinery/newscaster{
	pixel_y = -28
	},
/obj/structure/table/bench/steel,
/turf/simulated/floor/tiled/monotechmaint,
/area/template_noop)
"Cu" = (
/turf/simulated/wall/prepainted,
/area/template_noop)
"Cz" = (
/obj/machinery/atmospherics/pipe/simple/hidden/cyan{
	dir = 4
	},
/obj/effect/floor_decal/corner_techfloor_grid/full{
	dir = 8
	},
/turf/simulated/floor/tiled/steel_ridged,
/area/template_noop)
"CZ" = (
/obj/machinery/atmospherics/component/unary/engine{
	dir = 8
	},
/turf/simulated/shuttle/plating/airless/carry,
/area/template_noop)
"Dn" = (
/obj/machinery/button/remote/blast_door{
	dir = 4;
	pixel_y = 9;
	id = "Bcaravan2";
	name = "Caravan Front Door"
	},
/obj/structure/table/steel_reinforced,
/turf/simulated/floor/tiled/techfloor,
/area/template_noop)
"Ed" = (
/obj/effect/floor_decal/industrial/outline/yellow,
/turf/simulated/floor/tiled/techfloor,
/area/template_noop)
"Fq" = (
/obj/structure/bed/chair/comfy/brown{
	dir = 8
	},
/turf/simulated/floor/tiled/techfloor,
/area/template_noop)
"FD" = (
/obj/effect/floor_decal/industrial/outline/yellow,
/obj/machinery/light/small,
/turf/simulated/floor/tiled/techfloor,
/area/template_noop)
"FQ" = (
/turf/simulated/floor/wood,
/area/template_noop)
"Ge" = (
/obj/structure/table/steel,
/obj/structure/sink/kitchen,
/obj/effect/floor_decal/corner_techfloor_grid{
	dir = 5
	},
/turf/simulated/floor/tiled/old_tile/white,
/area/template_noop)
"Gh" = (
/obj/machinery/door/blast/regular{
	density = 0;
	dir = 4;
	icon_state = "pdoorc0";
	id = "Bcaravan1";
	name = "Spacenat Caravan Airlock";
	opacity = 0
	},
/obj/machinery/door/airlock/hatch{
	name = "Caravan Airtight Hatch";
	req_one_access = null
	},
/obj/machinery/door/firedoor,
/obj/structure/fans/tiny,
/turf/simulated/floor/tiled/old_tile/blue,
/area/template_noop)
"Gr" = (
/obj/structure/panic_button{
	pixel_y = -28
	},
/turf/simulated/floor/tiled/monotechmaint,
/area/template_noop)
"GB" = (
/obj/structure/cable/green{
	icon_state = "4-8"
	},
/obj/structure/bed/chair/wood{
	dir = 8
	},
/obj/effect/floor_decal/corner_techfloor_grid{
	dir = 10
	},
/turf/simulated/floor/tiled/kafel_full/white,
/area/template_noop)
"GL" = (
/obj/machinery/atmospherics/pipe/simple/hidden/cyan{
	dir = 1
	},
/turf/simulated/floor/tiled/techfloor,
/area/template_noop)
"GP" = (
/obj/spawner/window/low_wall/reinforced/full/firelocks,
/turf/simulated/floor/tiled/techfloor,
/area/template_noop)
"GS" = (
/obj/machinery/atmospherics/pipe/simple/hidden/cyan{
	dir = 4
	},
/obj/structure/table/wooden_reinforced,
/turf/simulated/floor/tiled/kafel_full/white,
/area/template_noop)
"GW" = (
/obj/machinery/atmospherics/pipe/simple/hidden/cyan{
	dir = 4
	},
/obj/effect/floor_decal/corner_techfloor_grid{
	dir = 6
	},
/turf/simulated/floor/tiled/kafel_full/white,
/area/template_noop)
"He" = (
/obj/machinery/atmospherics/pipe/simple/hidden/cyan{
	dir = 4
	},
/obj/structure/bed/chair/wood{
	dir = 4
	},
/obj/effect/floor_decal/corner_techfloor_grid{
	dir = 9
	},
/turf/simulated/floor/tiled/kafel_full/white,
/area/template_noop)
"HF" = (
/obj/structure/cable/green,
/obj/structure/table/steel_reinforced,
/obj/machinery/computer/ship/sensors{
	dir = 1
	},
/obj/machinery/power/apc/alarms_hidden/south_mount{
	req_access = null
	},
/turf/simulated/floor/tiled/techfloor,
/area/template_noop)
"KA" = (
/turf/simulated/floor/tiled/monotechmaint,
/area/template_noop)
"LI" = (
/obj/machinery/atmospherics/pipe/manifold/hidden{
	dir = 8
	},
/obj/effect/floor_decal/corner_techfloor_grid/full{
	dir = 4
	},
/turf/simulated/floor/tiled/steel_ridged,
/area/template_noop)
"LV" = (
/obj/structure/cable/green{
	icon_state = "4-8"
	},
/obj/structure/bed/chair/wood{
	dir = 4
	},
/obj/effect/floor_decal/corner_techfloor_grid/full,
/obj/machinery/light/small,
/turf/simulated/floor/tiled/kafel_full/white,
/area/template_noop)
"Ms" = (
/obj/machinery/telecomms/relay/preset/telecomms,
/obj/structure/cable/green{
	icon_state = "1-8"
	},
/turf/simulated/floor/plating,
/area/template_noop)
"Mt" = (
/obj/effect/floor_decal/corner_techfloor_grid{
	dir = 9
	},
/turf/simulated/floor/tiled/kafel_full/white,
/area/template_noop)
"Nf" = (
/obj/structure/bed/pod,
/obj/structure/bed/pod{
	pixel_y = 16
	},
/turf/simulated/floor/wood,
/area/template_noop)
"NG" = (
/obj/structure/closet/secure_closet/freezer/meat,
/obj/item/reagent_containers/food/drinks/soymilk,
/obj/item/reagent_containers/food/drinks/soymilk,
/obj/item/reagent_containers/food/drinks/bottle/milk,
/obj/item/reagent_containers/food/drinks/bottle/milk,
/obj/item/reagent_containers/food/drinks/bottle/cola,
/obj/item/reagent_containers/food/drinks/bottle/cola,
/obj/item/reagent_containers/food/drinks/bottle/cola,
/obj/item/reagent_containers/food/drinks/bottle/cola,
/obj/item/reagent_containers/food/drinks/bottle/cola,
/obj/item/reagent_containers/food/drinks/bottle/cola,
/obj/item/reagent_containers/food/drinks/bottle/cola,
/obj/item/reagent_containers/food/drinks/bottle/cola,
/obj/item/reagent_containers/food/drinks/bottle/cola,
/obj/item/reagent_containers/food/drinks/bottle/cola,
/obj/item/reagent_containers/food/drinks/bottle/cola,
/obj/item/reagent_containers/food/drinks/bottle/cola,
/obj/item/reagent_containers/food/drinks/bottle/cola,
/obj/item/reagent_containers/food/drinks/bottle/cola,
/obj/item/storage/box/glasses/meta,
/obj/effect/floor_decal/corner_techfloor_grid/full{
	dir = 1
	},
/obj/machinery/light/small{
	dir = 1
	},
/turf/simulated/floor/tiled/kafel_full/white,
/area/template_noop)
"NK" = (
/obj/structure/cable/green{
	icon_state = "1-8"
	},
/obj/structure/shuttle/engine/heater{
	dir = 4
	},
/obj/machinery/atmospherics/pipe/simple/hidden{
	dir = 4
	},
/turf/simulated/wall/prepainted,
/area/template_noop)
"NL" = (
/obj/machinery/atmospherics/portables_connector{
	dir = 1
	},
/obj/machinery/portable_atmospherics/canister/empty/phoron,
/turf/simulated/floor/plating,
/area/template_noop)
"OR" = (
/turf/simulated/wall/prepainted/civilian,
/area/template_noop)
"Pi" = (
/obj/effect/floor_decal/corner_techfloor_grid/full,
/turf/simulated/floor/tiled/steel_ridged,
/area/template_noop)
"Pj" = (
/obj/structure/shuttle/engine/heater{
	dir = 4
	},
/obj/machinery/atmospherics/pipe/simple/hidden{
	dir = 4
	},
/turf/simulated/wall/prepainted,
/area/template_noop)
"Pt" = (
/obj/effect/floor_decal/corner_techfloor_grid/diagonal,
/turf/simulated/floor/tiled/steel_ridged,
/area/template_noop)
"PJ" = (
/obj/machinery/computer/ship/engines{
	dir = 1
	},
/obj/structure/table/steel_reinforced,
/obj/machinery/light/small,
/turf/simulated/floor/tiled/techfloor,
/area/template_noop)
"Qo" = (
/obj/structure/cable/green{
	icon_state = "4-8"
	},
/obj/structure/table/bench/steel,
/turf/simulated/floor/tiled/monotechmaint,
/area/template_noop)
"QJ" = (
/obj/structure/lattice,
/turf/template_noop,
/area/template_noop)
"Rf" = (
/obj/machinery/portable_atmospherics/canister/phoron,
/obj/machinery/atmospherics/portables_connector{
	dir = 1
	},
/turf/simulated/floor/plating,
/area/template_noop)
"Rg" = (
/obj/machinery/power/smes/buildable{
	charge = 15000;
	cur_coils = 3
	},
/obj/structure/cable/green{
	icon_state = "0-2"
	},
/turf/simulated/floor/plating,
/area/template_noop)
"St" = (
/obj/structure/cable/green{
	icon_state = "4-8"
	},
/obj/machinery/atmospherics/pipe/simple/hidden/cyan{
	dir = 9
	},
/turf/simulated/floor/tiled/techfloor,
/area/template_noop)
"SK" = (
/obj/structure/cable/green{
	icon_state = "4-8"
	},
/obj/machinery/atmospherics/valve{
	dir = 4
	},
/turf/simulated/floor/tiled/techfloor,
/area/template_noop)
"ST" = (
/obj/structure/cable/orange{
	icon_state = "1-4"
	},
/turf/simulated/wall/prepainted,
/area/template_noop)
"UC" = (
/obj/structure/cable/green{
	icon_state = "4-8"
	},
/turf/simulated/floor/tiled/techfloor,
/area/template_noop)
"UF" = (
/obj/structure/table/steel_reinforced,
/obj/item/gps/internal/base{
	name = "Caravan Beacon";
	gps_tag = "CARGORAVAN"
	},
/obj/machinery/light/small{
	dir = 1
	},
/obj/machinery/computer/shuttle_control/explore/cargoravana,
/turf/simulated/floor/tiled/techfloor,
/area/template_noop)
"Wb" = (
/obj/structure/table/steel,
/obj/machinery/microwave,
/obj/machinery/light/small{
	dir = 1
	},
/obj/machinery/air_alarm/alarms_hidden/north_mount{
	req_one_access = null
	},
/obj/effect/floor_decal/corner_techfloor_grid/full{
	dir = 8
	},
/turf/simulated/floor/tiled/kafel_full/white,
/area/template_noop)
"WR" = (
/turf/simulated/floor/tiled/techfloor/monogrid,
/area/template_noop)
"Xg" = (
/obj/structure/bed/chair/sofa/brown/left{
	dir = 8
	},
/obj/machinery/light/small,
/turf/simulated/floor/tiled/monotechmaint,
/area/template_noop)
"XF" = (
/obj/machinery/computer/ship/helm{
	req_one_access = null
	},
/obj/structure/table/steel_reinforced,
/obj/machinery/embedded_controller/radio/airlock/docking_port{
	pixel_y = 30;
	pixel_x = -6;
	id_tag = "tradeport_caravan_docker"
	},
/turf/simulated/floor/tiled/techfloor,
/area/template_noop)
"Yo" = (
/turf/simulated/floor/tiled/kafel_full/white,
/area/template_noop)
"Zc" = (
/obj/machinery/door/blast/regular{
	density = 0;
	dir = 4;
	icon_state = "pdoorc0";
	id = "Bcaravan1";
	name = "Spacenat Caravan Airlock";
	opacity = 0
	},
/obj/machinery/button/remote/blast_door{
	id = "Bcaravan1";
	name = "Caravan Back Door";
	pixel_x = 26
	},
/obj/machinery/door/airlock/hatch{
	name = "Caravan Airtight Hatch";
	req_one_access = null
	},
/obj/machinery/door/firedoor,
/obj/structure/fans/tiny,
/turf/simulated/floor/tiled/old_tile/blue,
/area/template_noop)
"ZJ" = (
/obj/machinery/atmospherics/pipe/simple/hidden/cyan{
	dir = 4
	},
/obj/machinery/door/airlock/hatch{
	name = "Caravan Airtight Hatch";
	req_one_access = null
	},
/turf/simulated/floor/tiled/old_tile/yellow,
/area/template_noop)

(1,1,1) = {"
vN
vN
OR
xf
xf
xf
xf
OR
vN
vN
"}
(2,1,1) = {"
vN
vN
xf
UF
Dn
ov
PJ
xf
vN
vN
"}
(3,1,1) = {"
vN
vN
OR
XF
Fq
zm
HF
OR
vN
vN
"}
(4,1,1) = {"
vN
vN
hT
eZ
eZ
vh
Gr
OR
vN
vN
"}
(5,1,1) = {"
vN
vN
OR
jZ
eZ
oI
lI
OR
vN
vN
"}
(6,1,1) = {"
vN
vN
xJ
WR
eZ
Qo
Cg
OR
vN
vN
"}
(7,1,1) = {"
vN
vN
QJ
eZ
eZ
bl
Xg
OR
OR
vN
"}
(8,1,1) = {"
vN
vN
vN
QJ
WR
SK
eZ
wR
OR
OR
"}
(9,1,1) = {"
vN
vN
QJ
pq
GL
St
eZ
eZ
mQ
Gh
"}
(10,1,1) = {"
QJ
QJ
KA
qc
eZ
UC
eZ
eZ
eZ
Zc
"}
(11,1,1) = {"
OR
Cu
KA
gp
Aj
kD
Ed
Ed
FD
OR
"}
(12,1,1) = {"
OR
Wb
Mt
He
LV
Cu
qi
qi
qi
GP
"}
(13,1,1) = {"
GP
Ge
Yo
GS
mi
Cu
Cu
Cu
Cu
OR
"}
(14,1,1) = {"
GP
nh
Yo
bG
GB
Cu
Nf
FQ
Nf
GP
"}
(15,1,1) = {"
OR
NG
uj
GW
fj
gl
FQ
nG
FQ
GP
"}
(16,1,1) = {"
OR
Cu
Cu
ZJ
aY
Cu
Cu
Cu
Cu
OR
"}
(17,1,1) = {"
Cu
Cu
Cu
Cz
wq
Pt
Pi
Cu
Cu
Cu
"}
(18,1,1) = {"
vN
kt
ST
gp
tf
LI
wN
Cu
Cu
vN
"}
(19,1,1) = {"
vN
vN
iz
lS
NK
Pj
sd
NL
vN
vN
"}
(20,1,1) = {"
vN
vN
Rg
Ms
CZ
CZ
ix
Rf
vN
vN
"}
