//MAP CONVERTED BY dmm2tgm.py THIS HEADER COMMENT PREVENTS RECONVERSION, DO NOT REMOVE
"an" = (
/obj/effect/floor_decal/industrial/warning{
	dir = 4
	},
/turf/simulated/floor/tiled/techfloor,
/area/submap/osiris_field/pirate_wreck2)
"aA" = (
/obj/machinery/door/blast/regular{
	dir = 4;
	id = "hammerheadfsb";
	name = "Fighter Launch Tube"
	},
/turf/simulated/floor/maglev{
	desc = "Magnetic propulsion fighter launch rails. Caution! Electrified!";
	dir = 8;
	name = "launch rail"
	},
/area/submap/osiris_field/pirate_wreck2)
"aE" = (
/obj/structure/catwalk,
/obj/machinery/light/no_nightshift,
/turf/simulated/floor/plating,
/area/submap/osiris_field/pirate_wreck2)
"aH" = (
/obj/machinery/light/no_nightshift{
	dir = 1;
	old_wall = 1
	},
/turf/simulated/floor/maglev{
	desc = "Magnetic propulsion fighter launch rails. Caution! Electrified!";
	dir = 8;
	name = "launch rail"
	},
/area/submap/osiris_field/pirate_wreck2)
"bh" = (
/obj/structure/table/steel_reinforced,
/obj/machinery/light/no_nightshift{
	dir = 8;
	old_wall = 1
	},
/obj/structure/closet/medical_wall{
	pixel_x = -32
	},
/obj/effect/floor_decal/corner_techfloor_grid{
	dir = 9
	},
/obj/item/storage/firstaid/regular,
/obj/item/storage/single_use/med_pouch/trauma{
	pixel_x = -3;
	pixel_y = 3
	},
/obj/item/storage/single_use/med_pouch/burn{
	pixel_x = 3;
	pixel_y = 3
	},
/turf/simulated/floor/tiled/steel_ridged,
/area/submap/osiris_field/pirate_wreck2)
"cN" = (
/obj/machinery/door/firedoor/glass,
/obj/machinery/door/airlock/voidcraft/vertical,
/turf/simulated/floor/tiled/techfloor,
/area/submap/osiris_field/pirate_wreck2)
"dH" = (
/obj/random/multiple/treasure,
/obj/random/contraband,
/turf/simulated/floor/tiled/techfloor/monogrid,
/area/submap/osiris_field/pirate_wreck2)
"dL" = (
/obj/effect/floor_decal/borderfloorblack{
	dir = 8
	},
/obj/effect/floor_decal/industrial/warning{
	dir = 9
	},
/turf/simulated/floor/reinforced,
/area/submap/osiris_field/pirate_wreck2)
"ec" = (
/obj/structure/closet/walllocker/emergsuit_wall{
	dir = 8;
	pixel_x = -32
	},
/obj/structure/sign/warning/high_voltage,
/turf/simulated/wall/pshull,
/area/submap/osiris_field/pirate_wreck2)
"eq" = (
/obj/effect/floor_decal/corner_techfloor_grid/full,
/obj/structure/salvageable/console_broken_os{
	dir = 4
	},
/turf/simulated/floor/tiled/steel_ridged,
/area/submap/osiris_field/pirate_wreck2)
"eu" = (
/obj/structure/bed/chair/bay/shuttle{
	dir = 8;
	name = "Pilot's Seat"
	},
/obj/effect/floor_decal/corner_techfloor_grid{
	dir = 1
	},
/turf/simulated/floor/tiled/steel_ridged,
/area/submap/osiris_field/pirate_wreck2)
"eP" = (
/obj/machinery/atmospherics/pipe/simple/hidden/cyan{
	dir = 4
	},
/obj/effect/floor_decal/borderfloorblack{
	dir = 4
	},
/obj/structure/cable/orange{
	icon_state = "4-8"
	},
/obj/effect/decal/mecha_wreckage/duke/cw,
/turf/simulated/floor/reinforced,
/area/submap/osiris_field/pirate_wreck2)
"eS" = (
/obj/structure/cable/orange{
	icon_state = "1-2"
	},
/obj/machinery/door/window/brigdoor/southright{
	name = "Cockpit Access"
	},
/obj/effect/floor_decal/industrial/warning,
/obj/machinery/door/firedoor/glass,
/turf/simulated/floor/tiled/techfloor,
/area/submap/osiris_field/pirate_wreck2)
"gm" = (
/turf/template_noop,
/area/template_noop)
"gp" = (
/obj/machinery/light/no_nightshift{
	dir = 8
	},
/obj/effect/floor_decal/corner_techfloor_grid/full,
/obj/item/radio/intercom/department/security{
	dir = 8;
	pixel_x = -24
	},
/obj/structure/salvageable/console_broken_os{
	dir = 4
	},
/turf/simulated/floor/tiled/steel_ridged,
/area/submap/osiris_field/pirate_wreck2)
"gZ" = (
/obj/effect/floor_decal/corner_techfloor_grid/full{
	dir = 4
	},
/turf/simulated/floor/tiled/steel_ridged,
/area/submap/osiris_field/pirate_wreck2)
"hu" = (
/obj/effect/floor_decal/corner_techfloor_grid{
	dir = 6
	},
/mob/living/simple_mob/animal/space/carp,
/turf/simulated/floor/tiled/steel_ridged,
/area/submap/osiris_field/pirate_wreck2)
"hO" = (
/obj/effect/floor_decal/corner_techfloor_grid/full{
	dir = 4
	},
/obj/effect/floor_decal/industrial/warning/corner,
/obj/structure/catwalk,
/turf/simulated/floor/plating,
/area/submap/osiris_field/pirate_wreck2)
"hQ" = (
/obj/structure/bed/chair/bay/shuttle{
	dir = 8
	},
/obj/effect/floor_decal/corner_techfloor_grid/full{
	dir = 1
	},
/turf/simulated/floor/tiled/steel_ridged,
/area/submap/osiris_field/pirate_wreck2)
"ix" = (
/mob/living/simple_mob/animal/space/carp,
/turf/simulated/floor/reinforced,
/area/submap/osiris_field/pirate_wreck2)
"iM" = (
/obj/machinery/atmospheric_field_generator/perma,
/obj/machinery/door/blast/regular{
	dir = 4;
	id = "hammerheadfsb";
	name = "Fighter Launch Tube"
	},
/turf/simulated/floor/maglev{
	desc = "Magnetic propulsion fighter launch rails. Caution! Electrified!";
	dir = 8;
	name = "launch rail"
	},
/area/submap/osiris_field/pirate_wreck2)
"jf" = (
/obj/effect/floor_decal/corner_techfloor_grid/full{
	dir = 8
	},
/obj/structure/salvageable/console_broken_os{
	dir = 4
	},
/turf/simulated/floor/tiled/steel_ridged,
/area/submap/osiris_field/pirate_wreck2)
"jx" = (
/obj/structure/cable/orange{
	icon_state = "2-8"
	},
/obj/structure/cable/orange{
	icon_state = "1-2"
	},
/obj/effect/floor_decal/corner_techfloor_grid{
	dir = 10
	},
/turf/simulated/floor/tiled/steel_ridged,
/area/submap/osiris_field/pirate_wreck2)
"jG" = (
/obj/effect/floor_decal/corner_techfloor_gray/full,
/obj/structure/catwalk,
/turf/simulated/floor/plating,
/area/submap/osiris_field/pirate_wreck2)
"jJ" = (
/obj/item/spacecash/c100,
/obj/random/coin,
/turf/simulated/floor/tiled/techfloor/monogrid,
/area/submap/osiris_field/pirate_wreck2)
"jN" = (
/obj/structure/table/steel_reinforced,
/obj/machinery/light/no_nightshift{
	dir = 1;
	old_wall = 1
	},
/obj/structure/closet/walllocker/emergsuit_wall{
	dir = 4;
	pixel_x = 32
	},
/obj/effect/floor_decal/corner_techfloor_grid/full{
	dir = 1
	},
/turf/simulated/floor/tiled/steel_ridged,
/area/submap/osiris_field/pirate_wreck2)
"jQ" = (
/obj/structure/handrail{
	dir = 1
	},
/turf/simulated/floor/tiled/techfloor/grid,
/area/submap/osiris_field/pirate_wreck2)
"jV" = (
/obj/structure/cable/orange{
	icon_state = "4-8"
	},
/turf/simulated/floor/maglev{
	desc = "Magnetic propulsion fighter launch rails. Caution! Electrified!";
	dir = 8;
	name = "launch rail"
	},
/area/submap/osiris_field/pirate_wreck2)
"kq" = (
/obj/effect/floor_decal/borderfloorblack{
	dir = 4
	},
/obj/effect/floor_decal/industrial/warning{
	dir = 5
	},
/turf/simulated/floor/reinforced,
/area/submap/osiris_field/pirate_wreck2)
"kA" = (
/obj/structure/handrail{
	dir = 1
	},
/obj/machinery/door/window/brigdoor/northleft{
	dir = 8;
	name = "Holding Cell"
	},
/obj/random/coin,
/turf/simulated/floor/tiled/techfloor/monogrid,
/area/submap/osiris_field/pirate_wreck2)
"lc" = (
/obj/machinery/atmospheric_field_generator/perma,
/obj/machinery/door/blast/regular{
	dir = 4;
	id = "hammerfighterport";
	name = "Port Fighter Bay"
	},
/obj/effect/floor_decal/borderfloorblack{
	dir = 8
	},
/turf/simulated/floor/tiled/techmaint,
/area/submap/osiris_field/pirate_wreck2)
"lI" = (
/obj/structure/table/steel_reinforced,
/obj/machinery/light/no_nightshift,
/obj/structure/closet/walllocker/emergsuit_wall{
	dir = 4;
	pixel_x = 32
	},
/obj/effect/floor_decal/corner_techfloor_grid/full{
	dir = 4
	},
/turf/simulated/floor/tiled/steel_ridged,
/area/submap/osiris_field/pirate_wreck2)
"md" = (
/obj/machinery/mech_recharger,
/obj/effect/floor_decal/industrial/warning{
	dir = 4
	},
/obj/machinery/light/no_nightshift{
	dir = 1;
	old_wall = 1
	},
/turf/simulated/floor/maglev{
	desc = "Magnetic propulsion fighter launch rails. Caution! Electrified!";
	dir = 8;
	name = "launch rail"
	},
/area/submap/osiris_field/pirate_wreck2)
"mK" = (
/obj/structure/handrail{
	dir = 1
	},
/mob/living/simple_mob/animal/space/carp,
/turf/simulated/floor/tiled/techfloor/grid,
/area/submap/osiris_field/pirate_wreck2)
"mY" = (
/obj/structure/cable/orange{
	icon_state = "4-8"
	},
/obj/machinery/mech_recharger,
/obj/effect/floor_decal/industrial/warning{
	dir = 4
	},
/turf/simulated/floor/maglev{
	desc = "Magnetic propulsion fighter launch rails. Caution! Electrified!";
	dir = 8;
	name = "launch rail"
	},
/area/submap/osiris_field/pirate_wreck2)
"nD" = (
/obj/machinery/door/firedoor/glass,
/obj/effect/floor_decal/industrial/warning,
/obj/machinery/door/airlock/voidcraft/vertical,
/turf/simulated/floor/tiled/techfloor,
/area/submap/osiris_field/pirate_wreck2)
"oE" = (
/obj/machinery/atmospherics/pipe/simple/hidden/cyan{
	dir = 4
	},
/obj/structure/cable/orange{
	icon_state = "4-8"
	},
/obj/effect/floor_decal/corner_techfloor_gray/full{
	dir = 8
	},
/obj/structure/catwalk,
/turf/simulated/floor/plating,
/area/submap/osiris_field/pirate_wreck2)
"oW" = (
/obj/item/radio/beacon/anchored,
/turf/simulated/floor/tiled/steel_ridged,
/area/submap/osiris_field/pirate_wreck2)
"pn" = (
/obj/machinery/door/blast/regular{
	dir = 4;
	id = "hammerheadsbc";
	name = "Starboard Cargo Door"
	},
/obj/machinery/atmospheric_field_generator/perma,
/turf/simulated/floor/tiled/techmaint,
/area/submap/osiris_field/pirate_wreck2)
"pv" = (
/turf/simulated/shuttle/wall/voidcraft/red/hard_corner,
/area/submap/osiris_field/pirate_wreck2)
"pA" = (
/obj/structure/cable/orange{
	icon_state = "4-8"
	},
/obj/machinery/door/blast/regular{
	dir = 4;
	id = "hammerheadtba";
	name = "Fighter Launch Tube Access"
	},
/obj/effect/floor_decal/borderfloorblack,
/turf/simulated/floor/reinforced,
/area/submap/osiris_field/pirate_wreck2)
"qw" = (
/obj/machinery/light/no_nightshift{
	old_wall = 1
	},
/turf/simulated/floor/maglev{
	desc = "Magnetic propulsion fighter launch rails. Caution! Electrified!";
	dir = 8;
	name = "launch rail"
	},
/area/submap/osiris_field/pirate_wreck2)
"qA" = (
/obj/machinery/door/blast/regular{
	dir = 4;
	id = "hammerheadfsb";
	name = "Fighter Launch Tube"
	},
/obj/machinery/atmospheric_field_generator/perma,
/turf/simulated/floor/maglev{
	desc = "Magnetic propulsion fighter launch rails. Caution! Electrified!";
	dir = 8;
	name = "launch rail"
	},
/area/submap/osiris_field/pirate_wreck2)
"qB" = (
/obj/machinery/atmospheric_field_generator/perma,
/obj/machinery/door/blast/regular{
	dir = 4;
	id = "hammerfighterport";
	name = "Port Fighter Bay"
	},
/turf/simulated/floor/tiled/techmaint,
/area/submap/osiris_field/pirate_wreck2)
"rq" = (
/obj/effect/floor_decal/borderfloorblack{
	dir = 8
	},
/obj/effect/floor_decal/industrial/warning{
	dir = 8
	},
/obj/effect/decal/mecha_wreckage/duke/cw,
/turf/simulated/floor/reinforced,
/area/submap/osiris_field/pirate_wreck2)
"rX" = (
/obj/machinery/light/no_nightshift{
	dir = 1;
	old_wall = 1
	},
/obj/random/multiple/treasure,
/turf/simulated/floor/tiled/techfloor/monogrid,
/area/submap/osiris_field/pirate_wreck2)
"sC" = (
/obj/structure/closet/secure_closet/guncabinet{
	anchored = 1
	},
/obj/effect/floor_decal/corner_techfloor_grid/full,
/obj/structure/closet/hydrant{
	dir = 4;
	pixel_x = -32
	},
/turf/simulated/floor/tiled/steel_ridged,
/area/submap/osiris_field/pirate_wreck2)
"sZ" = (
/obj/machinery/atmospheric_field_generator/perma,
/obj/machinery/door/blast/regular{
	dir = 4;
	id = "hammerfighterport";
	name = "Port Fighter Bay"
	},
/obj/effect/floor_decal/borderfloorblack{
	dir = 4
	},
/turf/simulated/floor/tiled/techmaint,
/area/submap/osiris_field/pirate_wreck2)
"td" = (
/obj/structure/cable/orange{
	icon_state = "4-8"
	},
/obj/structure/handrail{
	dir = 1
	},
/obj/effect/floor_decal/corner_techfloor_grid{
	dir = 10
	},
/obj/structure/closet/walllocker/emergsuit_wall{
	dir = 8;
	pixel_x = -32;
	pixel_y = -24
	},
/turf/simulated/floor/tiled/steel_ridged,
/area/submap/osiris_field/pirate_wreck2)
"um" = (
/mob/living/simple_mob/animal/space/carp,
/turf/simulated/floor/tiled/techfloor/grid,
/area/submap/osiris_field/pirate_wreck2)
"uP" = (
/obj/spawner/window/low_wall/reinforced/firelocks,
/obj/machinery/computer/secure_data,
/turf/simulated/floor/plating,
/area/submap/osiris_field/pirate_wreck2)
"uU" = (
/obj/structure/table/rack/shelf/steel,
/turf/simulated/floor/tiled/steel_ridged,
/area/submap/osiris_field/pirate_wreck2)
"vm" = (
/obj/effect/floor_decal/industrial/warning{
	dir = 1
	},
/turf/simulated/floor/reinforced,
/area/submap/osiris_field/pirate_wreck2)
"vW" = (
/obj/structure/cable/orange{
	icon_state = "4-8"
	},
/obj/machinery/mech_recharger,
/turf/simulated/floor/maglev{
	desc = "Magnetic propulsion fighter launch rails. Caution! Electrified!";
	dir = 8;
	name = "launch rail"
	},
/area/submap/osiris_field/pirate_wreck2)
"vZ" = (
/obj/structure/cable/orange{
	icon_state = "4-8"
	},
/obj/structure/bed/chair/bay/shuttle,
/obj/machinery/light/no_nightshift{
	dir = 1;
	old_wall = 1
	},
/obj/effect/floor_decal/corner_techfloor_grid{
	dir = 5
	},
/turf/simulated/floor/tiled/steel_ridged,
/area/submap/osiris_field/pirate_wreck2)
"wg" = (
/obj/structure/handrail{
	dir = 8
	},
/obj/effect/floor_decal/corner_techfloor_grid{
	dir = 6
	},
/turf/simulated/floor/tiled/steel_ridged,
/area/submap/osiris_field/pirate_wreck2)
"wU" = (
/obj/effect/floor_decal/corner_techfloor_grid{
	dir = 10
	},
/obj/structure/table/steel_reinforced,
/obj/structure/cable/orange{
	icon_state = "0-4"
	},
/obj/machinery/recharger{
	pixel_x = 5;
	pixel_y = 3
	},
/obj/machinery/recharger{
	pixel_x = -5;
	pixel_y = 3
	},
/turf/simulated/floor/tiled/steel_ridged,
/area/submap/osiris_field/pirate_wreck2)
"xk" = (
/obj/structure/cable/orange{
	icon_state = "1-4"
	},
/obj/structure/cable/orange{
	icon_state = "2-4"
	},
/turf/simulated/floor/maglev{
	desc = "Magnetic propulsion fighter launch rails. Caution! Electrified!";
	dir = 8;
	name = "launch rail"
	},
/area/submap/osiris_field/pirate_wreck2)
"xZ" = (
/obj/effect/floor_decal/corner_techfloor_grid/diagonal,
/obj/effect/floor_decal/industrial/warning{
	dir = 5
	},
/turf/simulated/floor/tiled/techfloor,
/area/submap/osiris_field/pirate_wreck2)
"ye" = (
/obj/effect/floor_decal/corner_techfloor_grid{
	dir = 6
	},
/turf/simulated/floor/tiled/steel_ridged,
/area/submap/osiris_field/pirate_wreck2)
"yH" = (
/obj/machinery/mech_recharger,
/obj/machinery/light/no_nightshift{
	dir = 1;
	old_wall = 1
	},
/turf/simulated/floor/maglev{
	desc = "Magnetic propulsion fighter launch rails. Caution! Electrified!";
	dir = 8;
	name = "launch rail"
	},
/area/submap/osiris_field/pirate_wreck2)
"zh" = (
/obj/structure/cable/orange{
	icon_state = "4-8"
	},
/obj/effect/floor_decal/borderfloorblack,
/turf/simulated/floor/reinforced,
/area/submap/osiris_field/pirate_wreck2)
"zn" = (
/obj/effect/floor_decal/corner_techfloor_grid/full,
/obj/structure/salvageable/console_broken_os{
	dir = 1
	},
/turf/simulated/floor/tiled/steel_ridged,
/area/submap/osiris_field/pirate_wreck2)
"zO" = (
/obj/effect/floor_decal/borderfloorblack{
	dir = 5
	},
/turf/simulated/floor/reinforced,
/area/submap/osiris_field/pirate_wreck2)
"zS" = (
/obj/structure/lattice,
/obj/structure/catwalk,
/turf/template_noop,
/area/template_noop)
"Ad" = (
/obj/spawner/window/low_wall/reinforced/firelocks,
/turf/simulated/floor/tiled/techfloor,
/area/submap/osiris_field/pirate_wreck2)
"Az" = (
/obj/structure/bed/chair/bay/shuttle{
	dir = 8
	},
/obj/effect/floor_decal/corner_techfloor_grid{
	dir = 8
	},
/turf/simulated/floor/tiled/steel_ridged,
/area/submap/osiris_field/pirate_wreck2)
"AX" = (
/obj/machinery/atmospherics/pipe/simple/hidden/cyan{
	dir = 4
	},
/obj/structure/cable/orange{
	icon_state = "4-8"
	},
/turf/simulated/floor/reinforced,
/area/submap/osiris_field/pirate_wreck2)
"Bw" = (
/obj/structure/cable/orange{
	icon_state = "4-8"
	},
/obj/machinery/atmospherics/pipe/manifold/hidden/cyan{
	dir = 1
	},
/turf/simulated/floor/reinforced,
/area/submap/osiris_field/pirate_wreck2)
"By" = (
/turf/simulated/floor/tiled/techfloor/grid,
/area/submap/osiris_field/pirate_wreck2)
"BF" = (
/obj/structure/cable/orange{
	icon_state = "1-2"
	},
/obj/effect/floor_decal/industrial/warning{
	dir = 8
	},
/turf/simulated/floor/tiled/techfloor,
/area/template_noop)
"Cp" = (
/obj/structure/cable/orange{
	icon_state = "1-2"
	},
/obj/machinery/door/window/brigdoor/southright{
	dir = 1;
	name = "Cockpit Access";
	req_access = list(2);
	req_one_access = list(2)
	},
/obj/effect/floor_decal/industrial/warning{
	dir = 1
	},
/obj/machinery/door/firedoor/glass,
/turf/simulated/floor/tiled/techfloor,
/area/submap/osiris_field/pirate_wreck2)
"CO" = (
/obj/machinery/door/blast/regular{
	dir = 4;
	id = "hammerheadtba";
	name = "Fighter Launch Tube Access"
	},
/obj/effect/floor_decal/borderfloorblack{
	dir = 1
	},
/turf/simulated/floor/reinforced,
/area/submap/osiris_field/pirate_wreck2)
"Dg" = (
/turf/simulated/floor/reinforced,
/area/submap/osiris_field/pirate_wreck2)
"Ds" = (
/turf/simulated/floor/tiled/steel_ridged,
/area/submap/osiris_field/pirate_wreck2)
"Fr" = (
/obj/structure/cable/orange{
	icon_state = "4-8"
	},
/obj/effect/floor_decal/corner_techfloor_grid{
	dir = 5
	},
/obj/structure/bed/chair/bay/shuttle,
/turf/simulated/floor/tiled/steel_ridged,
/area/submap/osiris_field/pirate_wreck2)
"FB" = (
/obj/effect/floor_decal/borderfloorblack{
	dir = 8
	},
/obj/effect/floor_decal/industrial/warning{
	dir = 10
	},
/turf/simulated/floor/reinforced,
/area/submap/osiris_field/pirate_wreck2)
"FC" = (
/obj/effect/floor_decal/borderfloorblack{
	dir = 1
	},
/turf/simulated/floor/reinforced,
/area/submap/osiris_field/pirate_wreck2)
"Gk" = (
/obj/structure/cable/orange{
	icon_state = "1-8"
	},
/obj/effect/floor_decal/corner_techfloor_grid/full{
	dir = 1
	},
/turf/simulated/floor/tiled/steel_ridged,
/area/submap/osiris_field/pirate_wreck2)
"KE" = (
/turf/simulated/floor/maglev{
	desc = "Magnetic propulsion fighter launch rails. Caution! Electrified!";
	dir = 8;
	name = "launch rail"
	},
/area/submap/osiris_field/pirate_wreck2)
"KJ" = (
/turf/simulated/floor/plating,
/area/template_noop)
"Lb" = (
/obj/structure/closet/hydrant{
	pixel_y = 32
	},
/turf/simulated/floor/tiled/techfloor/grid,
/area/submap/osiris_field/pirate_wreck2)
"Lo" = (
/obj/machinery/light/no_nightshift{
	dir = 8;
	old_wall = 1
	},
/obj/structure/table/steel_reinforced,
/obj/machinery/recharger{
	pixel_x = -5;
	pixel_y = 3
	},
/obj/machinery/recharger{
	pixel_x = 5;
	pixel_y = 3
	},
/obj/structure/cable/orange{
	icon_state = "0-4"
	},
/obj/effect/floor_decal/corner_techfloor_grid/full{
	dir = 8
	},
/turf/simulated/floor/tiled/steel_ridged,
/area/submap/osiris_field/pirate_wreck2)
"LE" = (
/mob/living/simple_mob/animal/space/carp,
/turf/simulated/floor/maglev{
	desc = "Magnetic propulsion fighter launch rails. Caution! Electrified!";
	dir = 8;
	name = "launch rail"
	},
/area/submap/osiris_field/pirate_wreck2)
"LG" = (
/obj/machinery/door/window/brigdoor/southright{
	dir = 8;
	name = "Flight Operations Access";
	req_access = list(2);
	req_one_access = list(2)
	},
/turf/simulated/floor/tiled/steel_ridged,
/area/submap/osiris_field/pirate_wreck2)
"Nz" = (
/turf/simulated/floor/plating,
/area/submap/osiris_field/pirate_wreck2)
"NO" = (
/mob/living/simple_mob/animal/space/carp,
/turf/template_noop,
/area/template_noop)
"NQ" = (
/obj/structure/cable/orange{
	icon_state = "1-2"
	},
/obj/effect/floor_decal/corner_techfloor_grid{
	dir = 4
	},
/mob/living/simple_mob/animal/space/carp,
/turf/simulated/floor/tiled/steel_ridged,
/area/submap/osiris_field/pirate_wreck2)
"Or" = (
/obj/structure/cable/orange{
	icon_state = "1-2"
	},
/turf/simulated/floor/maglev{
	desc = "Magnetic propulsion fighter launch rails. Caution! Electrified!";
	dir = 8;
	name = "launch rail"
	},
/area/submap/osiris_field/pirate_wreck2)
"Pg" = (
/obj/machinery/door/firedoor/glass,
/obj/machinery/door/airlock/voidcraft/vertical,
/turf/simulated/floor/tiled/techfloor/grid,
/area/submap/osiris_field/pirate_wreck2)
"Pj" = (
/obj/effect/floor_decal/industrial/warning,
/turf/simulated/floor/reinforced,
/area/submap/osiris_field/pirate_wreck2)
"PT" = (
/obj/structure/handrail{
	dir = 1
	},
/obj/item/radio/intercom/department/security{
	pixel_y = -24
	},
/turf/simulated/floor/tiled/techfloor/grid,
/area/submap/osiris_field/pirate_wreck2)
"Qr" = (
/obj/spawner/window/low_wall/reinforced/firelocks,
/turf/simulated/floor/plating,
/area/submap/osiris_field/pirate_wreck2)
"QR" = (
/obj/machinery/door/window/brigdoor/northright{
	dir = 8;
	name = "Holding Cell"
	},
/obj/structure/handrail,
/obj/random/multiple/treasure,
/obj/random/contraband,
/turf/simulated/floor/tiled/techfloor/monogrid,
/area/submap/osiris_field/pirate_wreck2)
"QU" = (
/obj/structure/cable/orange{
	icon_state = "4-8"
	},
/obj/machinery/door/blast/regular{
	dir = 4;
	id = "hammerheadfsb";
	name = "Fighter Launch Tube"
	},
/turf/simulated/floor/maglev{
	desc = "Magnetic propulsion fighter launch rails. Caution! Electrified!";
	dir = 8;
	name = "launch rail"
	},
/area/submap/osiris_field/pirate_wreck2)
"Rd" = (
/obj/effect/floor_decal/corner_techfloor_grid/full{
	dir = 4
	},
/obj/spawner/window/low_wall/reinforced/firelocks,
/turf/simulated/floor/tiled/steel_ridged,
/area/submap/osiris_field/pirate_wreck2)
"Rs" = (
/obj/structure/catwalk,
/obj/structure/lattice,
/turf/template_noop,
/area/template_noop)
"RH" = (
/obj/machinery/light/no_nightshift{
	dir = 1;
	old_wall = 1
	},
/obj/machinery/air_alarm/alarms_hidden/west_mount,
/turf/simulated/floor/tiled/techfloor/grid,
/area/submap/osiris_field/pirate_wreck2)
"RI" = (
/obj/effect/floor_decal/industrial/warning{
	dir = 4
	},
/obj/structure/table/rack/shelf/steel,
/obj/item/storage/toolbox/mechanical{
	pixel_y = 10
	},
/obj/item/storage/toolbox/electrical{
	pixel_y = -4
	},
/turf/simulated/floor/tiled/techfloor,
/area/submap/osiris_field/pirate_wreck2)
"SL" = (
/obj/machinery/light/no_nightshift{
	dir = 1;
	old_wall = 1
	},
/obj/structure/lattice,
/obj/structure/catwalk,
/obj/structure/marker_beacon/red,
/turf/template_noop,
/area/template_noop)
"SS" = (
/obj/effect/floor_decal/borderfloorblack{
	dir = 4
	},
/obj/effect/floor_decal/industrial/warning{
	dir = 6
	},
/turf/simulated/floor/reinforced,
/area/submap/osiris_field/pirate_wreck2)
"Tm" = (
/obj/structure/bed/chair/bay/shuttle{
	dir = 8;
	name = "Copilot's Seat"
	},
/obj/effect/floor_decal/corner_techfloor_grid{
	dir = 1
	},
/turf/simulated/floor/tiled/steel_ridged,
/area/submap/osiris_field/pirate_wreck2)
"Tn" = (
/obj/structure/cable/orange{
	icon_state = "4-8"
	},
/obj/effect/floor_decal/borderfloorblack,
/mob/living/simple_mob/animal/space/carp/large/huge/roguemines,
/turf/simulated/floor/reinforced,
/area/submap/osiris_field/pirate_wreck2)
"Tz" = (
/obj/effect/floor_decal/industrial/warning/corner,
/obj/machinery/light/no_nightshift,
/obj/structure/catwalk,
/turf/simulated/floor/plating,
/area/submap/osiris_field/pirate_wreck2)
"TE" = (
/obj/effect/floor_decal/corner_techfloor_grid{
	dir = 6
	},
/obj/structure/cable/orange{
	icon_state = "0-2"
	},
/turf/simulated/floor/tiled/steel_ridged,
/area/submap/osiris_field/pirate_wreck2)
"VT" = (
/obj/effect/floor_decal/corner_techfloor_grid/full{
	dir = 8
	},
/obj/structure/salvageable/console_broken_os,
/turf/simulated/floor/tiled/steel_ridged,
/area/submap/osiris_field/pirate_wreck2)
"Wo" = (
/obj/effect/floor_decal/corner_techfloor_grid/full,
/obj/effect/floor_decal/industrial/warning/corner{
	dir = 8
	},
/obj/structure/catwalk,
/turf/simulated/floor/plating,
/area/submap/osiris_field/pirate_wreck2)
"Wz" = (
/turf/simulated/wall/pshull,
/area/submap/osiris_field/pirate_wreck2)
"WG" = (
/obj/machinery/computer/ship/navigation/telescreen{
	pixel_x = 32
	},
/obj/structure/table/rack/shelf/steel,
/turf/simulated/floor/tiled/steel_ridged,
/area/submap/osiris_field/pirate_wreck2)
"WQ" = (
/obj/effect/floor_decal/industrial/warning/full,
/obj/machinery/light/no_nightshift,
/turf/simulated/floor/tiled/techfloor,
/area/submap/osiris_field/pirate_wreck2)
"YM" = (
/obj/structure/cable/orange{
	icon_state = "4-8"
	},
/obj/machinery/atmospherics/pipe/simple/hidden/cyan{
	dir = 6
	},
/obj/effect/floor_decal/borderfloorblack/corner{
	dir = 8
	},
/turf/simulated/floor/reinforced,
/area/submap/osiris_field/pirate_wreck2)
"YV" = (
/obj/effect/floor_decal/borderfloorblack{
	dir = 4
	},
/obj/effect/floor_decal/industrial/warning{
	dir = 4
	},
/mob/living/simple_mob/animal/space/carp,
/turf/simulated/floor/reinforced,
/area/submap/osiris_field/pirate_wreck2)
"Zb" = (
/obj/structure/catwalk,
/turf/simulated/floor/plating,
/area/submap/osiris_field/pirate_wreck2)
"ZN" = (
/obj/effect/floor_decal/industrial/warning/corner{
	dir = 4
	},
/turf/simulated/wall/pshull,
/area/submap/osiris_field/pirate_wreck2)

(1,1,1) = {"
gm
gm
gm
gm
gm
gm
gm
gm
gm
gm
gm
gm
gm
gm
gm
gm
gm
gm
gm
gm
"}
(2,1,1) = {"
gm
gm
gm
gm
gm
NO
gm
gm
gm
gm
gm
gm
gm
gm
gm
gm
gm
gm
gm
gm
"}
(3,1,1) = {"
gm
gm
gm
gm
gm
gm
gm
Qr
Wz
qA
iM
pv
Wz
gm
gm
gm
gm
gm
gm
gm
"}
(4,1,1) = {"
gm
gm
gm
gm
gm
Wz
Qr
Qr
Wz
KE
KE
Wz
Wz
Wz
Wz
gm
gm
gm
gm
gm
"}
(5,1,1) = {"
gm
gm
gm
Nz
Qr
Wz
jf
gp
Wz
aH
qw
Wz
Lo
sC
Wz
uP
Qr
gm
gm
gm
"}
(6,1,1) = {"
gm
gm
Nz
Nz
jf
bh
eu
wU
Wz
KE
LE
Wz
Fr
Ds
bh
eq
Qr
Qr
gm
gm
"}
(7,1,1) = {"
gm
gm
Nz
VT
Tm
Ds
Ds
td
Wz
KE
LE
ec
vZ
oW
Ds
Az
zn
Qr
gm
gm
"}
(8,1,1) = {"
NO
gm
Wz
jN
wg
TE
NQ
jx
eS
Or
xk
Cp
Gk
hu
ye
wg
lI
Wz
gm
gm
"}
(9,1,1) = {"
gm
gm
Wz
Wz
Wz
pv
hQ
gZ
Ad
KE
jV
Ad
LG
Rd
Wz
Wz
Wz
Wz
gm
gm
"}
(10,1,1) = {"
gm
gm
gm
gm
Wz
Wz
pv
By
Wz
aA
QU
Wz
Ds
uU
Wz
Wz
gm
gm
gm
gm
"}
(11,1,1) = {"
gm
gm
gm
gm
gm
WQ
Wz
Pg
Wz
yH
vW
Qr
Ds
uU
Wz
gm
gm
gm
NO
gm
"}
(12,1,1) = {"
gm
gm
gm
gm
gm
Wz
pv
By
Wz
md
mY
Qr
Ds
WG
Wz
gm
gm
gm
gm
NO
"}
(13,1,1) = {"
gm
gm
gm
gm
gm
Wz
RH
PT
Wz
CO
pA
Wz
cN
Wz
Wz
gm
gm
gm
gm
gm
"}
(14,1,1) = {"
gm
gm
gm
gm
gm
Wz
um
mK
Ad
FC
zh
xZ
an
RI
Wz
gm
gm
gm
gm
gm
"}
(15,1,1) = {"
gm
gm
gm
gm
gm
Wz
um
um
nD
FC
Tn
hO
Zb
aE
Wz
SL
gm
gm
gm
gm
"}
(16,1,1) = {"
gm
gm
NO
gm
gm
Wz
Lb
jQ
Ad
FC
YM
dL
rq
FB
lc
zS
Rs
gm
gm
gm
"}
(17,1,1) = {"
gm
gm
gm
gm
gm
Wz
QR
kA
Wz
FC
AX
vm
Dg
Pj
qB
zS
Rs
gm
gm
gm
"}
(18,1,1) = {"
gm
gm
gm
gm
gm
Wz
jJ
dH
Wz
FC
Bw
vm
ix
Pj
qB
zS
Rs
gm
gm
gm
"}
(19,1,1) = {"
gm
gm
gm
gm
gm
Wz
rX
jJ
Wz
zO
eP
kq
YV
SS
sZ
zS
Rs
gm
NO
gm
"}
(20,1,1) = {"
gm
gm
gm
gm
gm
pv
ZN
Wz
Wz
jG
oE
Wo
Zb
Tz
Wz
SL
gm
gm
gm
gm
"}
(21,1,1) = {"
gm
gm
gm
gm
gm
pn
gm
KJ
gm
gm
NO
BF
gm
KJ
gm
gm
gm
gm
NO
gm
"}
(22,1,1) = {"
gm
gm
gm
gm
gm
gm
gm
gm
gm
KJ
KJ
gm
gm
gm
gm
gm
gm
gm
gm
gm
"}
(23,1,1) = {"
gm
KJ
gm
gm
KJ
gm
gm
gm
gm
gm
gm
gm
gm
gm
gm
KJ
gm
gm
gm
gm
"}
(24,1,1) = {"
gm
gm
gm
gm
gm
KJ
gm
gm
KJ
KJ
gm
gm
KJ
gm
gm
gm
gm
gm
gm
gm
"}
(25,1,1) = {"
gm
gm
gm
gm
gm
gm
gm
gm
gm
gm
gm
NO
gm
gm
gm
gm
gm
gm
KJ
gm
"}
(26,1,1) = {"
gm
gm
KJ
gm
gm
gm
gm
gm
gm
KJ
gm
gm
gm
gm
gm
KJ
gm
gm
gm
gm
"}
(27,1,1) = {"
gm
gm
KJ
gm
gm
gm
gm
KJ
KJ
gm
gm
gm
gm
gm
gm
KJ
gm
gm
KJ
gm
"}
(28,1,1) = {"
gm
gm
KJ
gm
gm
KJ
gm
gm
gm
gm
gm
gm
gm
KJ
gm
KJ
gm
gm
gm
gm
"}
(29,1,1) = {"
gm
gm
gm
gm
gm
gm
gm
gm
gm
gm
KJ
gm
gm
gm
gm
gm
KJ
gm
gm
gm
"}
(30,1,1) = {"
gm
gm
gm
gm
gm
gm
gm
gm
gm
gm
gm
gm
gm
gm
gm
KJ
KJ
gm
gm
gm
"}
