//MAP CONVERTED BY dmm2tgm.py THIS HEADER COMMENT PREVENTS RECONVERSION, DO NOT REMOVE
"aa" = (
/obj/machinery/door/airlock,
/turf/simulated/floor/tiled/techfloor,
/area/submap/osiris_field/pirate_wreck3)
"aj" = (
/turf/simulated/floor/tiled/techfloor/grid,
/area/submap/osiris_field/pirate_wreck3)
"aw" = (
/obj/structure/lattice,
/turf/space/basic,
/area/space)
"aP" = (
/obj/machinery/door/blast/regular{
	dir = 4
	},
/turf/simulated/floor/reinforced,
/area/submap/osiris_field/pirate_wreck3)
"aV" = (
/obj/random/multiple/large_corp_crate,
/turf/simulated/floor/tiled/techfloor,
/area/submap/osiris_field/pirate_wreck3)
"aW" = (
/obj/effect/floor_decal/techfloor/orange{
	dir = 6
	},
/obj/machinery/porta_turret/poi,
/turf/simulated/floor/tiled/monotechmaint,
/area/submap/osiris_field/pirate_wreck3)
"bt" = (
/obj/spawner/window/low_wall/reinforced/firelocks,
/turf/simulated/floor,
/area/submap/osiris_field/pirate_wreck3)
"ch" = (
/obj/item/trash/bowl,
/turf/simulated/floor,
/area/submap/osiris_field/pirate_wreck3)
"cu" = (
/obj/random/empty_or_lootable_crate,
/turf/simulated/floor/tiled/techfloor,
/area/submap/osiris_field/pirate_wreck3)
"cx" = (
/turf/simulated/floor,
/area/space)
"cC" = (
/obj/machinery/porta_turret/poi,
/turf/simulated/floor,
/area/submap/osiris_field/pirate_wreck3)
"du" = (
/obj/effect/floor_decal/techfloor{
	dir = 4
	},
/obj/effect/floor_decal/steeldecal/steel_decals10,
/turf/simulated/floor/tiled/monotechmaint,
/area/submap/osiris_field/pirate_wreck3)
"eB" = (
/obj/effect/floor_decal/techfloor/orange{
	dir = 9
	},
/obj/machinery/porta_turret/poi,
/turf/simulated/floor/tiled/monotechmaint,
/area/submap/osiris_field/pirate_wreck3)
"eQ" = (
/obj/spawner/window/low_wall/reinforced/full,
/turf/space/basic,
/area/submap/osiris_field/pirate_wreck3)
"gq" = (
/mob/living/simple_mob/humanoid/pirate/ranged/handcannon/armored,
/turf/simulated/floor/tiled/techfloor,
/area/submap/osiris_field/pirate_wreck3)
"gN" = (
/obj/structure/ship_munition/disperser_charge/fire,
/obj/structure/window/basic{
	dir = 4
	},
/obj/structure/window/basic{
	dir = 8
	},
/obj/structure/window/basic{
	dir = 1
	},
/turf/simulated/floor/tiled/techfloor/grid,
/area/submap/osiris_field/pirate_wreck3)
"hm" = (
/obj/structure/lattice,
/turf/space/basic,
/area/submap/osiris_field/pirate_wreck3)
"hq" = (
/obj/effect/floor_decal/steeldecal/steel_decals5,
/obj/effect/floor_decal/steeldecal/steel_decals5{
	dir = 1
	},
/obj/effect/floor_decal/steeldecal/steel_decals5{
	dir = 1
	},
/turf/simulated/floor/tiled/monotechmaint,
/area/submap/osiris_field/pirate_wreck3)
"ij" = (
/obj/effect/floor_decal/steeldecal/steel_decals5{
	dir = 8
	},
/obj/effect/floor_decal/steeldecal/steel_decals5{
	dir = 4
	},
/turf/simulated/floor/tiled/monotechmaint,
/area/submap/osiris_field/pirate_wreck3)
"iD" = (
/obj/item/trash/liquidfood,
/turf/simulated/floor,
/area/submap/osiris_field/pirate_wreck3)
"jl" = (
/turf/simulated/wall/r_wall/prepainted,
/area/space)
"jv" = (
/obj/machinery/door/airlock/multi_tile{
	dir = 8
	},
/turf/simulated/floor/tiled/monotechmaint,
/area/submap/osiris_field/pirate_wreck3)
"jI" = (
/mob/living/simple_mob/animal/roach/roachling,
/turf/simulated/floor,
/area/submap/osiris_field/pirate_wreck3)
"li" = (
/obj/machinery/door/airlock/multi_tile,
/obj/effect/floor_decal/techfloor{
	dir = 8
	},
/turf/simulated/floor/tiled/monotechmaint,
/area/submap/osiris_field/pirate_wreck3)
"lw" = (
/obj/machinery/door/airlock/hatch,
/turf/simulated/floor,
/area/submap/osiris_field/pirate_wreck3)
"ml" = (
/obj/machinery/door/airlock/hatch,
/obj/machinery/door/airlock/hatch,
/turf/simulated/floor,
/area/submap/osiris_field/pirate_wreck3)
"mu" = (
/obj/effect/floor_decal/techfloor/orange/corner,
/turf/simulated/floor/tiled/monotechmaint,
/area/submap/osiris_field/pirate_wreck3)
"oa" = (
/obj/structure/transit_tube/high_velocity{
	icon_state = "N-S-Pass"
	},
/turf/space/basic,
/area/submap/osiris_field/pirate_wreck3)
"oR" = (
/mob/living/simple_mob/humanoid/pirate/mate/ranged/shotgun,
/turf/simulated/floor/tiled/techfloor,
/area/submap/osiris_field/pirate_wreck3)
"sj" = (
/obj/effect/floor_decal/techfloor{
	dir = 8
	},
/mob/living/simple_mob/humanoid/pirate/armored,
/turf/simulated/floor/tiled/monotechmaint,
/area/submap/osiris_field/pirate_wreck3)
"sR" = (
/mob/living/simple_mob/humanoid/pirate,
/turf/simulated/floor/reinforced,
/area/submap/osiris_field/pirate_wreck3)
"tl" = (
/obj/effect/decal/mecha_wreckage/duke,
/turf/simulated/floor/reinforced,
/area/submap/osiris_field/pirate_wreck3)
"tw" = (
/obj/effect/floor_decal/techfloor{
	dir = 1
	},
/mob/living/simple_mob/humanoid/pirate/las,
/turf/simulated/floor/tiled/monotechmaint,
/area/submap/osiris_field/pirate_wreck3)
"ui" = (
/obj/effect/floor_decal/techfloor{
	dir = 4
	},
/obj/effect/floor_decal/techfloor/hole/right,
/turf/simulated/floor/tiled/monotechmaint,
/area/submap/osiris_field/pirate_wreck3)
"ur" = (
/obj/spawner/window/low_wall/reinforced/firelocks,
/turf/simulated/floor/tiled/techfloor,
/area/submap/osiris_field/pirate_wreck3)
"vx" = (
/obj/effect/floor_decal/techfloor{
	dir = 8
	},
/obj/effect/floor_decal/techfloor/hole/right,
/turf/simulated/floor/tiled/monotechmaint,
/area/submap/osiris_field/pirate_wreck3)
"wd" = (
/obj/machinery/door/airlock/multi_tile{
	dir = 8
	},
/obj/machinery/door/airlock/multi_tile{
	dir = 8
	},
/turf/simulated/floor/tiled/monotechmaint,
/area/submap/osiris_field/pirate_wreck3)
"yl" = (
/obj/item/trash/cavemoss,
/turf/simulated/floor,
/area/submap/osiris_field/pirate_wreck3)
"yz" = (
/obj/structure/transit_tube/high_velocity{
	icon_state = "N-S-Pass"
	},
/turf/simulated/floor/tiled/techfloor/grid,
/area/submap/osiris_field/pirate_wreck3)
"yC" = (
/obj/structure/ship_munition/disperser_charge/explosive,
/obj/structure/window/basic{
	dir = 4
	},
/obj/structure/window/basic{
	dir = 8
	},
/obj/structure/window/basic{
	dir = 1
	},
/turf/simulated/floor/tiled/techfloor/grid,
/area/submap/osiris_field/pirate_wreck3)
"yD" = (
/mob/living/simple_mob/humanoid/pirate/captain,
/turf/simulated/floor/tiled/techfloor,
/area/submap/osiris_field/pirate_wreck3)
"ze" = (
/obj/machinery/door/airlock/multi_tile,
/obj/effect/floor_decal/techfloor{
	dir = 8
	},
/obj/effect/floor_decal/techfloor{
	dir = 8
	},
/turf/simulated/floor/tiled/monotechmaint,
/area/submap/osiris_field/pirate_wreck3)
"zu" = (
/obj/structure/transit_tube_pod,
/obj/structure/transit_tube/station{
	dir = 4
	},
/turf/simulated/floor/tiled/techfloor/grid,
/area/submap/osiris_field/pirate_wreck3)
"Ar" = (
/turf/simulated/floor/reinforced,
/area/submap/osiris_field/pirate_wreck3)
"AH" = (
/obj/effect/decal/mecha_wreckage/duke/db,
/turf/simulated/floor/reinforced,
/area/submap/osiris_field/pirate_wreck3)
"Bt" = (
/turf/simulated/wall/r_wall/prepainted,
/area/submap/osiris_field/pirate_wreck3)
"BH" = (
/obj/machinery/door/airlock,
/turf/simulated/floor,
/area/submap/osiris_field/pirate_wreck3)
"BX" = (
/obj/structure/lattice,
/obj/structure/lattice,
/turf/space/basic,
/area/submap/osiris_field/pirate_wreck3)
"Cd" = (
/obj/random/multiple/corp_crate,
/turf/simulated/floor/tiled/techfloor,
/area/submap/osiris_field/pirate_wreck3)
"Co" = (
/obj/effect/floor_decal/techfloor{
	dir = 1
	},
/turf/simulated/floor/tiled/monotechmaint,
/area/submap/osiris_field/pirate_wreck3)
"CH" = (
/mob/living/simple_mob/humanoid/pirate,
/turf/simulated/floor/tiled/techfloor,
/area/submap/osiris_field/pirate_wreck3)
"CL" = (
/obj/effect/floor_decal/techfloor{
	dir = 8
	},
/mob/living/simple_mob/humanoid/pirate/ranged/handcannon/armored,
/turf/simulated/floor/tiled/monotechmaint,
/area/submap/osiris_field/pirate_wreck3)
"Dt" = (
/obj/item/trash/hot_cheesie,
/turf/simulated/floor,
/area/submap/osiris_field/pirate_wreck3)
"Eh" = (
/mob/living/simple_mob/humanoid/pirate/machete,
/turf/simulated/floor/tiled/techfloor,
/area/submap/osiris_field/pirate_wreck3)
"Ff" = (
/turf/simulated/floor/tiled/techfloor,
/area/submap/osiris_field/pirate_wreck3)
"Fo" = (
/obj/effect/floor_decal/techfloor/orange/corner{
	dir = 4
	},
/turf/simulated/floor/tiled/monotechmaint,
/area/submap/osiris_field/pirate_wreck3)
"JL" = (
/obj/item/trash/pistachios,
/turf/simulated/floor,
/area/submap/osiris_field/pirate_wreck3)
"KV" = (
/obj/effect/floor_decal/techfloor,
/turf/simulated/floor/tiled/monotechmaint,
/area/submap/osiris_field/pirate_wreck3)
"LO" = (
/obj/item/trash/fishingboot,
/turf/simulated/floor,
/area/submap/osiris_field/pirate_wreck3)
"LY" = (
/obj/effect/floor_decal/techfloor{
	dir = 4
	},
/turf/simulated/floor/tiled/monotechmaint,
/area/submap/osiris_field/pirate_wreck3)
"OI" = (
/obj/structure/transit_tube_pod,
/obj/structure/transit_tube/station{
	dir = 8
	},
/turf/simulated/floor/tiled/techfloor/grid,
/area/submap/osiris_field/pirate_wreck3)
"Pc" = (
/turf/simulated/floor/tiled/monotechmaint,
/area/submap/osiris_field/pirate_wreck3)
"PL" = (
/obj/structure/ship_munition/disperser_charge/mining,
/obj/structure/window/basic{
	dir = 4
	},
/obj/structure/window/basic{
	dir = 8
	},
/obj/structure/window/basic{
	dir = 1
	},
/turf/simulated/floor/tiled/techfloor/grid,
/area/submap/osiris_field/pirate_wreck3)
"PN" = (
/turf/space/basic,
/area/space)
"Qb" = (
/obj/effect/floor_decal/techfloor/orange/corner{
	dir = 8
	},
/turf/simulated/floor/tiled/monotechmaint,
/area/submap/osiris_field/pirate_wreck3)
"QI" = (
/obj/effect/floor_decal/techfloor/orange{
	dir = 6
	},
/turf/simulated/floor/tiled/monotechmaint,
/area/submap/osiris_field/pirate_wreck3)
"Rp" = (
/turf/simulated/floor,
/area/submap/osiris_field/pirate_wreck3)
"RA" = (
/obj/effect/floor_decal/techfloor/orange/corner{
	dir = 1
	},
/turf/simulated/floor/tiled/monotechmaint,
/area/submap/osiris_field/pirate_wreck3)
"RK" = (
/turf/space/basic,
/area/submap/osiris_field/pirate_wreck3)
"RZ" = (
/obj/structure/ship_munition/disperser_charge/emp,
/obj/structure/window/basic{
	dir = 4
	},
/obj/structure/window/basic{
	dir = 8
	},
/obj/structure/window/basic{
	dir = 1
	},
/turf/simulated/floor/tiled/techfloor/grid,
/area/submap/osiris_field/pirate_wreck3)
"SY" = (
/obj/effect/floor_decal/techfloor/orange{
	dir = 5
	},
/obj/machinery/porta_turret/poi,
/turf/simulated/floor/tiled/monotechmaint,
/area/submap/osiris_field/pirate_wreck3)
"Tb" = (
/obj/item/trash/popcorn,
/turf/simulated/floor,
/area/submap/osiris_field/pirate_wreck3)
"Tp" = (
/obj/effect/floor_decal/techfloor{
	dir = 4
	},
/obj/effect/floor_decal/techfloor/hole,
/turf/simulated/floor/tiled/monotechmaint,
/area/submap/osiris_field/pirate_wreck3)
"TH" = (
/obj/effect/floor_decal/steeldecal/steel_decals5,
/obj/effect/floor_decal/steeldecal/steel_decals5{
	dir = 1
	},
/turf/simulated/floor/tiled/monotechmaint,
/area/submap/osiris_field/pirate_wreck3)
"UF" = (
/mob/living/simple_mob/humanoid/pirate/armored,
/turf/simulated/floor/tiled/techfloor,
/area/submap/osiris_field/pirate_wreck3)
"VR" = (
/obj/effect/floor_decal/techfloor{
	dir = 8
	},
/obj/machinery/door/airlock/multi_tile/glass,
/turf/simulated/floor/tiled/monotechmaint,
/area/submap/osiris_field/pirate_wreck3)
"VS" = (
/obj/effect/floor_decal/techfloor/orange{
	dir = 9
	},
/turf/simulated/floor/tiled/monotechmaint,
/area/submap/osiris_field/pirate_wreck3)
"Wo" = (
/obj/effect/floor_decal/techfloor{
	dir = 8
	},
/turf/simulated/floor/tiled/monotechmaint,
/area/submap/osiris_field/pirate_wreck3)
"Ww" = (
/obj/effect/floor_decal/techfloor{
	dir = 4
	},
/obj/effect/floor_decal/techfloor{
	dir = 4
	},
/turf/simulated/floor/tiled/monotechmaint,
/area/submap/osiris_field/pirate_wreck3)
"WB" = (
/obj/spawner/window/low_wall/reinforced/full,
/turf/simulated/floor/tiled/techfloor,
/area/submap/osiris_field/pirate_wreck3)
"WX" = (
/obj/machinery/door/airlock/multi_tile/glass,
/turf/simulated/floor/tiled/techfloor,
/area/submap/osiris_field/pirate_wreck3)
"Xb" = (
/obj/effect/floor_decal/techfloor{
	dir = 1
	},
/obj/effect/floor_decal/techfloor/hole/right,
/obj/effect/floor_decal/techfloor/hole,
/turf/simulated/floor/tiled/monotechmaint,
/area/submap/osiris_field/pirate_wreck3)
"Xy" = (
/obj/effect/floor_decal/techfloor,
/obj/effect/floor_decal/techfloor/hole/right,
/turf/simulated/floor/tiled/monotechmaint,
/area/submap/osiris_field/pirate_wreck3)
"XF" = (
/obj/machinery/door/airlock/multi_tile{
	dir = 8
	},
/turf/simulated/floor/tiled/techfloor,
/area/submap/osiris_field/pirate_wreck3)
"XV" = (
/obj/machinery/door/airlock/multi_tile,
/turf/simulated/floor/tiled/monotechmaint,
/area/submap/osiris_field/pirate_wreck3)
"YM" = (
/obj/effect/decal/mecha_wreckage/duke/cw,
/turf/simulated/floor/reinforced,
/area/submap/osiris_field/pirate_wreck3)
"ZM" = (
/obj/effect/floor_decal/techfloor/orange{
	dir = 10
	},
/obj/machinery/porta_turret/poi,
/turf/simulated/floor/tiled/monotechmaint,
/area/submap/osiris_field/pirate_wreck3)
"ZP" = (
/obj/effect/floor_decal/techfloor{
	dir = 4
	},
/mob/living/simple_mob/humanoid/pirate/machete,
/turf/simulated/floor/tiled/monotechmaint,
/area/submap/osiris_field/pirate_wreck3)

(1,1,1) = {"
PN
PN
PN
PN
PN
PN
PN
PN
PN
PN
PN
PN
PN
PN
PN
PN
PN
PN
PN
PN
PN
PN
PN
PN
PN
PN
PN
PN
PN
PN
PN
PN
PN
PN
PN
PN
PN
PN
PN
PN
PN
PN
PN
PN
PN
PN
PN
PN
PN
PN
PN
PN
PN
PN
PN
PN
PN
PN
PN
PN
PN
PN
PN
PN
PN
PN
PN
PN
PN
PN
PN
PN
PN
PN
PN
PN
PN
PN
PN
PN
"}
(2,1,1) = {"
PN
PN
PN
PN
PN
PN
PN
PN
PN
PN
PN
PN
PN
PN
PN
PN
PN
PN
PN
PN
PN
PN
PN
PN
PN
PN
PN
PN
PN
PN
PN
PN
PN
PN
PN
PN
PN
PN
PN
PN
PN
PN
PN
PN
PN
PN
PN
PN
PN
PN
PN
PN
PN
PN
PN
PN
PN
PN
PN
PN
PN
PN
PN
PN
PN
PN
PN
PN
PN
PN
PN
PN
PN
PN
PN
PN
PN
PN
PN
PN
"}
(3,1,1) = {"
PN
PN
PN
PN
PN
PN
PN
PN
PN
PN
PN
PN
PN
PN
PN
PN
PN
PN
PN
PN
PN
PN
PN
PN
PN
PN
hm
hm
hm
Ar
hm
RK
RK
hm
Ar
Ar
Bt
Bt
Bt
Bt
Bt
PN
PN
PN
PN
PN
PN
PN
PN
PN
PN
Bt
Bt
Bt
Bt
Bt
Bt
Bt
Bt
Bt
Bt
Bt
Bt
Bt
Bt
Bt
Bt
Bt
Bt
Bt
Bt
Bt
PN
PN
PN
PN
PN
PN
PN
PN
"}
(4,1,1) = {"
PN
PN
PN
PN
PN
PN
PN
PN
PN
PN
PN
PN
PN
PN
PN
PN
PN
PN
PN
PN
PN
aw
PN
PN
PN
aw
Ar
Ar
Ar
Ar
Ar
hm
hm
Ar
Ar
Ar
Ar
ml
Rp
Rp
Rp
cx
PN
PN
PN
PN
aw
PN
PN
PN
PN
RK
Rp
Rp
Rp
Rp
Rp
Rp
Rp
Rp
lw
Rp
Rp
yl
Rp
Rp
Tb
Rp
Rp
Rp
Bt
Bt
Bt
PN
PN
PN
PN
PN
PN
PN
"}
(5,1,1) = {"
PN
PN
PN
PN
PN
PN
PN
aw
PN
PN
PN
PN
PN
aw
PN
PN
PN
PN
PN
PN
PN
PN
PN
aw
aw
jl
Ar
Ar
Ar
Ar
Ar
Ar
Ar
Ar
Ar
Ar
Ar
Bt
Bt
Bt
Bt
cx
cx
PN
aw
PN
PN
PN
PN
PN
PN
RK
RK
hm
hm
Bt
Bt
Bt
Bt
Bt
Bt
Bt
lw
Bt
Bt
Bt
Bt
Bt
Bt
Rp
Bt
Bt
Bt
Bt
PN
PN
PN
PN
PN
PN
"}
(6,1,1) = {"
PN
RK
RK
RK
RK
RK
RK
RK
RK
RK
RK
hm
RK
RK
RK
RK
RK
RK
RK
RK
RK
RK
hm
Rp
Rp
Bt
Ar
Ar
Ar
Ar
Ar
Ar
Ar
Ar
Ar
Ar
Ar
Ff
Ff
Bt
Rp
Rp
hm
RK
RK
RK
RK
RK
RK
hm
RK
RK
RK
RK
Ff
Rp
Ff
Ff
Ff
Ff
Bt
cu
Ff
Ff
aV
Ff
Ff
cu
Bt
Rp
Bt
Bt
Bt
Bt
eQ
eQ
WB
WB
WB
PN
"}
(7,1,1) = {"
PN
RK
Bt
RK
RK
RK
RK
RK
RK
RK
RK
RK
RK
RK
RK
RK
RK
RK
RK
RK
RK
hm
Rp
Rp
Ff
Bt
Ar
Ar
YM
Ar
Ar
Ar
Ar
tl
Ar
Ar
Ar
Ff
Ff
Bt
Rp
Rp
hm
RK
RK
RK
RK
RK
RK
RK
RK
RK
RK
RK
hm
Rp
Rp
Ff
Ff
Ff
Bt
aV
Ff
Ff
aV
Eh
Ff
cu
Bt
Rp
Rp
Rp
JL
Bt
Ff
Ff
Ff
Ff
WB
PN
"}
(8,1,1) = {"
PN
RK
Bt
hm
RK
RK
RK
RK
RK
RK
RK
RK
RK
RK
hm
RK
RK
hm
hm
hm
Rp
Rp
Rp
Ff
Ff
Bt
Ar
Ar
Ar
Ar
Ar
Ar
Ar
Ar
Ar
YM
Ar
Ff
Ff
Bt
Rp
Rp
Ff
RK
RK
hm
RK
RK
RK
RK
hm
RK
hm
Ff
hm
hm
Rp
Rp
Ff
Ff
Bt
cu
Ff
Ff
Ff
Ff
gq
Ff
Bt
Bt
Bt
Bt
Rp
Bt
Ff
Ff
Ff
Ff
WB
PN
"}
(9,1,1) = {"
PN
Bt
Bt
hm
hm
hm
RK
RK
RK
RK
hm
RK
RK
RK
RK
RK
hm
Rp
Rp
Rp
Rp
Ff
Ff
Ff
Rp
Bt
Ar
Ar
Ar
Ar
Ar
Ar
Ar
Ar
Ar
Ar
Ar
Ff
Ff
Bt
Rp
Rp
BX
Ff
RK
RK
RK
RK
RK
hm
Ff
hm
hm
RK
hm
Ff
Rp
Rp
Ff
Ff
Bt
cu
Ff
Ff
Ff
Ff
Ff
Ff
aa
VS
ZM
Bt
Rp
Bt
Ff
oR
Ff
Ff
WB
PN
"}
(10,1,1) = {"
PN
Bt
Bt
Bt
Bt
Rp
hm
RK
RK
RK
RK
RK
RK
RK
RK
hm
Rp
Bt
BH
Bt
Bt
Bt
Bt
Bt
Bt
Bt
Bt
Bt
Bt
Bt
Bt
Bt
Bt
Bt
Bt
Bt
Bt
Pc
jv
Bt
Bt
Bt
hm
hm
RK
RK
RK
RK
RK
hm
Ff
hm
RK
hm
Ff
hm
Ff
hm
Rp
Rp
Bt
aV
Eh
Ff
Ff
UF
Ff
Cd
Bt
Co
KV
Bt
lw
Bt
Ff
Ff
Ff
Ff
WB
PN
"}
(11,1,1) = {"
PN
Bt
Pc
Pc
Pc
Pc
Rp
hm
Rp
hm
RK
RK
RK
hm
hm
Rp
Wo
Rp
Rp
Wo
VR
Wo
Wo
Wo
Wo
Wo
Wo
Wo
Wo
Wo
Wo
Wo
vx
Wo
Wo
Wo
VR
Wo
Wo
Wo
ZM
Bt
Rp
Ff
Ff
RK
RK
RK
RK
RK
hm
RK
RK
RK
hm
RK
hm
hm
Ff
Rp
Bt
aV
Ff
aV
Ff
Cd
Ff
Cd
Bt
Co
Qb
CL
Wo
ze
Ff
Ff
yD
Ff
WB
PN
"}
(12,1,1) = {"
PN
Bt
Pc
Pc
Pc
Pc
Pc
Rp
hm
Rp
hm
RK
hm
Rp
Rp
Pc
Rp
LY
LY
LY
LY
LY
LY
LY
LY
LY
LY
LY
LY
LY
LY
LY
Tp
LY
LY
LY
LY
LY
LY
Fo
KV
WX
Rp
Ff
Ff
RK
RK
RK
RK
RK
RK
RK
RK
RK
Ff
RK
RK
hm
Rp
hm
Bt
cu
Ff
aV
Ff
Cd
Ff
Cd
Bt
Co
Pc
LY
LY
LY
Ff
Ff
Ff
Ff
WB
PN
"}
(13,1,1) = {"
PN
Bt
Ff
XF
Bt
Bt
Bt
Bt
Bt
Rp
hm
hm
Bt
Bt
Bt
Bt
Bt
Bt
Bt
Bt
Bt
Bt
Bt
Pc
wd
Bt
Bt
Bt
Bt
Bt
Bt
Bt
Bt
Bt
Bt
Bt
Bt
Bt
Bt
Co
KV
Ff
Ff
Rp
hm
RK
RK
RK
RK
RK
RK
RK
RK
RK
RK
RK
hm
hm
Rp
Ff
Bt
Bt
Bt
Bt
Bt
Bt
Bt
Bt
Bt
tw
KV
Bt
Bt
Bt
Ff
oR
Ff
Ff
WB
PN
"}
(14,1,1) = {"
PN
Bt
Ff
Ff
Rp
Rp
Rp
Rp
Rp
Rp
Rp
Rp
Rp
LO
Rp
Rp
Rp
Dt
Rp
Rp
Rp
Rp
lw
ij
ij
lw
Rp
Rp
Rp
Rp
jI
Rp
Dt
Rp
Rp
Rp
Rp
Rp
Bt
Co
Xy
Bt
Ff
Rp
hm
hm
Ff
RK
RK
RK
Ff
Ff
RK
RK
RK
Rp
Rp
hm
Rp
Ff
Bt
eB
Wo
Wo
Wo
Wo
Wo
Wo
Wo
RA
KV
Ff
Ff
Bt
Ff
Ff
Ff
Ff
WB
PN
"}
(15,1,1) = {"
PN
Bt
Ff
Ff
Bt
Bt
Bt
Rp
Bt
Bt
Bt
Bt
Bt
Bt
Bt
Bt
Bt
Bt
Bt
Bt
Bt
Bt
Bt
Pc
wd
Bt
Bt
Bt
Bt
Bt
Bt
Bt
Bt
Bt
Bt
Bt
Bt
jI
Bt
Co
KV
ur
Ff
Rp
Rp
Rp
Ff
RK
RK
RK
Ff
hm
hm
Ff
RK
hm
Rp
Ff
Ff
Ff
Bt
Co
mu
LY
LY
du
LY
LY
LY
du
aW
Ff
Ff
Bt
Ff
Ff
Ff
Ff
WB
PN
"}
(16,1,1) = {"
PN
Bt
Ff
Ff
Ff
Ff
Bt
Ff
Ff
Ff
Ff
Ff
CH
Ff
Ff
Ff
Ff
Ff
Ff
Ff
Ff
Ff
Ff
Ff
Ff
Ff
Ff
CH
Ff
Ff
Ff
UF
Ff
Ff
Ff
Ff
Bt
jI
Bt
Co
KV
ur
Ff
Rp
Rp
Rp
hm
hm
RK
RK
hm
hm
hm
Ff
hm
Rp
Rp
Ff
Ff
Ff
Bt
Xb
KV
Bt
Bt
Bt
Bt
Bt
Bt
Bt
Bt
Ff
Ff
Bt
Ff
Ff
Ff
Ff
WB
PN
"}
(17,1,1) = {"
PN
Bt
Ff
Ff
Ff
Ff
Bt
Ff
Ff
Ff
Ff
Ff
Ff
Ff
Ff
Ff
Ff
Ff
UF
Ff
Ff
Ff
Ff
Ff
Ff
Ff
Ff
Ff
Ff
Ff
Ff
Ff
Ff
Ff
Ff
Ff
Bt
Rp
Bt
Co
KV
ur
Ff
Ff
Ff
Rp
Ff
Ff
BX
hm
Ff
hm
Rp
Rp
Rp
hm
Rp
Ff
Ff
Ff
Bt
Xb
KV
Bt
Ff
Ff
Ff
Ff
Ff
Bt
Ff
Ff
Ff
Bt
Bt
Bt
Bt
WB
WB
PN
"}
(18,1,1) = {"
PN
Bt
Ff
Ff
Ff
Ff
Bt
Ar
Ar
Ar
Ar
Ar
Ar
Ar
sR
Ar
Ar
Ar
Ar
Ar
Ar
Ar
Ar
Ar
Ar
Ar
Ar
Ar
Ar
Ar
Ar
Ar
Ar
Ar
Ff
Ff
Bt
Rp
Bt
Co
KV
Bt
Ff
Ff
Rp
Rp
hm
hm
Ff
hm
Bt
Bt
bt
Bt
bt
bt
Bt
bt
Bt
Bt
Bt
Xb
KV
Bt
Ff
Ff
Ff
Ff
Ff
Bt
RZ
aj
aj
zu
yz
yz
yz
oa
PN
PN
"}
(19,1,1) = {"
PN
Bt
Ff
Ff
Ff
Ff
Bt
Ar
Ar
sR
Ar
Ar
Ar
Ar
Ar
Ar
Ar
Ar
Ar
Ar
Ar
Ar
Ar
Ar
Ar
Ar
Ar
Ar
Ar
Ar
Ar
Ar
Ar
Ar
Ff
Ff
Bt
LO
Bt
Co
KV
WX
Ff
Ff
Ff
Rp
Rp
hm
Ff
hm
Bt
cC
Rp
Wo
Wo
Wo
Wo
Rp
Wo
Wo
li
tw
KV
Bt
Ff
Ff
UF
Ff
Ff
Bt
yC
aj
aj
aj
Bt
Bt
Bt
RK
PN
PN
"}
(20,1,1) = {"
PN
Bt
Ff
Ff
Ff
Ff
Bt
Ar
Ar
Ar
Ar
Ar
Ar
Ar
Ar
Ar
Ar
Ar
Ar
Ar
Ar
Ar
Ar
tl
Ar
Ar
Ar
Ar
Ar
Ar
Ar
Ar
Ar
Ar
Ff
Ff
Bt
Rp
Bt
Co
KV
Ff
Ff
Ff
Ff
Ff
hm
Rp
Ff
Rp
bt
Rp
Pc
LY
ui
ZP
LY
LY
LY
LY
Ww
Co
KV
Bt
Ff
Ff
Ff
Ff
Ff
Bt
gN
aj
aj
OI
yz
yz
yz
oa
PN
PN
"}
(21,1,1) = {"
PN
Bt
Ff
Ff
Ff
Ff
Bt
Ar
Ar
AH
Ar
Ar
Ar
Ar
Ar
Ar
Ar
Ar
Ar
Ar
Ar
Ar
Ar
Ar
Ar
Ar
sR
Ar
Ar
Ar
Ar
Ar
Ar
Ar
Ff
Ff
Bt
Rp
Bt
Co
KV
Bt
Ff
Ff
Ff
Ff
Ff
Ff
Ff
Rp
bt
Co
KV
Bt
Bt
Bt
Bt
Bt
Bt
Bt
Bt
Co
KV
Bt
Ff
Ff
Ff
Ff
Ff
Bt
PL
aj
aj
aj
Bt
Bt
Bt
RK
PN
PN
"}
(22,1,1) = {"
PN
Bt
Ff
Ff
Ff
Ff
Bt
Ar
Ar
Ar
Ar
Ar
Ar
Ar
Ar
Ar
Ar
Ar
Ar
Ar
Ar
Ar
Ar
Ar
Ar
Ar
Ar
Ar
Ar
Ar
Ar
Ar
AH
Ar
Ff
CH
Bt
lw
Bt
Co
KV
Bt
Ff
Ff
Ff
Ff
Ff
Ff
Ff
Ff
Bt
Co
KV
Bt
Ff
Ff
Ff
Ff
Ff
Ff
Bt
Co
KV
Bt
Ff
Ff
Ff
Ff
Ff
Bt
aj
aj
aj
OI
yz
yz
yz
oa
PN
PN
"}
(23,1,1) = {"
PN
Bt
Ff
Ff
Ff
Ff
Bt
Ar
Ar
Ar
Ar
Ar
Ar
Ar
Ar
Ar
Ar
AH
Ar
Ar
Ar
Ar
Ar
Ar
Ar
Ar
Ar
Ar
Ar
Ar
Ar
Ar
Ar
Ar
Ff
Ff
XV
TH
XV
Co
KV
Bt
Bt
Bt
Bt
Bt
Bt
Bt
Bt
Bt
Bt
Co
KV
Bt
Ff
Ff
Ff
Ff
Ff
Ff
aa
Co
KV
Bt
UF
Ff
Ff
Ff
Ff
Bt
aj
aj
aj
Bt
Bt
Bt
Bt
RK
PN
PN
"}
(24,1,1) = {"
PN
Bt
Ff
Ff
Ff
Ff
Bt
Ar
Ar
Ar
Ar
Ar
Ar
tl
Ar
Ar
Ar
Ar
Ar
Ar
Ar
Ar
Ar
Ar
Ar
Ar
YM
Ar
Ar
Ar
Ar
Ar
Ar
Ar
Ff
Ff
Pc
hq
Pc
Co
Qb
VR
Wo
Wo
Wo
Wo
sj
Wo
Wo
Wo
li
RA
KV
Bt
Ff
Ff
Ff
Ff
Ff
Ff
Bt
Co
KV
Bt
Ff
Ff
Ff
Ff
Ff
Bt
lw
Bt
Bt
Bt
Bt
Bt
Bt
RK
PN
PN
"}
(25,1,1) = {"
PN
Bt
Bt
Bt
Bt
Bt
Bt
Ar
Ar
Ar
Ar
Ar
Ar
Ar
Ar
Ar
Ar
Ar
sR
Ar
Ar
Ar
Ar
Ar
Ar
Ar
Ar
Ar
Ar
Ar
Ar
Ar
Ar
Ar
Ff
Ff
Bt
lw
Bt
SY
LY
LY
LY
LY
LY
LY
LY
LY
LY
LY
LY
LY
aW
Bt
Ff
Ff
Ff
Ff
Ff
Ff
Bt
SY
QI
Ff
Ff
Ff
Ff
Ff
Ff
Bt
Rp
Bt
Bt
Bt
Bt
PN
PN
PN
PN
PN
"}
(26,1,1) = {"
PN
PN
Bt
Bt
Bt
Bt
Bt
Ar
Ar
Ar
Ar
Ar
Ar
Ar
Ar
Ar
Ar
Ar
Ar
Ar
Ar
Ar
Ar
Ar
Ar
Ar
Ar
Ar
Ar
Ar
Ar
Ar
Ar
Ar
Ff
Ff
Bt
Rp
Bt
Bt
Bt
Bt
Bt
Bt
Bt
Bt
Bt
Bt
Bt
Bt
Bt
Bt
Bt
Bt
lw
Bt
Bt
Bt
Bt
Bt
Bt
Bt
ml
Bt
Bt
Bt
Bt
Bt
Bt
Bt
Rp
Bt
Bt
Bt
PN
PN
PN
PN
PN
PN
"}
(27,1,1) = {"
PN
PN
Bt
Bt
Bt
Bt
Bt
Ar
Ar
Ar
Ar
Ar
Ar
Ar
Ar
Ar
Ar
Ar
Ar
Ar
Ar
Ar
Ar
Ar
Ar
Ar
Ar
Ar
Ar
Ar
Ar
Ar
Ar
Ar
Ff
Ff
Bt
Rp
Rp
Dt
Rp
iD
Rp
Rp
Rp
Rp
jI
Rp
Rp
Rp
Rp
Rp
Rp
Rp
Rp
Rp
jI
Rp
Rp
iD
Rp
Rp
Rp
Rp
ch
Rp
Rp
jI
jI
Rp
Rp
Bt
Bt
PN
PN
PN
PN
PN
PN
PN
"}
(28,1,1) = {"
PN
PN
PN
PN
Bt
Bt
Bt
aP
aP
aP
aP
aP
aP
aP
aP
aP
aP
aP
aP
aP
aP
aP
aP
aP
aP
aP
aP
aP
aP
aP
aP
aP
aP
aP
Bt
Bt
Bt
Bt
Bt
Bt
Bt
Bt
Bt
Bt
Bt
Bt
Bt
Bt
Bt
Bt
Bt
Bt
Bt
Bt
Bt
Bt
Bt
Bt
Bt
Bt
Bt
Bt
Bt
Bt
Bt
Bt
Bt
Bt
Bt
Bt
Bt
Bt
PN
PN
PN
PN
PN
PN
PN
PN
"}
(29,1,1) = {"
PN
PN
PN
PN
PN
PN
PN
PN
PN
PN
PN
PN
PN
PN
PN
PN
PN
PN
PN
PN
PN
PN
PN
PN
PN
PN
PN
PN
PN
PN
PN
PN
PN
PN
PN
PN
PN
PN
PN
PN
PN
PN
PN
PN
PN
PN
PN
PN
PN
PN
PN
PN
PN
PN
PN
PN
PN
PN
PN
PN
PN
PN
PN
PN
PN
PN
PN
PN
PN
PN
PN
PN
PN
PN
PN
PN
PN
PN
PN
PN
"}
(30,1,1) = {"
PN
PN
PN
PN
PN
PN
PN
PN
PN
PN
PN
PN
PN
PN
PN
PN
PN
PN
PN
PN
PN
PN
PN
PN
PN
PN
PN
PN
PN
PN
PN
PN
PN
PN
PN
PN
PN
PN
PN
PN
PN
PN
PN
PN
PN
PN
PN
PN
PN
PN
PN
PN
PN
PN
PN
PN
PN
PN
PN
PN
PN
PN
PN
PN
PN
PN
PN
PN
PN
PN
PN
PN
PN
PN
PN
PN
PN
PN
PN
PN
"}
