//MAP CONVERTED BY dmm2tgm.py THIS HEADER COMMENT PREVENTS RECONVERSION, DO NOT REMOVE
"ah" = (
/obj/structure/table/steel,
/obj/random/mre,
/turf/simulated/floor/plating,
/area/tether/under/poi)
"bs" = (
/obj/random/junk,
/turf/simulated/floor/tiled/old_tile/blue,
/area/tether/under/poi)
"cq" = (
/obj/effect/spider/stickyweb,
/turf/simulated/floor/plating,
/area/tether/under/poi)
"cB" = (
/obj/machinery/door/airlock/maintenance/common,
/obj/machinery/atmospherics/pipe/simple/hidden/scrubbers,
/obj/machinery/atmospherics/pipe/simple/hidden/supply,
/obj/structure/catwalk,
/obj/machinery/door/firedoor/glass,
/turf/simulated/floor/plating,
/area/tether/under/poi)
"dD" = (
/obj/effect/decal/cleanable/dirt,
/obj/random/trash,
/turf/simulated/floor/plating,
/area/tether/under/poi)
"eg" = (
/obj/machinery/atmospherics/pipe/simple/hidden/scrubbers{
	dir = 4
	},
/obj/machinery/atmospherics/pipe/simple/hidden/supply{
	dir = 4
	},
/obj/effect/decal/cleanable/dirt,
/obj/effect/decal/cleanable/dirt,
/obj/structure/catwalk,
/mob/living/simple_mob/animal/space/bats{
	base_attack_cooldown = 5;
	faction = "mouse";
	health = 50;
	maxHealth = 50;
	movement_cooldown = 0
	},
/turf/simulated/floor/plating,
/area/tether/under/poi)
"fo" = (
/turf/simulated/floor/tiled/old_tile/blue,
/area/tether/under/poi)
"fP" = (
/obj/machinery/door/airlock/maintenance/common,
/obj/structure/catwalk,
/obj/machinery/door/firedoor/glass,
/turf/simulated/floor/plating,
/area/tether/under/poi)
"fW" = (
/obj/structure/table/steel,
/obj/random/medical/pillbottle,
/turf/simulated/floor/tiled/old_tile/blue,
/area/tether/under/poi)
"ga" = (
/obj/machinery/atmospherics/pipe/simple/hidden/scrubbers,
/obj/machinery/atmospherics/pipe/simple/hidden/supply,
/obj/effect/decal/cleanable/dirt,
/obj/effect/decal/cleanable/dirt,
/obj/structure/catwalk,
/turf/simulated/floor/plating,
/area/tether/under/poi)
"iR" = (
/obj/effect/decal/cleanable/blood,
/turf/simulated/floor/tiled/old_tile/blue,
/area/tether/under/poi)
"ja" = (
/obj/structure/extinguisher_cabinet{
	pixel_x = 25
	},
/turf/simulated/floor/tiled/old_tile/blue,
/area/tether/under/poi)
"kj" = (
/obj/effect/decal/cleanable/blood,
/turf/simulated/floor/plating,
/area/tether/under/poi)
"kE" = (
/obj/structure/closet/crate,
/obj/random/cash,
/obj/random/curseditem,
/obj/item/spacecash/c1000,
/obj/item/storage/secure/briefcase/ml3m_pack_med,
/turf/simulated/floor/tiled/old_tile/blue,
/area/tether/under/poi)
"lU" = (
/obj/structure/closet/crate/medical,
/obj/random/medical/pillbottle,
/obj/random/drinkbottle,
/obj/item/storage/firstaid/regular,
/turf/simulated/floor/tiled/old_tile/blue,
/area/tether/under/poi)
"mq" = (
/obj/machinery/vending/blood,
/turf/simulated/floor/plating,
/area/tether/under/poi)
"mz" = (
/obj/effect/spider/stickyweb,
/obj/random/junk,
/turf/simulated/floor/plating,
/area/tether/under/poi)
"nV" = (
/obj/random/junk,
/turf/simulated/floor/plating,
/area/tether/under/poi)
"oo" = (
/obj/structure/table/steel,
/turf/simulated/floor/tiled/old_tile/blue,
/area/tether/under/poi)
"ru" = (
/obj/random/mouseremains,
/turf/simulated/floor/plating,
/area/tether/under/poi)
"rH" = (
/obj/machinery/door/airlock/maintenance/int{
	locked = 1
	},
/obj/machinery/door/firedoor/glass,
/turf/simulated/floor/plating,
/area/tether/under/poi)
"sq" = (
/turf/simulated/wall/iron,
/area/tether/under/poi)
"st" = (
/obj/machinery/atmospherics/pipe/simple/hidden/scrubbers{
	dir = 5
	},
/obj/effect/decal/cleanable/dirt,
/obj/structure/catwalk,
/turf/simulated/floor/plating,
/area/tether/under/poi)
"tC" = (
/obj/structure/filingcabinet,
/turf/simulated/floor/plating,
/area/tether/under/poi)
"uu" = (
/obj/random/trash,
/turf/simulated/floor/plating,
/area/tether/under/poi)
"uE" = (
/obj/machinery/atmospherics/pipe/simple/hidden/supply{
	dir = 4
	},
/obj/effect/decal/cleanable/dirt,
/obj/effect/decal/cleanable/dirt,
/obj/structure/catwalk,
/turf/simulated/floor/plating,
/area/tether/under/poi)
"xa" = (
/obj/structure/filingcabinet/chestdrawer,
/turf/simulated/floor/plating,
/area/tether/under/poi)
"yY" = (
/obj/structure/table/steel,
/obj/machinery/recharger,
/turf/simulated/floor/tiled/old_tile/blue,
/area/tether/under/poi)
"BV" = (
/obj/machinery/atmospherics/unary/cryo_cell,
/turf/simulated/floor/plating,
/area/tether/under/poi)
"Gf" = (
/obj/structure/catwalk,
/obj/random/junk,
/turf/simulated/floor/plating,
/area/tether/under/poi)
"Gq" = (
/obj/effect/decal/cleanable/dirt,
/obj/machinery/firealarm{
	dir = 1;
	pixel_y = -24
	},
/turf/simulated/floor/plating,
/area/tether/under/poi)
"GJ" = (
/obj/structure/table/steel,
/obj/random/medical,
/turf/simulated/floor/tiled/old_tile/blue,
/area/tether/under/poi)
"Ir" = (
/obj/effect/decal/cleanable/dirt,
/obj/structure/closet/crate,
/obj/random/mre,
/obj/random/mre,
/obj/random/mre,
/turf/simulated/floor/plating,
/area/tether/under/poi)
"JY" = (
/turf/simulated/floor/plating,
/area/tether/under/poi)
"Ln" = (
/mob/living/simple_mob/horror/bradley{
	base_attack_cooldown = 10;
	health = 450;
	maxHealth = 450;
	move_speed = 25;
	movement_cooldown = 0;
	name = "???"
	},
/turf/simulated/floor/plating,
/area/tether/under/poi)
"Lz" = (
/obj/machinery/atmospherics/pipe/simple/hidden/scrubbers,
/obj/machinery/atmospherics/pipe/simple/hidden/supply,
/obj/effect/decal/cleanable/dirt,
/obj/structure/catwalk,
/turf/simulated/floor/plating,
/area/tether/under/poi)
"Mh" = (
/obj/structure/catwalk,
/turf/simulated/floor/plating,
/area/tether/under/poi)
"Nv" = (
/obj/effect/spider/stickyweb,
/obj/effect/decal/cleanable/dirt,
/turf/simulated/floor/plating,
/area/tether/under/poi)
"Ot" = (
/obj/structure/table/steel,
/obj/random/unidentified_medicine/fresh_medicine,
/turf/simulated/floor/tiled/old_tile/blue,
/area/tether/under/poi)
"OR" = (
/obj/machinery/atmospherics/pipe/simple/hidden/scrubbers{
	dir = 10
	},
/obj/machinery/atmospherics/pipe/simple/hidden/supply{
	dir = 10
	},
/obj/effect/decal/cleanable/dirt,
/obj/effect/decal/cleanable/dirt,
/obj/structure/catwalk,
/turf/simulated/floor/plating,
/area/tether/under/poi)
"PK" = (
/obj/machinery/atmospherics/unary/cryo_cell,
/turf/simulated/floor/tiled/old_tile/blue,
/area/tether/under/poi)
"Qn" = (
/obj/structure/table/steel,
/obj/item/storage/firstaid/regular,
/turf/simulated/floor/tiled/old_tile/blue,
/area/tether/under/poi)
"QD" = (
/obj/machinery/atmospherics/pipe/simple/hidden/scrubbers,
/obj/structure/catwalk,
/obj/random/trash,
/turf/simulated/floor/plating,
/area/tether/under/poi)
"Rd" = (
/obj/effect/decal/cleanable/dirt,
/turf/simulated/floor/plating,
/area/tether/under/poi)
"SM" = (
/obj/item/stool/padded,
/turf/simulated/floor/plating,
/area/tether/under/poi)
"Te" = (
/obj/machinery/light/small{
	dir = 1;
	icon_state = "bulb1"
	},
/turf/simulated/floor/plating,
/area/tether/under/poi)
"TH" = (
/obj/structure/sign/department/medbay{
	pixel_x = -32
	},
/obj/effect/spider/stickyweb,
/turf/simulated/floor/plating,
/area/tether/under/poi)
"Up" = (
/obj/effect/decal/cleanable/dirt,
/obj/structure/closet/crate/mimic/dangerous,
/obj/random/maintenance/research,
/turf/simulated/floor/plating,
/area/tether/under/poi)
"VZ" = (
/obj/machinery/atmospherics/pipe/simple/hidden/scrubbers{
	dir = 4
	},
/obj/machinery/atmospherics/pipe/simple/hidden/supply{
	dir = 4
	},
/obj/effect/decal/cleanable/dirt,
/obj/effect/decal/cleanable/dirt,
/obj/structure/catwalk,
/obj/random/trash,
/turf/simulated/floor/plating,
/area/tether/under/poi)
"Wa" = (
/obj/machinery/atmospherics/pipe/simple/hidden/scrubbers,
/obj/machinery/atmospherics/pipe/simple/hidden/supply,
/obj/effect/decal/cleanable/dirt,
/obj/structure/catwalk,
/obj/effect/decal/cleanable/blood,
/turf/simulated/floor/plating,
/area/tether/under/poi)
"Wh" = (
/obj/structure/table/steel,
/turf/simulated/floor/plating,
/area/tether/under/poi)
"XA" = (
/obj/machinery/firealarm{
	dir = 1;
	pixel_y = -24
	},
/turf/simulated/floor/plating,
/area/tether/under/poi)
"YC" = (
/obj/machinery/door/airlock/maintenance/int{
	locked = 1
	},
/turf/simulated/floor/plating,
/area/tether/under/poi)
"YP" = (
/obj/effect/decal/cleanable/dirt,
/obj/effect/decal/cleanable/blood,
/turf/simulated/floor/plating,
/area/tether/under/poi)
"ZJ" = (
/mob/living/simple_mob/horror/bradley{
	base_attack_cooldown = 10;
	health = 450;
	maxHealth = 450;
	move_speed = 25;
	movement_cooldown = 0;
	name = "???"
	},
/turf/simulated/floor/tiled/old_tile/blue,
/area/tether/under/poi)

(1,1,1) = {"
sq
sq
sq
sq
sq
sq
sq
sq
sq
sq
sq
sq
sq
"}
(2,1,1) = {"
sq
BV
JY
bs
fo
fo
ah
GJ
fW
Wh
lU
kE
sq
"}
(3,1,1) = {"
sq
PK
ZJ
fo
iR
fo
fo
fo
fo
iR
fo
fo
sq
"}
(4,1,1) = {"
sq
PK
JY
fo
ja
fo
SM
SM
fo
fo
uu
iR
sq
"}
(5,1,1) = {"
sq
sq
sq
sq
sq
Wh
yY
oo
fW
iR
fo
mq
sq
"}
(6,1,1) = {"
sq
JY
cq
cq
sq
JY
fo
fo
Wh
fo
fo
XA
sq
"}
(7,1,1) = {"
cB
Lz
st
nV
sq
JY
kj
fo
fo
fo
iR
JY
YC
"}
(8,1,1) = {"
sq
Te
VZ
Nv
sq
fo
JY
uu
Ot
nV
fo
fo
sq
"}
(9,1,1) = {"
sq
cq
eg
Gq
sq
rH
sq
sq
sq
JY
fo
ru
sq
"}
(10,1,1) = {"
sq
mz
uE
YP
nV
cq
TH
mz
sq
JY
fo
Ln
sq
"}
(11,1,1) = {"
sq
Nv
OR
ga
Wa
QD
Mh
cq
sq
ru
fo
fo
sq
"}
(12,1,1) = {"
sq
Up
Ir
dD
Rd
JY
Gf
kj
sq
tC
xa
Qn
sq
"}
(13,1,1) = {"
sq
sq
sq
sq
sq
sq
fP
sq
sq
sq
sq
sq
sq
"}
