"a" = (/turf/simulated/wall/solidrock,/area/space)
"b" = (/obj/effect/floor_decal/rust,/turf/simulated/floor/plating,/area/space)
"c" = (/obj/effect/spider/stickyweb,/turf/simulated/floor/plating,/area/space)
"d" = (/obj/effect/floor_decal/rust,/obj/structure/grille/broken,/turf/simulated/floor/plating,/area/space)
"e" = (/obj/effect/floor_decal/rust,/obj/structure/table/rack/shelf,/obj/random/tool,/obj/random/tool,/obj/random/tool,/obj/random/medical/lite,/turf/simulated/floor/tiled/techfloor,/area/space)
"f" = (/obj/machinery/atmospherics/pipe/manifold4w/visible,/turf/simulated/floor/tiled/techfloor,/area/space)
"g" = (/obj/effect/floor_decal/rust,/obj/effect/spider/stickyweb,/turf/simulated/floor/plating,/area/space)
"i" = (/turf/simulated/floor/plating,/area/space)
"j" = (/obj/machinery/atmospherics/pipe/tank/air,/turf/simulated/floor/tiled/techfloor,/area/space)
"k" = (/obj/effect/floor_decal/rust,/turf/simulated/floor/tiled/techfloor,/area/space)
"n" = (/obj/machinery/atmospherics/pipe/simple/visible{dir = 5},/obj/effect/floor_decal/rust,/obj/random/trash,/turf/simulated/floor/tiled/techfloor,/area/space)
"o" = (/obj/machinery/atmospherics/pipe/simple/hidden,/turf/simulated/wall/iron,/area/space)
"p" = (/obj/structure/girder,/turf/simulated/floor/plating,/area/space)
"q" = (/obj/structure/railing,/obj/structure/table/rack,/obj/random/tank,/turf/simulated/floor/tiled/techfloor,/area/space)
"r" = (/obj/effect/floor_decal/rust,/obj/structure/railing,/obj/machinery/portable_atmospherics/powered/pump,/obj/machinery/atmospherics/portables_connector{dir = 8},/turf/simulated/floor/tiled/techfloor,/area/space)
"s" = (/obj/machinery/atmospherics/pipe/manifold/visible,/obj/item/pipe_meter,/obj/effect/floor_decal/rust,/turf/simulated/floor/tiled/techfloor,/area/space)
"t" = (/obj/machinery/atmospherics/pipe/tank/air{dir = 1},/turf/simulated/floor/tiled/techfloor,/area/space)
"u" = (/obj/structure/sign/atmos_air,/turf/simulated/wall/iron,/area/space)
"x" = (/obj/effect/floor_decal/rust,/obj/random/junk,/obj/effect/spider/stickyweb,/turf/simulated/floor/plating,/area/space)
"z" = (/obj/machinery/atmospherics/valve,/obj/effect/floor_decal/rust/mono_rusted3,/turf/simulated/floor/tiled/techfloor,/area/space)
"B" = (/obj/structure/railing,/obj/machinery/atmospherics/pipe/simple/visible{dir = 8},/turf/simulated/floor/tiled/techfloor,/area/space)
"C" = (/obj/structure/girder/displaced,/turf/simulated/floor/plating,/area/space)
"F" = (/obj/machinery/atmospherics/pipe/manifold/visible{dir = 8},/obj/effect/floor_decal/rust,/turf/simulated/floor/tiled/techfloor,/area/space)
"G" = (/obj/machinery/atmospherics/pipe/tank/air,/obj/effect/spider/stickyweb,/turf/simulated/floor/tiled/techfloor,/area/space)
"H" = (/obj/machinery/atmospherics/pipe/simple/visible{dir = 8},/turf/simulated/floor/tiled/techfloor,/area/space)
"I" = (/obj/effect/floor_decal/rust,/obj/structure/railing,/obj/structure/table/rack,/obj/random/toolbox,/turf/simulated/floor/tiled/techfloor,/area/space)
"J" = (/obj/machinery/atmospherics/pipe/simple/visible{dir = 8},/obj/effect/floor_decal/rust,/mob/living/simple_mob/animal/passive/mouse/rat,/obj/random/trash,/turf/simulated/floor/tiled/techfloor,/area/space)
"K" = (/obj/effect/floor_decal/rust,/obj/machinery/atmospherics/pipe/zpipe/down,/obj/random/junk,/obj/effect/spider/stickyweb,/turf/simulated/floor/plating,/area/space)
"L" = (/obj/effect/floor_decal/rust,/obj/effect/spider/stickyweb,/obj/random/trash,/turf/simulated/floor/plating,/area/space)
"N" = (/obj/effect/floor_decal/rust,/obj/random/trash,/turf/simulated/floor/plating,/area/space)
"O" = (/obj/machinery/portable_atmospherics/powered/pump,/obj/machinery/atmospherics/portables_connector{dir = 8},/turf/simulated/floor/tiled/techfloor,/area/space)
"P" = (/turf/simulated/wall/iron,/area/space)
"R" = (/obj/effect/floor_decal/rust,/obj/structure/girder,/turf/simulated/floor/plating,/area/space)
"S" = (/obj/random/junk,/obj/effect/spider/stickyweb,/turf/simulated/floor/plating,/area/space)
"U" = (/obj/effect/floor_decal/rust,/mob/living/simple_mob/animal/passive/mouse/rat,/turf/simulated/floor/tiled/techfloor,/area/space)
"V" = (/obj/effect/floor_decal/rust,/obj/structure/mob_spawner/mouse_nest,/turf/simulated/floor/tiled/techfloor,/area/space)
"X" = (/obj/random/trash,/turf/simulated/floor/plating,/area/space)

(1,1,1) = {"
aaaaaadaaaaaa
aaaaaagKaaaaa
aaPPPRCoPppaa
aaPGjVkzUepaa
aaPFsJHfHOPga
aaPtIqknBrPga
LcPubbbiiiPib
agcPXbaaxgCXb
aabPCPPaagPbb
aabiNiPaaSpba
aaaPPibaPPPaa
aaaaPPNaaaaaa
aaaaaabaaaaaa
"}
