//MAP CONVERTED BY dmm2tgm.py THIS HEADER COMMENT PREVENTS RECONVERSION, DO NOT REMOVE
"a" = (
/turf/simulated/wall/solidrock,
/area)
"b" = (
/obj/structure/closet/crate/miningcar,
/obj/item/ore/gold,
/obj/item/ore/silver,
/obj/item/ore/coal,
/turf/simulated/mineral/floor,
/area)
"e" = (
/obj/effect/mine,
/turf/simulated/mineral/floor,
/area)
"g" = (
/obj/item/clothing/under/rank/miner,
/turf/simulated/mineral/floor,
/area)
"i" = (
/obj/item/material/shard,
/turf/simulated/mineral/floor,
/area)
"o" = (
/turf/simulated/mineral/floor,
/area)
"t" = (
/obj/item/clothing/suit/storage/hooded/wintercoat/miner,
/turf/simulated/mineral/floor,
/area)
"u" = (
/obj/structure/sign/signnew/explosives,
/turf/simulated/wall/solidrock,
/area)
"v" = (
/obj/effect/mine,
/obj/item/storage/box,
/turf/simulated/mineral/floor,
/area)
"w" = (
/obj/item/trash/liquidfood,
/turf/simulated/mineral/floor,
/area)
"x" = (
/obj/item/flashlight/lantern,
/turf/simulated/mineral/floor,
/area)
"E" = (
/obj/item/trash/candy/proteinbar,
/turf/simulated/mineral/floor,
/area)
"K" = (
/obj/item/pickaxe/diamonddrill,
/obj/item/clothing/shoes/boots/workboots,
/turf/simulated/mineral/floor,
/area)
"N" = (
/obj/effect/decal/remains,
/turf/simulated/mineral/floor,
/area)
"P" = (
/obj/machinery/botany,
/turf/simulated/mineral/floor,
/area)
"Q" = (
/obj/item/mine,
/turf/simulated/mineral/floor,
/area)
"S" = (
/obj/item/pickaxe/gold,
/obj/effect/decal/remains,
/mob/living/simple_mob/animal/giant_spider,
/turf/simulated/mineral/floor,
/area)
"Z" = (
/obj/effect/spider/stickyweb,
/turf/simulated/mineral/floor,
/area)

(1,1,1) = {"
a
a
a
a
a
a
o
a
a
a
a
a
a
"}
(2,1,1) = {"
a
o
o
Z
Z
a
o
o
o
o
o
Z
a
"}
(3,1,1) = {"
a
S
a
a
Z
a
o
o
a
o
o
Z
a
"}
(4,1,1) = {"
a
a
a
o
o
o
o
a
a
Z
o
Z
a
"}
(5,1,1) = {"
a
a
o
o
a
a
a
a
a
a
o
a
a
"}
(6,1,1) = {"
a
o
o
a
a
v
o
o
o
a
o
o
a
"}
(7,1,1) = {"
o
o
a
a
o
o
a
a
o
u
o
o
o
"}
(8,1,1) = {"
a
a
a
Q
o
o
o
a
e
o
o
o
a
"}
(9,1,1) = {"
a
P
o
E
o
o
a
a
a
a
a
o
a
"}
(10,1,1) = {"
a
P
N
x
o
Q
a
o
o
o
o
o
a
"}
(11,1,1) = {"
a
o
g
K
i
a
a
o
a
Z
o
o
a
"}
(12,1,1) = {"
a
b
o
t
w
a
o
o
a
a
Z
o
a
"}
(13,1,1) = {"
a
a
a
a
a
a
o
a
a
a
a
a
a
"}
