//MAP CONVERTED BY dmm2tgm.py THIS HEADER COMMENT PREVENTS RECONVERSION, DO NOT REMOVE
"a" = (
/turf/simulated/floor/plating,
/area/maintenance{
	name = "underdiner"
	})
"b" = (
/obj/machinery/appliance/cooker/fryer,
/obj/item/reagent_containers/cooking_container/fryer,
/obj/effect/floor_decal/corner/red/diagonal,
/turf/simulated/floor/tiled/steel_dirty,
/area/maintenance{
	name = "underdiner"
	})
"c" = (
/obj/effect/floor_decal/corner/red/diagonal,
/turf/simulated/floor/tiled/steel_dirty,
/area/maintenance{
	name = "underdiner"
	})
"d" = (
/obj/machinery/door/airlock/glass,
/turf/simulated/floor/tiled/steel_dirty,
/area/maintenance{
	name = "underdiner"
	})
"e" = (
/obj/structure/table/standard,
/obj/machinery/microwave,
/obj/machinery/light/flicker{
	dir = 1
	},
/obj/effect/floor_decal/corner/red/diagonal,
/turf/simulated/floor/tiled/steel_dirty,
/area/maintenance{
	name = "underdiner"
	})
"g" = (
/obj/machinery/light/flamp/flicker,
/turf/simulated/floor/tiled/steel_dirty,
/area/maintenance{
	name = "underdiner"
	})
"i" = (
/obj/random/trash_pile,
/turf/simulated/floor/tiled/steel_dirty,
/area/maintenance{
	name = "underdiner"
	})
"m" = (
/obj/structure/table/standard,
/obj/item/reagent_containers/food/condiment/small/saltshaker{
	pixel_x = 5
	},
/obj/item/reagent_containers/food/condiment/small/peppermill,
/obj/effect/floor_decal/corner/red/diagonal,
/turf/simulated/floor/tiled/steel_dirty,
/area/maintenance{
	name = "underdiner"
	})
"n" = (
/obj/item/stool/padded,
/obj/effect/floor_decal/corner/red/diagonal,
/turf/simulated/floor/tiled/steel_dirty,
/area/maintenance{
	name = "underdiner"
	})
"o" = (
/obj/structure/closet/secure_closet/freezer/fridge,
/mob/living/simple_mob/animal/passive/mouse/rat,
/mob/living/simple_mob/animal/passive/mouse/rat,
/mob/living/simple_mob/animal/passive/mouse/rat,
/mob/living/simple_mob/animal/passive/mouse/rat,
/mob/living/simple_mob/animal/passive/mouse/rat,
/mob/living/simple_mob/animal/passive/mouse/rat,
/obj/effect/floor_decal/corner/red/diagonal,
/turf/simulated/floor/tiled/steel_dirty,
/area/maintenance{
	name = "underdiner"
	})
"p" = (
/obj/structure/bed/chair/sofa{
	dir = 8
	},
/obj/effect/floor_decal/corner/red/diagonal,
/turf/simulated/floor/tiled/steel_dirty,
/area/maintenance{
	name = "underdiner"
	})
"s" = (
/obj/machinery/door/window/holowindoor{
	dir = 2
	},
/obj/effect/floor_decal/corner/red/diagonal,
/turf/simulated/floor/tiled/steel_dirty,
/area/maintenance{
	name = "underdiner"
	})
"t" = (
/obj/machinery/door/airlock,
/turf/simulated/floor/tiled/steel_dirty,
/area/maintenance{
	name = "underdiner"
	})
"u" = (
/obj/structure/bed/chair/sofa{
	dir = 4
	},
/obj/effect/floor_decal/corner/red/diagonal,
/turf/simulated/floor/tiled/steel_dirty,
/area/maintenance{
	name = "underdiner"
	})
"y" = (
/obj/structure/table/marble,
/obj/effect/floor_decal/corner/red/diagonal,
/obj/item/reagent_containers/food/snacks/fries,
/turf/simulated/floor/tiled/steel_dirty,
/area/maintenance{
	name = "underdiner"
	})
"z" = (
/obj/structure/table/marble,
/obj/effect/floor_decal/corner/red/diagonal,
/obj/item/reagent_containers/food/drinks/coffee,
/turf/simulated/floor/tiled/steel_dirty,
/area/maintenance{
	name = "underdiner"
	})
"D" = (
/obj/structure/table/standard,
/obj/item/reagent_containers/food/condiment/small/saltshaker,
/obj/item/reagent_containers/food/condiment/small/peppermill{
	pixel_x = -5
	},
/obj/effect/floor_decal/corner/red/diagonal,
/turf/simulated/floor/tiled/steel_dirty,
/area/maintenance{
	name = "underdiner"
	})
"F" = (
/obj/structure/sign/double/barsign,
/turf/simulated/wall,
/area/maintenance{
	name = "underdiner"
	})
"G" = (
/obj/structure/table/marble,
/obj/effect/floor_decal/corner/red/diagonal,
/obj/item/reagent_containers/food/snacks/bearburger,
/turf/simulated/floor/tiled/steel_dirty,
/area/maintenance{
	name = "underdiner"
	})
"I" = (
/obj/structure/loot_pile/maint/trash,
/turf/simulated/floor/tiled/steel_dirty,
/area/maintenance{
	name = "underdiner"
	})
"J" = (
/obj/structure/table/marble,
/obj/item/reagent_containers/food/condiment/small/saltshaker,
/obj/item/reagent_containers/food/condiment/small/peppermill{
	pixel_x = -5
	},
/obj/effect/floor_decal/corner/red/diagonal,
/turf/simulated/floor/tiled/steel_dirty,
/area/maintenance{
	name = "underdiner"
	})
"L" = (
/obj/item/stool/padded,
/obj/item/stool/padded,
/obj/effect/floor_decal/corner/red/diagonal,
/turf/simulated/floor/tiled/steel_dirty,
/area/maintenance{
	name = "underdiner"
	})
"N" = (
/obj/structure/table/standard,
/obj/machinery/chemical_dispenser/bar_soft,
/obj/effect/floor_decal/corner/red/diagonal,
/turf/simulated/floor/tiled/steel_dirty,
/area/maintenance{
	name = "underdiner"
	})
"Q" = (
/obj/structure/closet/crate/trashcart,
/turf/simulated/floor/tiled/steel_dirty,
/area/maintenance{
	name = "underdiner"
	})
"R" = (
/obj/structure/table/standard,
/obj/machinery/chemical_dispenser/bar_coffee,
/obj/effect/floor_decal/corner/red/diagonal,
/turf/simulated/floor/tiled/steel_dirty,
/area/maintenance{
	name = "underdiner"
	})
"S" = (
/turf/simulated/wall,
/area/maintenance{
	name = "underdiner"
	})
"T" = (
/turf/simulated/floor/tiled/steel_dirty,
/area/maintenance{
	name = "underdiner"
	})
"U" = (
/obj/machinery/door/airlock/glass,
/obj/effect/floor_decal/corner/red/diagonal,
/turf/simulated/floor/tiled/steel_dirty,
/area/maintenance{
	name = "underdiner"
	})
"V" = (
/obj/machinery/power/apc/alarms_hidden{
	cell_type = /obj/item/cell/hyper;
	chargelevel = 1;
	dir = 1;
	name = "Abandoned Diner APC";
	pixel_y = -30
	},
/turf/simulated/floor/tiled/steel_dirty,
/area/maintenance{
	name = "underdiner"
	})
"W" = (
/obj/structure/table/standard,
/obj/effect/floor_decal/corner/red/diagonal,
/turf/simulated/floor/tiled/steel_dirty,
/area/maintenance{
	name = "underdiner"
	})
"X" = (
/obj/effect/wingrille_spawn,
/turf/simulated/floor,
/area/maintenance{
	name = "underdiner"
	})
"Z" = (
/obj/structure/table/marble,
/obj/effect/floor_decal/corner/red/diagonal,
/obj/item/reagent_containers/food/snacks/hotdog,
/turf/simulated/floor/tiled/steel_dirty,
/area/maintenance{
	name = "underdiner"
	})

(1,1,1) = {"
a
a
a
a
a
a
a
a
a
a
a
a
a
"}
(2,1,1) = {"
a
g
T
T
T
T
T
T
T
T
g
T
a
"}
(3,1,1) = {"
a
T
S
S
S
S
X
X
X
S
T
T
a
"}
(4,1,1) = {"
a
T
S
o
c
s
c
c
u
X
T
T
T
"}
(5,1,1) = {"
a
T
t
c
c
z
n
c
m
X
d
S
T
"}
(6,1,1) = {"
a
Q
S
W
c
J
n
c
p
S
c
X
T
"}
(7,1,1) = {"
a
Q
S
e
c
y
L
c
c
U
c
X
T
"}
(8,1,1) = {"
a
I
S
b
c
G
L
c
u
S
c
X
T
"}
(9,1,1) = {"
a
i
S
N
c
J
n
c
D
X
d
S
T
"}
(10,1,1) = {"
a
V
S
R
c
Z
n
c
p
X
T
T
T
"}
(11,1,1) = {"
a
T
S
S
S
S
X
X
S
S
T
F
a
"}
(12,1,1) = {"
a
g
T
T
T
T
T
T
T
T
g
S
a
"}
(13,1,1) = {"
a
a
a
a
a
a
a
a
a
a
a
a
a
"}
