//MAP CONVERTED BY dmm2tgm.py THIS HEADER COMMENT PREVENTS RECONVERSION, DO NOT REMOVE
"a" = (
/turf/template_noop,
/area/template_noop)
"e" = (
/turf/simulated/floor/tiled/techfloor/grid,
/area/submap/skyplanet/poi/broken2)
"g" = (
/obj/random/multiple/corp_crate,
/turf/simulated/floor/tiled/techfloor/grid,
/area/submap/skyplanet/poi/broken2)
"j" = (
/obj/effect/floor_decal/rust,
/obj/random/cutout,
/turf/simulated/floor/plating/outdoors,
/area/submap/skyplanet/poi/broken2)
"k" = (
/obj/machinery/door/airlock,
/turf/simulated/floor/tiled/techmaint,
/area/submap/skyplanet/poi/broken2)
"m" = (
/obj/effect/floor_decal/rust,
/turf/simulated/floor/plating/outdoors,
/area/template_noop)
"o" = (
/obj/random/mob/robotic,
/obj/effect/floor_decal/rust,
/turf/simulated/floor/tiled/techfloor/grid,
/area/submap/skyplanet/poi/broken2)
"p" = (
/obj/effect/floor_decal/rust,
/obj/random/cutout,
/turf/simulated/floor/tiled/techfloor/grid,
/area/submap/skyplanet/poi/broken2)
"q" = (
/obj/effect/floor_decal/rust,
/turf/simulated/floor/tiled/techmaint,
/area/submap/skyplanet/poi/broken2)
"s" = (
/turf/simulated/floor/plating/outdoors,
/area/submap/skyplanet/poi/broken2)
"t" = (
/obj/structure/table/rack/shelf/steel,
/obj/effect/floor_decal/rust,
/obj/random/multiple/ores,
/turf/simulated/floor/tiled/techfloor/grid,
/area/submap/skyplanet/poi/broken2)
"u" = (
/turf/simulated/wall/r_wall,
/area/template_noop)
"w" = (
/obj/structure/event/prop/terminal2,
/turf/simulated/floor/tiled/techfloor/grid,
/area/submap/skyplanet/poi/broken2)
"x" = (
/turf/simulated/floor/plating/outdoors,
/area/template_noop)
"y" = (
/obj/machinery/door/airlock,
/turf/simulated/floor/tiled/techfloor/grid,
/area/submap/skyplanet/poi/broken2)
"z" = (
/obj/structure/table/rack/shelf/steel,
/obj/random/fishing_junk,
/turf/simulated/floor/tiled/techfloor/grid,
/area/submap/skyplanet/poi/broken2)
"B" = (
/obj/structure/table/rack/shelf/steel,
/obj/effect/floor_decal/rust,
/turf/simulated/floor/tiled/techfloor/grid,
/area/submap/skyplanet/poi/broken2)
"D" = (
/obj/effect/floor_decal/rust,
/turf/simulated/floor/tiled/techfloor/grid,
/area/submap/skyplanet/poi/broken2)
"F" = (
/obj/effect/floor_decal/rust,
/obj/random/multiple/large_corp_crate,
/turf/simulated/floor/tiled/techfloor/grid,
/area/submap/skyplanet/poi/broken2)
"H" = (
/obj/item/event/prop/laptop1{
	pixel_y = 13
	},
/turf/simulated/floor/tiled/techfloor/grid,
/area/submap/skyplanet/poi/broken2)
"K" = (
/obj/random/mob/robotic,
/turf/simulated/floor/tiled/techfloor/grid,
/area/submap/skyplanet/poi/broken2)
"L" = (
/obj/structure/lattice,
/turf/template_noop,
/area/template_noop)
"M" = (
/obj/structure/lattice,
/turf/template_noop,
/area/submap/skyplanet/poi/broken2)
"P" = (
/obj/random/cutout,
/turf/simulated/floor/plating/outdoors,
/area/submap/skyplanet/poi/broken2)
"Q" = (
/obj/structure/table/rack/shelf/steel,
/obj/random/drinkbottle,
/turf/simulated/floor/tiled/techfloor/grid,
/area/submap/skyplanet/poi/broken2)
"R" = (
/turf/simulated/floor/tiled/techmaint,
/area/submap/skyplanet/poi/broken2)
"U" = (
/obj/structure/event/prop/server2,
/turf/simulated/floor/tiled/techfloor/grid,
/area/submap/skyplanet/poi/broken2)
"W" = (
/obj/effect/floor_decal/rust,
/turf/simulated/floor/plating/outdoors,
/area/submap/skyplanet/poi/broken2)
"X" = (
/obj/structure/event/prop/processor2,
/turf/simulated/floor/tiled/techfloor/monogrid,
/area/submap/skyplanet/poi/broken2)
"Y" = (
/turf/simulated/wall/r_wall,
/area/submap/skyplanet/poi/broken2)

(1,1,1) = {"
u
a
a
a
a
a
a
a
a
a
a
a
a
a
a
a
a
a
a
u
"}
(2,1,1) = {"
a
a
a
a
a
a
a
a
a
a
a
a
a
a
a
a
a
a
a
a
"}
(3,1,1) = {"
a
a
a
a
a
a
a
a
a
a
a
a
a
a
a
a
a
a
a
a
"}
(4,1,1) = {"
a
a
a
a
a
Y
Y
Y
Y
Y
Y
Y
Y
Y
Y
a
a
a
a
a
"}
(5,1,1) = {"
a
a
a
a
Y
Y
H
e
e
D
k
R
s
P
Y
Y
a
a
a
a
"}
(6,1,1) = {"
a
a
a
Y
Y
X
e
e
K
t
Y
R
R
W
s
Y
Y
a
a
a
"}
(7,1,1) = {"
a
a
a
Y
U
e
e
D
D
B
Y
R
R
R
s
s
Y
a
a
a
"}
(8,1,1) = {"
a
a
a
Y
w
o
e
D
D
Q
Y
s
W
q
s
W
Y
a
a
a
"}
(9,1,1) = {"
a
a
a
Y
U
D
e
D
D
z
Y
s
s
s
W
j
Y
a
a
a
"}
(10,1,1) = {"
a
a
a
Y
Y
y
Y
Y
Y
Y
Y
M
M
s
W
s
Y
a
a
a
"}
(11,1,1) = {"
a
a
a
Y
D
D
e
e
s
s
M
a
a
L
L
x
m
a
a
a
"}
(12,1,1) = {"
a
a
a
Y
y
Y
Y
Y
s
M
M
L
a
a
a
L
L
a
a
a
"}
(13,1,1) = {"
a
a
a
Y
D
e
g
Y
q
W
W
L
a
a
a
a
L
a
a
a
"}
(14,1,1) = {"
a
a
a
Y
p
o
D
Y
q
s
M
L
a
a
a
a
a
a
a
a
"}
(15,1,1) = {"
a
a
a
Y
Y
D
D
Y
q
s
W
L
a
a
a
a
a
a
a
a
"}
(16,1,1) = {"
a
a
a
a
Y
Y
F
Y
s
W
s
L
L
a
a
a
a
a
a
a
"}
(17,1,1) = {"
a
a
a
a
a
Y
Y
Y
Y
Y
Y
m
L
L
a
a
a
a
a
a
"}
(18,1,1) = {"
a
a
a
a
a
a
a
a
a
a
a
a
a
a
a
a
a
a
a
a
"}
(19,1,1) = {"
a
a
a
a
a
a
a
a
a
a
a
a
a
a
a
a
a
a
a
a
"}
(20,1,1) = {"
u
a
a
a
a
a
a
a
a
a
a
a
a
a
a
a
a
a
a
u
"}
