//MAP CONVERTED BY dmm2tgm.py THIS HEADER COMMENT PREVENTS RECONVERSION, DO NOT REMOVE
"a" = (
/turf/simulated/floor/plating/outdoors,
/area/template_noop)
"c" = (
/obj/effect/floor_decal/rust,
/turf/simulated/floor/tiled/techfloor/lythios43c,
/area/template_noop)
"k" = (
/turf/simulated/floor/tiled/techfloor/lythios43c,
/area/template_noop)
"C" = (
/turf/template_noop,
/area/template_noop)
"N" = (
/obj/effect/floor_decal/rust,
/turf/template_noop,
/area/template_noop)
"U" = (
/turf/simulated/wall/r_wall,
/area/template_noop)
"Z" = (
/obj/effect/floor_decal/rust,
/turf/simulated/floor/plating/outdoors,
/area/template_noop)

(1,1,1) = {"
U
k
k
k
a
a
C
C
C
C
C
C
C
C
C
C
C
C
C
U
"}
(2,1,1) = {"
k
k
k
Z
Z
a
a
C
C
C
C
C
C
C
C
C
a
C
C
C
"}
(3,1,1) = {"
k
a
a
Z
k
c
a
a
C
C
C
C
C
C
a
a
Z
a
a
C
"}
(4,1,1) = {"
a
k
k
c
k
k
Z
Z
a
C
C
C
a
a
a
Z
a
k
Z
a
"}
(5,1,1) = {"
Z
c
k
k
Z
k
a
Z
Z
a
a
a
a
a
a
c
c
c
Z
a
"}
(6,1,1) = {"
Z
c
c
k
a
Z
k
a
a
Z
a
a
a
Z
c
k
c
k
a
C
"}
(7,1,1) = {"
Z
Z
Z
k
k
a
c
k
k
a
Z
Z
Z
c
k
c
k
Z
a
C
"}
(8,1,1) = {"
a
Z
Z
c
k
a
k
c
k
k
k
k
a
a
k
k
Z
a
C
C
"}
(9,1,1) = {"
a
Z
a
Z
k
k
a
c
c
c
c
c
Z
a
c
k
Z
a
C
C
"}
(10,1,1) = {"
C
a
Z
Z
k
k
a
a
k
c
k
k
a
k
k
k
c
a
k
C
"}
(11,1,1) = {"
a
Z
Z
c
c
c
c
c
a
c
k
k
Z
c
k
c
k
a
a
C
"}
(12,1,1) = {"
a
Z
k
k
k
k
k
c
k
Z
c
c
k
Z
a
c
k
k
a
C
"}
(13,1,1) = {"
a
c
a
k
k
k
k
c
c
c
Z
k
k
c
a
c
k
k
a
C
"}
(14,1,1) = {"
a
c
a
k
k
k
k
c
c
k
k
k
k
c
k
c
c
c
Z
C
"}
(15,1,1) = {"
a
a
Z
k
k
a
Z
Z
a
a
a
k
k
c
k
k
k
c
Z
C
"}
(16,1,1) = {"
C
a
k
Z
a
Z
Z
a
a
Z
Z
Z
a
c
k
k
k
Z
k
C
"}
(17,1,1) = {"
C
a
a
k
Z
Z
c
Z
Z
N
C
a
a
Z
Z
Z
Z
a
C
C
"}
(18,1,1) = {"
C
C
a
a
a
a
a
a
C
C
C
C
C
a
a
a
a
C
C
C
"}
(19,1,1) = {"
C
C
C
C
C
C
C
C
C
C
C
C
C
C
C
C
C
C
C
C
"}
(20,1,1) = {"
U
C
C
C
C
C
C
C
C
C
C
C
C
C
C
C
C
C
C
U
"}
