"a" = (/turf/template_noop,/area/template_noop)
"b" = (/turf/template_noop,/area/submap/snowfields/diyaabepod)
"c" = (/mob/living/simple_animal/hostile/diyaab,/turf/template_noop,/area/submap/snowfields/diyaabepod)
"d" = (/obj/structure/flora/bush,/turf/template_noop,/area/submap/snowfields/diyaabepod)
"e" = (/obj/item/weapon/airlock_electronics,/turf/template_noop,/area/submap/snowfields/diyaabepod)
"f" = (/obj/structure/door_assembly/door_assembly_ext,/turf/template_noop,/area/submap/snowfields/diyaabepod)
"g" = (/obj/effect/decal/cleanable/blood,/turf/template_noop,/area/submap/snowfields/diyaabepod)
"h" = (/obj/structure/shuttle/engine/propulsion/burst{dir = 1},/turf/simulated/shuttle/wall,/area/submap/snowfields/diyaabepod)
"i" = (/turf/simulated/shuttle/floor,/area/submap/snowfields/diyaabepod)
"j" = (/obj/effect/decal/remains/ribcage,/turf/template_noop,/area/submap/snowfields/diyaabepod)
"k" = (/turf/simulated/shuttle/wall,/area/submap/snowfields/diyaabepod)
"l" = (/mob/living/simple_animal/retaliate/diyaab,/turf/template_noop,/area/submap/snowfields/diyaabepod)
"m" = (/obj/structure/bed/chair,/obj/item/device/radio/intercom{dir = 8; name = "Station Intercom (General)"; pixel_x = -28},/obj/structure/closet/walllocker/emerglocker{pixel_x = 28},/obj/item/weapon/weldingtool,/mob/living/simple_animal/retaliate/diyaab,/turf/simulated/shuttle/floor,/area/submap/snowfields/diyaabepod)
"n" = (/obj/effect/decal/remains/human,/turf/template_noop,/area/submap/snowfields/diyaabepod)
"o" = (/obj/structure/bed/chair,/obj/machinery/vending/wallmed1{layer = 3.3; name = "Emergency NanoMed"; pixel_x = 28; pixel_y = 0},/obj/machinery/light{dir = 8; icon_state = "tube1"; pixel_y = 0},/turf/simulated/shuttle/floor,/area/submap/snowfields/diyaabepod)
"p" = (/obj/structure/bed/chair,/obj/machinery/status_display{density = 0; layer = 4; pixel_x = -32; pixel_y = 0},/obj/item/weapon/storage/backpack/satchel,/obj/item/weapon/spacecash/c100,/turf/simulated/shuttle/floor,/area/submap/snowfields/diyaabepod)
"q" = (/obj/structure/flora/tree/pine,/turf/template_noop,/area/submap/snowfields/diyaabepod)
"r" = (/obj/structure/shuttle/window,/obj/structure/grille,/turf/simulated/shuttle/plating,/area/submap/snowfields/diyaabepod)
"s" = (/obj/structure/flora/tree/dead,/turf/template_noop,/area/submap/snowfields/diyaabepod)

(1,1,1) = {"
aaaaaaaaaaaaaaa
abbbbdbbbbbefba
ablbbbglbhihbba
abbblbbbjkmkbba
abdbbbbnbkokbba
abbcbblbgkpkbba
abblqbbbbkrkbba
abbbbbbbblbsbba
abbbbbbbbdbbbba
aaaaaaaaaaaaaaa
"}
