"a" = (/turf/simulated/wall/solidrock{block_tele = 0},/area/submap/snowfields/icecave1d)
"b" = (/turf/template_noop,/area/template_noop)
"c" = (/turf/simulated/floor/outdoors/ice{outdoors = 0},/area/submap/snowfields/icecave1d)
"d" = (/obj/machinery/crystal/ice,/turf/simulated/floor/outdoors/ice{outdoors = 0},/area/submap/snowfields/icecave1d)
"e" = (/obj/structure/loot_pile/surface/bones,/mob/living/simple_animal/hostile/savik,/turf/simulated/floor/snow,/area/submap/snowfields/icecave1d)
"f" = (/turf/simulated/floor/snow,/area/submap/snowfields/icecave1d)
"g" = (/obj/machinery/crystal/ice,/turf/simulated/floor/snow,/area/submap/snowfields/icecave1d)
"h" = (/obj/random/firstaid,/turf/simulated/floor/snow,/area/submap/snowfields/icecave1d)
"i" = (/obj/item/ammo_casing/a12g/pellet,/turf/simulated/floor/snow,/area/submap/snowfields/icecave1d)
"j" = (/obj/item/weapon/gun/projectile/shotgun/pump/combat,/turf/simulated/floor/snow,/area/submap/snowfields/icecave1d)
"k" = (/obj/random/ammo,/turf/simulated/floor/snow,/area/submap/snowfields/icecave1d)
"l" = (/obj/structure/loot_pile/surface/bones,/obj/item/ammo_magazine/clip/c12g/pellet,/turf/simulated/floor/snow,/area/submap/snowfields/icecave1d)
"m" = (/obj/structure/loot_pile/surface/bones,/turf/simulated/floor/snow,/area/submap/snowfields/icecave1d)
"n" = (/mob/living/simple_animal/hostile/savik,/turf/simulated/floor/snow,/area/submap/snowfields/icecave1d)

(1,1,1) = {"
bbaaaaaaaaaaaaaaaaabbbbbbbbbbbbaaaaaaaaa
baaaaaaaaaaaaaaaaaaabbbbbbbbbbaaaaaaaaaa
aacccccdccccccccddaabbbbbbbbbbaaaefggaaa
aaccccccccccccccddaaabbbbbbbbaaagfffghaa
aaccccccccccccccaaaaaaaaaaaaaaaafffijkaa
aaccccccccccdcccaaaaaaaaaaaaaaafifffilaa
aadccccccccccccdaaaaaaccccdccggifffffaaa
aaccccccccccccccaaaaaacccccccffffgifgaaa
aaccccccccccccccffffffdccccccgggaaaaaaaa
aacccccccccdccccffggffccdcccdgggaaaaaaab
aaccdcccccccccccaaaaaaddaaaaaaaaaaabbbbb
aaccccdccccccccdaaaaaaddagmnfffaaaabbbbb
aaccccccdcccccccaaggffgdagfffffaabbbbbbb
aaccccccccccccccaafffffgaaafafgaabbbbbbb
baaaaadddddddddfffffgfffffffaffaabbbbbbb
baaaaagggfffgddddggggggffgffaffaabbbbbbb
aagggfffffffffccaaaaaaaaffngagfaabbbbbbb
aagnffffffffffccaaaaaaaaggggaffaabbbbbbb
aaaggfaaaaaaaaccaaaaaaagfffffffaabbbbbbb
aaaaffaaaaaaaaccaaaaaaaffffffaaaabbbbbbb
aaaaffgaaaaaaaccccccddafffffgaaaabbbbbbb
aaaaaffgaaaaaaccccccddaagfaaaaabbbbbbbbb
aaaagfffaaaaaaaaddccffgfffaaaaabbbbbbbbb
aaaggafffaaaaaaaddccffffffaabbbbbbbbbbbb
faaaaafffgaaaaaaaaaaaafffgaabbbbbbbbbbbb
ffaaaagffaaaaaaaaaaaaaggggaabbbbbbbbbbbb
fffffffffaaaaaaaaaaaaaaaaaaabbbbbbbbbbbb
bfffffffaaaaaaaaaaaaaaaaaaaabbbbbbbbbbbb
"}
