"aa" = (/turf/template_noop,/area/template_noop)
"ab" = (/turf/simulated/floor/outdoors/snow/virgo6,/area/submap/snowfields/qarantineshuttlesnow)
"ac" = (/obj/item/weapon/caution/cone,/turf/simulated/floor/outdoors/snow/virgo6,/area/submap/snowfields/qarantineshuttlesnow)
"ad" = (/turf/simulated/shuttle/wall,/area/submap/snowfields/qarantineshuttlesnow)
"ae" = (/obj/structure/inflatable,/turf/simulated/floor/outdoors/snow/virgo6,/area/submap/snowfields/qarantineshuttlesnow)
"af" = (/obj/structure/inflatable/door,/turf/simulated/floor/outdoors/snow/virgo6,/area/submap/snowfields/qarantineshuttlesnow)
"ag" = (/obj/structure/shuttle/engine/heater{icon_state = "heater"; dir = 4},/turf/simulated/floor/plating/virgo6,/area/submap/snowfields/qarantineshuttlesnow)
"ah" = (/obj/structure/shuttle/engine/propulsion{icon_state = "propulsion_l"; dir = 8},/turf/simulated/floor/plating/virgo6,/area/submap/snowfields/qarantineshuttlesnow)
"ai" = (/obj/structure/grille,/obj/structure/shuttle/window,/obj/machinery/door/blast/regular{dir = 8; id = "QShuttlePoIDoors"; layer = 3.3; name = "Emergency Lockdown Shutters"},/obj/item/tape/medical{dir = 4; icon_state = "tape_door_0"; layer = 3.4},/turf/simulated/floor/plating/virgo6,/area/submap/snowfields/qarantineshuttlesnow)
"aj" = (/turf/simulated/shuttle/wall/hard_corner,/area/submap/snowfields/qarantineshuttlesnow)
"ak" = (/obj/machinery/door/airlock/external{desc = "It opens and closes. It is stamped with the logo of Major Bill's Transportation"; frequency = 1380; icon_state = "door_locked"; id_tag = null; locked = 1; name = "MBT-540"},/obj/item/tape/medical{dir = 4; icon_state = "tape_door_0"; layer = 3.4},/turf/simulated/shuttle/floor{icon_state = "floor_white"},/area/submap/snowfields/qarantineshuttlesnow)
"al" = (/obj/structure/sign/biohazard{dir = 1},/turf/simulated/shuttle/wall/hard_corner,/area/submap/snowfields/qarantineshuttlesnow)
"am" = (/obj/structure/toilet{dir = 4},/obj/effect/decal/cleanable/vomit,/obj/effect/decal/remains/human,/turf/simulated/shuttle/floor,/area/submap/snowfields/qarantineshuttlesnow)
"an" = (/obj/machinery/door/airlock{name = "Restroom"},/turf/simulated/shuttle/wall,/area/submap/snowfields/qarantineshuttlesnow)
"ao" = (/obj/effect/decal/cleanable/vomit,/mob/living/simple_animal/hostile/creature/strong,/turf/simulated/shuttle/floor{icon_state = "floor_white"},/area/submap/snowfields/qarantineshuttlesnow)
"ap" = (/obj/effect/decal/remains/human,/obj/item/clothing/suit/space/emergency,/obj/item/clothing/head/helmet/space/emergency,/turf/simulated/shuttle/floor{icon_state = "floor_white"},/area/submap/snowfields/qarantineshuttlesnow)
"aq" = (/obj/structure/bed/chair,/turf/simulated/shuttle/floor{icon_state = "floor_white"},/area/submap/snowfields/qarantineshuttlesnow)
"ar" = (/obj/structure/bed/chair,/obj/effect/decal/remains/human,/obj/item/clothing/suit/space/emergency,/turf/simulated/shuttle/floor{icon_state = "floor_white"},/area/submap/snowfields/qarantineshuttlesnow)
"as" = (/obj/machinery/vending/snack{contraband = null; products = list(/obj/item/weapon/reagent_containers/food/snacks/candy = 0, /obj/item/weapon/reagent_containers/food/drinks/dry_ramen = 0, /obj/item/weapon/reagent_containers/food/snacks/chips = 0, /obj/item/weapon/reagent_containers/food/snacks/sosjerky = 0, /obj/item/weapon/reagent_containers/food/snacks/no_raisin = 0, /obj/item/weapon/reagent_containers/food/snacks/spacetwinkie = 0, /obj/item/weapon/reagent_containers/food/snacks/cheesiehonkers = 0, /obj/item/weapon/reagent_containers/food/snacks/tastybread = 0, /obj/item/weapon/reagent_containers/food/snacks/skrellsnacks = 0)},/turf/simulated/shuttle/floor{icon_state = "floor_white"},/area/submap/snowfields/qarantineshuttlesnow)
"at" = (/obj/machinery/vending/cola{contraband = null; products = list(/obj/item/weapon/reagent_containers/food/drinks/cans/cola = 0, /obj/item/weapon/reagent_containers/food/drinks/cans/space_mountain_wind = 0, /obj/item/weapon/reagent_containers/food/drinks/cans/dr_gibb = 0, /obj/item/weapon/reagent_containers/food/drinks/cans/starkist = 0, /obj/item/weapon/reagent_containers/food/drinks/cans/waterbottle = 0, /obj/item/weapon/reagent_containers/food/drinks/cans/space_up = 0, /obj/item/weapon/reagent_containers/food/drinks/cans/iced_tea = 0, /obj/item/weapon/reagent_containers/food/drinks/cans/grape_juice = 0, /obj/item/weapon/reagent_containers/food/drinks/cans/gingerale = 0)},/turf/simulated/shuttle/floor{icon_state = "floor_white"},/area/submap/snowfields/qarantineshuttlesnow)
"au" = (/obj/structure/closet/crate/secure/loot,/turf/simulated/shuttle/floor{icon_state = "floor_yellow"},/area/submap/snowfields/qarantineshuttlesnow)
"av" = (/obj/item/weapon/pickaxe/drill,/turf/simulated/shuttle/floor{icon_state = "floor_yellow"},/area/submap/snowfields/qarantineshuttlesnow)
"aw" = (/obj/item/clothing/mask/breath,/obj/effect/decal/cleanable/dirt,/turf/simulated/shuttle/floor{icon_state = "floor_white"},/area/submap/snowfields/qarantineshuttlesnow)
"ax" = (/obj/effect/decal/cleanable/generic,/turf/simulated/shuttle/floor{icon_state = "floor_white"},/area/submap/snowfields/qarantineshuttlesnow)
"ay" = (/obj/effect/decal/remains/xeno,/turf/simulated/shuttle/floor{icon_state = "floor_yellow"},/area/submap/snowfields/qarantineshuttlesnow)
"az" = (/obj/item/trash/syndi_cakes,/turf/simulated/shuttle/floor{icon_state = "floor_yellow"},/area/submap/snowfields/qarantineshuttlesnow)
"aA" = (/turf/simulated/shuttle/floor{icon_state = "floor_yellow"},/area/submap/snowfields/qarantineshuttlesnow)
"aB" = (/obj/item/weapon/cigbutt,/obj/item/weapon/tank/emergency/oxygen,/turf/simulated/shuttle/floor{icon_state = "floor_yellow"},/area/submap/snowfields/qarantineshuttlesnow)
"aC" = (/obj/item/weapon/material/knife/tacknife/boot,/obj/item/clothing/mask/breath,/turf/simulated/shuttle/floor{icon_state = "floor_yellow"},/area/submap/snowfields/qarantineshuttlesnow)
"aD" = (/obj/effect/decal/remains/human,/turf/simulated/shuttle/floor{icon_state = "floor_white"},/area/submap/snowfields/qarantineshuttlesnow)
"aE" = (/obj/item/trash/sosjerky,/obj/item/weapon/storage/box/donut/empty,/obj/item/weapon/reagent_containers/food/drinks/sillycup,/turf/simulated/shuttle/floor{icon_state = "floor_white"},/area/submap/snowfields/qarantineshuttlesnow)
"aF" = (/obj/structure/grille,/obj/structure/window/reinforced{dir = 1; health = 1e+006},/obj/structure/window/reinforced,/obj/structure/window/reinforced{dir = 8},/turf/simulated/shuttle/plating,/area/submap/snowfields/qarantineshuttlesnow)
"aG" = (/obj/machinery/door/airlock/glass,/turf/simulated/shuttle/floor{icon_state = "floor_yellow"},/area/submap/snowfields/qarantineshuttlesnow)
"aH" = (/obj/structure/grille,/obj/structure/window/reinforced{dir = 1; health = 1e+006},/obj/structure/window/reinforced{dir = 4},/turf/simulated/shuttle/plating,/area/submap/snowfields/qarantineshuttlesnow)
"aI" = (/obj/machinery/button{name = "Cargo Hatch"},/turf/simulated/shuttle/wall,/area/submap/snowfields/qarantineshuttlesnow)
"aJ" = (/obj/machinery/computer,/turf/simulated/shuttle/floor,/area/submap/snowfields/qarantineshuttlesnow)
"aK" = (/obj/structure/bed/chair/comfy/brown{dir = 8},/obj/effect/decal/cleanable/vomit,/turf/simulated/shuttle/floor{icon_state = "floor_white"},/area/submap/snowfields/qarantineshuttlesnow)
"aL" = (/obj/structure/table/standard,/obj/item/clothing/head/helmet/space/emergency,/obj/item/weapon/paper{desc = "It looks old."; icon_state = "paper_words"; info = "<B>Pilot's Log for Major Bill's Transportation Shuttle MBT-540</B><BR>Routine flight inbound for VIMC Outpost C-12 6:35AM 03/12/2491, Estimated arrival 7:05AM. 16 passengers, 2 crew.<BR><B>V.I.S Traffic Control 06:05:55:</B>Major Bill's MBT-540 you are clear for departure from Dock 6 on departure route Charlie. Have a safe flight.<BR><B>Captain Willis 06:06:33:</B> You too, control. Departing route Charlie.<BR><B>Captain Willis 06:06:48:</B> ...Damn it.<BR> ** <BR><B>Captain Adisu 06:10:23: </B> Hey Ted, I'm seeing a fuel line pressure drop on engine 3?<BR><B>Captain Willis 06:10:50</B>: Yeah, I see it. Heater's fading out, redistributing thrust 30% to compensate.<BR><B>06:12:31: A loud thud is heard.</B><BR><B>Captain Adisu 06:12:34: </B> What the (Expletives)?<BR><B>Captain Adisu 06:12:39:</B> We just lost power to engine- engine two. Hold on... Atmospheric alarm in the cargo bay. Son of a...<BR><B>Captain Willis 06:12:59:</B> Reducing thrust further 30%, do we have a breach Adi, a breach?<BR><B>Captain Adisu 06:13:05:</B>No breach, checking cameras... Looks like- looks like some cargo came loose back there.<BR><B>Captain Willis 06:13:15:</B> (Expletives), I'm turning us around. Put out a distress call to Control, we'll be back in Sif orbit in a couple of minutes. <BR> ** <BR> <BR><B>V.I.S Traffic Control 06:15:49:</B> MBT-540 we are recieving you. Your atmospheric sensors are reading potentially harmful toxins in your cargo bay. Advise locking down interior cargo bay doors. Please stand by.<BR><B>Captain Adisu 06:16:10:</B> Understood. <BR> ** <BR><B>V.I.S Traffic Control 06:27:02: </B> MBT-540, we have no docking bays available at this time, are you equipped for atmospheric re-entry?<BR><B>Captain Willis 06:27:12:</B> We-We are shielded. But we have fuel and air for-<BR><B>V.I.S Traffic Control 06:27:17:</B> Please make an emergency landing at the coordinates provided and standby for further information.<BR> ** <BR><B>Captain Willis 06:36:33:</B> Emergency landing successful. Adi, er Adisu is checking on the passengers but we had a smooth enough landing, are we clear to begin evacu-<BR><B>06:36:50: (Sound of emergency shutters closing)</B><BR><B>Captain Willis 06:36:51: </B>What the hell? Control we just had a remote activation of our emergency shutters, please advise.<BR><B>V.I.S Traffic Control 06:38:10:</B> Captain, please tune to frequency 1493.8 we are passing you on to local emergency response units. Godspeed.<BR><B>Captain Willis 06:38:49:</B> This is Captain Willis of Major Bill's Transportation flight MBT-540 we have eighteen souls aboard and our emergency lockdown shutters have engaged remotely. Do you read?<BR><B>S.D.D.C:</B> This is the Sif Department of Disease Control, your vessel has been identified as carrying highly sensitive materials, and due to the nature of your system's automated alerts you will be asked to remain in quarantine until we are able to determine the nature of the pathogens aboard and whether it has entered the air circulation system. Please remain in your cockpit at this time.<BR> ** </BR><B>Captain Adisu 17:23:58:09:</B> I don't think they're opening those doors Ted. I don't think they're coming.</BR>"; item_state = "paper"; name = "Black Box Transcript MBT-540"},/turf/simulated/shuttle/floor,/area/submap/snowfields/qarantineshuttlesnow)
"aM" = (/obj/item/trash/cheesie,/obj/effect/decal/remains/human,/turf/simulated/shuttle/floor{icon_state = "floor_white"},/area/submap/snowfields/qarantineshuttlesnow)
"aN" = (/obj/effect/decal/cleanable/dirt,/turf/simulated/shuttle/floor{icon_state = "floor_yellow"},/area/submap/snowfields/qarantineshuttlesnow)
"aO" = (/obj/structure/bed/chair{dir = 1},/obj/effect/decal/cleanable/dirt,/turf/simulated/shuttle/floor{icon_state = "floor_yellow"},/area/submap/snowfields/qarantineshuttlesnow)
"aP" = (/obj/structure/bed/chair{dir = 1},/obj/effect/decal/remains/human,/obj/item/clothing/mask/breath,/turf/simulated/shuttle/floor{icon_state = "floor_white"},/area/submap/snowfields/qarantineshuttlesnow)
"aQ" = (/obj/structure/bed/chair{dir = 1},/turf/simulated/shuttle/floor{icon_state = "floor_white"},/area/submap/snowfields/qarantineshuttlesnow)
"aR" = (/obj/structure/bed/chair{dir = 1},/turf/simulated/shuttle/floor{icon_state = "floor_yellow"},/area/submap/snowfields/qarantineshuttlesnow)
"aS" = (/obj/effect/decal/cleanable/vomit,/turf/simulated/shuttle/floor{icon_state = "floor_yellow"},/area/submap/snowfields/qarantineshuttlesnow)
"aT" = (/obj/item/clothing/head/helmet/space/emergency,/turf/simulated/shuttle/floor{icon_state = "floor_white"},/area/submap/snowfields/qarantineshuttlesnow)
"aU" = (/obj/machinery/door/airlock/engineering{icon_state = "door_locked"; locked = 1; name = "Cargo Bay"},/turf/simulated/shuttle/floor{icon_state = "floor_yellow"},/area/submap/snowfields/qarantineshuttlesnow)
"aV" = (/obj/item/weapon/virusdish/random,/turf/simulated/shuttle/floor{icon_state = "floor_yellow"},/area/submap/snowfields/qarantineshuttlesnow)
"aW" = (/mob/living/simple_animal/hostile/creature/strong,/turf/simulated/shuttle/floor{icon_state = "floor_yellow"},/area/submap/snowfields/qarantineshuttlesnow)
"aX" = (/obj/item/weapon/material/shard,/turf/simulated/shuttle/floor{icon_state = "floor_yellow"},/area/submap/snowfields/qarantineshuttlesnow)
"aY" = (/obj/item/device/paicard,/turf/simulated/shuttle/floor{icon_state = "floor_yellow"},/area/submap/snowfields/qarantineshuttlesnow)
"aZ" = (/obj/machinery/door/blast/regular{name = "Cargo Door"},/obj/item/tape/medical{dir = 4; icon_state = "tape_door_0"; layer = 3.4},/turf/simulated/shuttle/floor{icon_state = "floor_yellow"},/area/submap/snowfields/qarantineshuttlesnow)
"ba" = (/obj/effect/decal/remains/human,/obj/item/clothing/under/mbill{desc = "A uniform belonging to Major Bill's Transportation, a shipping megacorporation. This looks at least a few decades out of date."; name = "\improper old Major Bill's uniform"},/obj/item/clothing/head/soft/mbill{desc = "It's a ballcap bearing the colors of Major Bill's Shipping. This one looks at least a few decades out of date."; name = "old shipping cap"},/turf/simulated/shuttle/floor,/area/submap/snowfields/qarantineshuttlesnow)
"bb" = (/obj/item/weapon/cigbutt,/mob/living/simple_animal/hostile/creature/strong,/turf/simulated/shuttle/floor{icon_state = "floor_white"},/area/submap/snowfields/qarantineshuttlesnow)
"bc" = (/obj/item/weapon/cigbutt,/turf/simulated/shuttle/floor{icon_state = "floor_white"},/area/submap/snowfields/qarantineshuttlesnow)
"bd" = (/obj/machinery/door/airlock/command{icon_state = "door_locked"; locked = 1},/turf/simulated/shuttle/floor{icon_state = "floor_white"},/area/submap/snowfields/qarantineshuttlesnow)
"be" = (/obj/item/weapon/tank/emergency/oxygen/engi,/obj/effect/decal/cleanable/dirt,/turf/simulated/shuttle/floor{icon_state = "floor_white"},/area/submap/snowfields/qarantineshuttlesnow)
"bf" = (/obj/effect/decal/remains/human,/obj/item/clothing/suit/space/emergency,/obj/item/clothing/head/helmet/space/emergency,/obj/effect/decal/cleanable/dirt,/turf/simulated/shuttle/floor{icon_state = "floor_yellow"},/area/submap/snowfields/qarantineshuttlesnow)
"bg" = (/obj/structure/grille,/obj/structure/window/reinforced,/obj/structure/window/reinforced{dir = 8},/obj/structure/window/reinforced{dir = 1; health = 1e+006},/turf/simulated/shuttle/plating,/area/submap/snowfields/qarantineshuttlesnow)
"bh" = (/obj/structure/grille,/obj/structure/window/reinforced,/obj/structure/window/reinforced{dir = 1; health = 1e+006},/turf/simulated/shuttle/plating,/area/submap/snowfields/qarantineshuttlesnow)
"bi" = (/obj/structure/grille,/obj/structure/window/reinforced,/obj/structure/window/reinforced{dir = 4},/obj/structure/window/reinforced{dir = 1; health = 1e+006},/turf/simulated/shuttle/plating,/area/submap/snowfields/qarantineshuttlesnow)
"bj" = (/obj/item/clothing/suit/space/emergency,/turf/simulated/shuttle/floor{icon_state = "floor_yellow"},/area/submap/snowfields/qarantineshuttlesnow)
"bk" = (/obj/item/trash/candy,/obj/effect/decal/cleanable/dirt,/turf/simulated/shuttle/floor{icon_state = "floor_white"},/area/submap/snowfields/qarantineshuttlesnow)
"bl" = (/obj/structure/table/rack,/obj/structure/loot_pile/maint/boxfort,/turf/simulated/shuttle/floor{icon_state = "floor_yellow"},/area/submap/snowfields/qarantineshuttlesnow)
"bm" = (/obj/structure/table/rack,/obj/item/weapon/shovel,/turf/simulated/shuttle/floor{icon_state = "floor_yellow"},/area/submap/snowfields/qarantineshuttlesnow)
"bn" = (/obj/structure/closet/crate/secure/science{icon_state = "scisecurecrateopen"; locked = 0; name = "Virus Samples - FRAGILE"; opened = 1},/obj/item/weapon/virusdish/random,/obj/item/weapon/virusdish/random,/obj/item/weapon/virusdish/random,/turf/simulated/shuttle/floor{icon_state = "floor_yellow"},/area/submap/snowfields/qarantineshuttlesnow)
"bo" = (/obj/structure/bed/chair/comfy/brown{dir = 8},/obj/effect/decal/remains/human,/obj/item/clothing/under/mbill{desc = "A uniform belonging to Major Bill's Transportation, a shipping megacorporation. This looks at least a few decades out of date."; name = "\improper old Major Bill's uniform"},/obj/item/clothing/head/soft/mbill{desc = "It's a ballcap bearing the colors of Major Bill's Shipping. This one looks at least a few decades out of date."; name = "old shipping cap"},/turf/simulated/shuttle/floor{icon_state = "floor_white"},/area/submap/snowfields/qarantineshuttlesnow)
"bp" = (/obj/structure/table/standard,/obj/item/device/taperecorder,/turf/simulated/shuttle/floor,/area/submap/snowfields/qarantineshuttlesnow)
"bq" = (/obj/item/weapon/tool/crowbar/red,/turf/simulated/shuttle/floor{icon_state = "floor_white"},/area/submap/snowfields/qarantineshuttlesnow)
"br" = (/obj/item/trash/chips,/obj/effect/decal/cleanable/dirt,/turf/simulated/shuttle/floor{icon_state = "floor_yellow"},/area/submap/snowfields/qarantineshuttlesnow)
"bs" = (/obj/structure/bed/chair,/turf/simulated/shuttle/floor{icon_state = "floor_yellow"},/area/submap/snowfields/qarantineshuttlesnow)
"bt" = (/obj/structure/bed/chair,/obj/effect/decal/cleanable/dirt,/turf/simulated/shuttle/floor{icon_state = "floor_white"},/area/submap/snowfields/qarantineshuttlesnow)
"bu" = (/obj/structure/bed/chair,/obj/effect/decal/remains/human,/obj/item/clothing/mask/breath,/obj/item/clothing/head/soft/mbill{desc = "It's a ballcap bearing the colors of Major Bill's Shipping. This one looks at least a few decades out of date."; name = "old shipping cap"},/turf/simulated/shuttle/floor{icon_state = "floor_white"},/area/submap/snowfields/qarantineshuttlesnow)
"bv" = (/obj/structure/bed/chair,/obj/effect/decal/remains/human,/turf/simulated/shuttle/floor{icon_state = "floor_white"},/area/submap/snowfields/qarantineshuttlesnow)
"bw" = (/obj/effect/decal/remains/xeno,/obj/effect/decal/cleanable/dirt,/turf/simulated/shuttle/floor{icon_state = "floor_white"},/area/submap/snowfields/qarantineshuttlesnow)
"bx" = (/obj/item/weapon/material/shard{icon_state = "medium"},/turf/simulated/shuttle/floor{icon_state = "floor_yellow"},/area/submap/snowfields/qarantineshuttlesnow)
"by" = (/obj/effect/decal/remains/mouse,/turf/simulated/shuttle/floor{icon_state = "floor_yellow"},/area/submap/snowfields/qarantineshuttlesnow)
"bz" = (/obj/random/maintenance,/turf/simulated/shuttle/floor{icon_state = "floor_yellow"},/area/submap/snowfields/qarantineshuttlesnow)
"bA" = (/obj/item/weapon/coin/silver,/turf/simulated/shuttle/floor{icon_state = "floor_white"},/area/submap/snowfields/qarantineshuttlesnow)
"bB" = (/obj/effect/decal/remains/human,/obj/item/clothing/suit/space/emergency,/obj/item/clothing/head/helmet/space/emergency,/turf/simulated/shuttle/floor{icon_state = "floor_yellow"},/area/submap/snowfields/qarantineshuttlesnow)
"bC" = (/obj/effect/decal/cleanable/generic,/turf/simulated/shuttle/floor{icon_state = "floor_yellow"},/area/submap/snowfields/qarantineshuttlesnow)
"bD" = (/obj/item/weapon/tank/emergency/oxygen/engi,/turf/simulated/shuttle/floor{icon_state = "floor_yellow"},/area/submap/snowfields/qarantineshuttlesnow)
"bE" = (/obj/item/trash/sosjerky,/obj/effect/decal/remains/human,/turf/simulated/shuttle/floor{icon_state = "floor_white"},/area/submap/snowfields/qarantineshuttlesnow)
"bF" = (/obj/effect/decal/remains/human,/obj/item/clothing/mask/breath,/mob/living/simple_animal/hostile/creature/strong,/turf/simulated/shuttle/floor{icon_state = "floor_white"},/area/submap/snowfields/qarantineshuttlesnow)
"bG" = (/obj/structure/grille,/obj/structure/window/reinforced,/obj/structure/window/reinforced{dir = 8},/obj/structure/window/reinforced{dir = 1},/turf/simulated/shuttle/plating,/area/submap/snowfields/qarantineshuttlesnow)
"bH" = (/obj/structure/grille,/obj/structure/window/reinforced,/obj/structure/window/reinforced{dir = 4},/obj/structure/window/reinforced{dir = 1},/turf/simulated/shuttle/plating,/area/submap/snowfields/qarantineshuttlesnow)
"bI" = (/obj/machinery/button{dir = 4; name = "Cargo Access"},/turf/simulated/shuttle/wall,/area/submap/snowfields/qarantineshuttlesnow)
"bJ" = (/obj/machinery/recharge_station,/turf/simulated/shuttle/floor,/area/submap/snowfields/qarantineshuttlesnow)
"bK" = (/obj/machinery/door/airlock{name = "Charge Station"},/turf/simulated/shuttle/wall,/area/submap/snowfields/qarantineshuttlesnow)
"bL" = (/obj/item/trash/tastybread,/obj/item/weapon/material/butterfly/boxcutter,/obj/effect/decal/cleanable/dirt,/turf/simulated/shuttle/floor{icon_state = "floor_white"},/area/submap/snowfields/qarantineshuttlesnow)
"bM" = (/obj/effect/decal/cleanable/vomit,/turf/simulated/shuttle/floor{icon_state = "floor_white"},/area/submap/snowfields/qarantineshuttlesnow)
"bN" = (/obj/structure/bed/chair{dir = 1},/obj/effect/decal/remains/xeno,/turf/simulated/shuttle/floor{icon_state = "floor_white"},/area/submap/snowfields/qarantineshuttlesnow)
"bO" = (/obj/structure/bed/chair{dir = 1},/obj/item/weapon/card/id/external{desc = "An identification card of some sort. Looks like this one was issued by the Vir Independent Mining Corp."; name = "VIMC identification card"; rank = "Miner"; registered_name = "Nadia Chu"},/turf/simulated/shuttle/floor{icon_state = "floor_white"},/area/submap/snowfields/qarantineshuttlesnow)
"bP" = (/obj/structure/table/rack,/obj/item/weapon/storage/toolbox/emergency,/turf/simulated/shuttle/floor{icon_state = "floor_white"},/area/submap/snowfields/qarantineshuttlesnow)
"bQ" = (/obj/structure/table/rack,/obj/item/clothing/head/soft/mbill{desc = "It's a ballcap bearing the colors of Major Bill's Shipping. This one looks at least a few decades out of date."; name = "old shipping cap"},/turf/simulated/shuttle/floor{icon_state = "floor_white"},/area/submap/snowfields/qarantineshuttlesnow)
"bR" = (/obj/structure/ore_box,/turf/simulated/shuttle/floor{icon_state = "floor_yellow"},/area/submap/snowfields/qarantineshuttlesnow)
"bS" = (/obj/item/weapon/contraband/poster,/turf/simulated/shuttle/floor{icon_state = "floor_yellow"},/area/submap/snowfields/qarantineshuttlesnow)
"bT" = (/obj/structure/loot_pile/maint/technical,/turf/simulated/shuttle/floor{icon_state = "floor_yellow"},/area/submap/snowfields/qarantineshuttlesnow)
"bU" = (/obj/structure/sign/biohazard,/turf/simulated/shuttle/wall/hard_corner,/area/submap/snowfields/qarantineshuttlesnow)
"bV" = (/obj/structure/sign/warning/secure_area,/turf/simulated/wall/snowbrick,/area/submap/snowfields/qarantineshuttlesnow)
"bW" = (/obj/item/taperoll/medical,/turf/simulated/floor/outdoors/snow/virgo6,/area/submap/snowfields/qarantineshuttlesnow)
"bX" = (/obj/structure/sign/kiddieplaque{desc = "By order of the S.D.D.C, this site or craft is to be buried and not disturbed until such time that sterility can be confirmed. Dated: 20/12/2491 "; name = "\improper Sif Department of Disease Control notice"},/turf/simulated/wall/snowbrick,/area/submap/snowfields/qarantineshuttlesnow)
"bY" = (/obj/structure/sign/warning,/turf/simulated/wall/snowbrick,/area/submap/snowfields/qarantineshuttlesnow)
"bZ" = (/obj/item/bodybag,/turf/simulated/floor/outdoors/snow/virgo6,/area/submap/snowfields/qarantineshuttlesnow)
"ca" = (/obj/structure/table/steel,/obj/item/weapon/storage/box/bodybags,/obj/item/clothing/suit/storage/snowsuit,/turf/simulated/floor/outdoors/snow/virgo6,/area/submap/snowfields/qarantineshuttlesnow)
"cb" = (/obj/structure/table/steel,/obj/item/clothing/suit/bio_suit,/obj/random/medical/lite,/turf/simulated/floor/outdoors/snow/virgo6,/area/submap/snowfields/qarantineshuttlesnow)
"cc" = (/obj/structure/closet/l3closet/virology,/turf/simulated/floor/outdoors/snow/virgo6,/area/submap/snowfields/qarantineshuttlesnow)
"cd" = (/obj/item/weapon/reagent_containers/syringe/antiviral,/turf/simulated/floor/outdoors/snow/virgo6,/area/submap/snowfields/qarantineshuttlesnow)
"ce" = (/obj/structure/dispenser/oxygen,/turf/simulated/floor/outdoors/snow/virgo6,/area/submap/snowfields/qarantineshuttlesnow)
"cf" = (/obj/structure/table/steel,/obj/item/clothing/suit/storage/snowsuit,/turf/simulated/floor/outdoors/snow/virgo6,/area/submap/snowfields/qarantineshuttlesnow)
"cg" = (/obj/structure/table/steel,/obj/item/weapon/reagent_containers/syringe/antiviral,/turf/simulated/floor/outdoors/snow/virgo6,/area/submap/snowfields/qarantineshuttlesnow)
"ch" = (/obj/structure/table/steel,/obj/item/weapon/reagent_containers/spray/cleaner{desc = "Someone has crossed out the 'Space' from Space Cleaner and written in Chemistry. Scrawled on the back is, 'Okay, whoever filled this with polytrinic acid, it was only funny the first time. It was hard enough replacing the CMO's first cat!'"; name = "Chemistry Cleaner"},/turf/simulated/floor/outdoors/snow/virgo6,/area/submap/snowfields/qarantineshuttlesnow)
"ci" = (/obj/structure/table/steel,/obj/item/weapon/tool/crowbar/power,/turf/simulated/floor/outdoors/snow/virgo6,/area/submap/snowfields/qarantineshuttlesnow)
"cj" = (/obj/structure/table/rack,/obj/item/clothing/head/bio_hood,/obj/item/clothing/suit/bio_suit,/turf/simulated/floor/outdoors/snow/virgo6,/area/submap/snowfields/qarantineshuttlesnow)
"ck" = (/obj/item/weapon/weldingtool/largetank,/turf/simulated/floor/outdoors/snow/virgo6,/area/submap/snowfields/qarantineshuttlesnow)
"cl" = (/obj/structure/closet/crate/medical,/turf/simulated/floor/outdoors/snow/virgo6,/area/submap/snowfields/qarantineshuttlesnow)

(1,1,1) = {"
aaaaaaaaaaaaaaaaaaaaaaaaaaaaaaaaaaaaaaaaaaaaaaaaaa
aaaaaaaaaaaaaaaaaaaaaaaaaaaaaaaaaaaaaaaaaaaaaaaaaa
aaaaaaaaaaaaaaaaaaaaaaaaaaaaaaaaaaaaaaaaaaaaaaaaaa
aaaaaaaaaaaaaaaaaaaaaaaaaaaaaaaaaaaaaaaaaaaaaaaaaa
aaaaaaaaaaaaaaaaaaaaaaaaaaaaaaaaaaaaaaaaaaaaababaa
aaaaaaaaaaaaaaaaaaaaaaaaaaaaabacababaaaaadadadacaa
aaabababababaeafaeaeabaaaaabababababababadagahabaa
aaacababadaiajakakalaiadaiadadadadadadadadadadaaaa
aaababadadamanaoapadaqaqaradasatadauavauadagahaaaa
aaaaadadadadadawaxayazaAaBaCaDaEadaFaGaHadaIadabaa
aaaaaiaJaKaLadaMaNaOaPaQaQaRaSaTaUaVaWaXaYaAaZabaa
aaabaibabbbcbdbebfadbgbhbiadbjbkadblaAbmaAbnaZabaa
aaabaiaJbobpadbqbrbsbtbubvbsaNbwaUbxaAbyaVbzaZabaa
aaabadadadadadaDbAaAbBaAbCbDbEbFadbGaGbHadadbIabaa
aaababadadbJbKbLbMadbNaQbOadbPbQadbRbSbTadagahabaa
aaabacabadaiajakakbUaiadaiadadadadadadadadadadaaaa
aaabababababaeaeafaeababababbWabababababadagahaaaa
aaabababababababababababababababababababadadadaaaa
aaaaabababababababababbVbXbYbZbZbZabcacbccabcdaaaa
aaaaacababcecfcgchcicjababckabbZbZababababababaaaa
aaaaaaababclcfababababababababaaaaaaaaaaababacaaaa
aaaaaaaaaaaaaaaaaaaaaaaaaaaaaaaaaaaaaaaaaaaaaaaaaa
aaaaaaaaaaaaaaaaaaaaaaaaaaaaaaaaaaaaaaaaaaaaaaaaaa
aaaaaaaaaaaaaaaaaaaaaaaaaaaaaaaaaaaaaaaaaaaaaaaaaa
aaaaaaaaaaaaaaaaaaaaaaaaaaaaaaaaaaaaaaaaaaaaaaaaaa
"}
