"a" = (/turf/template_noop,/area/template_noop)
"b" = (/turf/simulated/floor/outdoors/snow/virgo6,/area/space)
"c" = (/turf/simulated/floor/tiled/monotile,/area/space)
"d" = (/obj/structure/flora/tree/dead,/turf/simulated/floor/outdoors/snow/virgo6,/area/space)
"e" = (/obj/structure/flora/tree/pine,/turf/simulated/floor/outdoors/snow/virgo6,/area/space)
"f" = (/obj/structure/flora/bush,/turf/simulated/floor/outdoors/snow/virgo6,/area/space)
"g" = (/turf/simulated/wall/r_wall,/area/space)
"h" = (/obj/machinery/recharge_station,/turf/simulated/floor/tiled/monotile,/area/space)
"i" = (/obj/machinery/door/airlock/vault/bolted{req_access = list(53)},/turf/simulated/floor/tiled/monotile,/area/space)
"j" = (/mob/living/simple_animal/hostile/viscerator,/turf/simulated/floor/outdoors/snow/virgo6,/area/space)
"k" = (/obj/structure/window/reinforced/full,/obj/structure/window/reinforced{dir = 4},/obj/structure/window/reinforced{dir = 8; health = 1e+006},/turf/simulated/floor/tiled/monotile,/area/space)
"l" = (/obj/structure/table/steel,/turf/simulated/floor/tiled/monotile,/area/space)
"m" = (/obj/machinery/recharger/wallcharger,/turf/simulated/wall/r_wall,/area/space)
"n" = (/obj/structure/flora/tree/dead{step_x = 20; step_y = 8},/turf/simulated/floor/outdoors/snow/virgo6,/area/space)
"o" = (/obj/machinery/mech_recharger,/mob/living/simple_animal/hostile/mecha,/turf/simulated/floor/tiled/monotile,/area/space)
"p" = (/obj/machinery/mech_recharger,/turf/simulated/floor/tiled/monotile,/area/space)
"q" = (/obj/structure/table/steel,/obj/machinery/recharger,/turf/simulated/floor/tiled/monotile,/area/space)
"r" = (/obj/structure/bed/chair/office/dark{dir = 8},/mob/living/simple_animal/hostile/syndicate/ranged/laser/poi,/turf/simulated/floor/tiled/monotile,/area/space)
"s" = (/obj/machinery/light/small{dir = 1},/turf/simulated/floor/tiled/monotile,/area/space)
"t" = (/obj/machinery/shower,/turf/simulated/floor/tiled/monotile,/area/space)
"u" = (/obj/machinery/sleeper{dir = 8},/turf/simulated/floor/tiled/monotile,/area/space)
"v" = (/obj/machinery/sleep_console,/turf/simulated/floor/tiled/monotile,/area/space)
"w" = (/obj/machinery/light/small{brightness_color = "#DA0205"; brightness_power = 1; brightness_range = 5},/turf/simulated/floor/tiled/monotile,/area/space)
"x" = (/obj/machinery/light{dir = 1},/turf/simulated/floor/tiled/monotile,/area/space)
"y" = (/obj/item/frame/extinguisher_cabinet,/turf/simulated/wall/r_wall,/area/space)

(1,1,1) = {"
aaaaaaaaaaaaaaaaaaaaaaaaaaaaaaaaaaaaaaaa
aaaaaabbbaaaaaaaaaaaaaaaaaaaaaaaaaaaaaaa
aaabbbbbdbbbbbbbaaaaaaabbbeaaaaabbbbaaaa
aabbbbbbbbbbbbbbbbbbbbbbbbbbbbfbbbbbbaaa
abbbgggggggggggggggggggggggggggggggbbaaa
afbbgcccccccccgcstgccccccccghcopchgbbaaa
abbbgcccccccccmcccgcuvcccccgccccccgbbaaa
abbbgcccccccccmcccgccccccccgccccccgbbbaa
abbbgcccccccccgcwcgccccccccgccccccgbbbaa
abbbggggccgggggcgggccccccccgccccccgbbbaa
abbbgcccccccccccccxccccccccgygccgggbbaaa
abbbgcccccccccccccccccccccccccccccgbbaaa
aabbgcccccccccccccccccccccccccccccgbdaaa
aadbgcccccccccccccccccccccccccccccgbbaaa
aabbgcccccccccccccccccccccccccccccgbbaaa
aabbgcccccccccccccccccccccccccccccgbaaaa
aafbgggggggggggggggcccccccccccccccgbaaaa
aaabgcccccccccccccgcccccccccccccccgbaaaa
aaabgcccccccccccccgcccccccccccccccgbbaaa
aaabgcccccccccccccgiiggggggcccccccgbfaaa
baabgcccccccccccccgccgccccgcccccccgbjaaa
bbabgcccccccccccccgccgccccccccccccgbbbaa
bbbbgggggggggggggggiigggggggggcggggbbbaa
bebbbbbbbbbbbbbbbbbbbbbbbbgcccccccgbbaaa
bbbbbbbbbbbbbbbbbbbbbbbfbbgcccccccgbbaaa
bbbbbbbbbjbbbbbbbbbbbbbbbbklqcccccgbbaaa
bbbbbbdbbbbbbbbbbbbbbbbjbbklrcccccgbbbaa
bbjbbbbbbbbbbbbbbbbbbbbbbbklrcccccgbbbba
bbbbbbbbbbbbbbbbbbbbbbbbebklqcccccgbbbba
bbbbbbbbbbbbbbbbbbbbbbbbbbgcccccccgnbbba
bbbbbbbbbbbbbbfbbbbbjbbbbbgcccccccgbbbba
bbbbbbbbbbbbbbbbbbbbbbbbbbgggggggggbbbba
bbbbbbbbbbbbbbbbbbbbbbbbbbbjbbbbbbbbbbba
bbbbbbbbbbbbbbbbbbbbbbbbbbbbbbbbbbbbbbaa
abbbbbbbebbbbbbbbbbdbbbbbbbbbbbbbbbbbaaa
abbbbjbbbbbbbbbbbbbbbbbbbbbbbbbbbbbbaaaa
aabbbbbbbbbbbbbbbbbbbbbbbbbbbfbbbbaaaaaa
aaabbbbbbbbbaaaaaaaaaaabbbbbbbbbbaaaaaaa
aaaabbbbbaaaaaaaaaaaaaaaaaaabbbaaaaaaaaa
aaaaaaaaaaaaaaaaaaaaaaaaaaaaaaaaaaaaaaaa
"}
