"a" = (/obj/effect/overmap/visitable/sector/mining_planet,/turf/unsimulated/mineral/triumph,/area/triumph_away/mining_planet/unexplored)
"e" = (/turf/simulated/mineral/triumph/rich,/area/triumph_away/mining_planet/explored)
"f" = (/obj/away_mission_init/mining_planet,/turf/unsimulated/mineral/triumph,/area/triumph_away/mining_planet/unexplored)
"j" = (/obj/effect/shuttle_landmark/automatic,/turf/simulated/mineral/floor,/area/triumph_away/mining_planet/explored)
"r" = (/turf/simulated/mineral/floor,/area/triumph_away/mining_planet/explored)
"w" = (/turf/simulated/mineral/triumph/rich,/area/triumph_away/mining_planet/unexplored)
"A" = (/turf/simulated/mineral/triumph,/area/triumph_away/mining_planet/unexplored)
"N" = (/turf/simulated/mineral/floor,/area/triumph_away/mining_planet/unexplored)
"O" = (/turf/unsimulated/mineral/triumph,/area/triumph_away/mining_planet/unexplored)

(1,1,1) = {"
OOOOOOOOOOOOOOOOOOOOOOOOOOOOOOOOOOOOOOOOOOOOOOOOOOOOOOOOOOOOOOOOOOOOOOOOOOOOOOOOOOOOOOOOOOOOOOOOOOOOOOOOOOOOOOOOOOOOOOOOOOOOOOOOOOOOOOOOOOOO
OOOOOOOOOOOOOOOOOOOOOOOOOOOOOOOOOOOOOOOOOOOOOOOOOOOOOOOOOOOOOOOOOOOOOOOOOOOOOOOOOOOOOOOOOOOOOOOOOOOOOOOOOOOOOOOOOOOOOOOOOOOOOOOOOOOOOOOOOOOO
OOwwwwwwwwwwwwwwwwwwwwwwwwwwwwwwwwwwwwwwwwwwwwwwwwwwwwwwwwwwwwwwwwwwwwwwwwwwwwwwwwwwwwwwwwwwwwwwwwwwwwwwwwwwwwwwwwwwwwwwwwwwwwwwwwwwwwwwwwOO
OOwwwwwwwwwwwwwwwwwwwwwwwwwwwwwwwwwwwwwwwwwwwwwwwwwwwwwwwwwwwwwwwwwwwwwwwwwwwwwwwwwwwwwwwwwwwwwwwwwwwwwwwwwwwwwwwwwwwwwwwwwwwwwwwwwwwwwwwwOO
OOwwwwwwwwwwwwwwwwwwwwwwwwwwwwwwwwwwwwwwwwwwwwwwwwwwwwwwwwwwwwwwwwwwwwwwwwwwwwwwwwwwwwwwwwwwwwwwwwwwwwwwwwwwwwwwwwwwwwwwwwwwwwwwwwwwwwwwwwOO
OOwwwwwwwwwwwwwwwwwwwwwwwwwwwwwwwwwwwwwwwwwwwwwwwwwwwwwwwwwwwwwwwwwwwwwwwwwwwwwwwwwwwwwwwwwwwwwwwwwwwwwwwwwwwwwwwwwwwwwwwwwwwwwwwwwwwwwwwwOO
OOwwwwwwwwwwwwwwwwwwwwwwwwwwwwwwwwwwwwwwwwwwwwwwwwwwwwwwwwwwwwwwwwwwwwwwwwwwwwwwwwwwwwwwwwwwwwwwwwwwwwwwwwwwwwwwwwwwwwwwwwwwwwwwwwwwwwwwwwOO
OOwwwwwwwwwwwwwwwwwwwwwwwwwwwwwwwwwwwwwwwwwwwwwwwwwwwwwwwwwwwwwwwwwwwwwwwwwwwwwwwwwwwwwwwwwwwwwwwwwwwwwwwwwwwwwwwwwwwwwwwwwwwwwwwwwwwwwwwwOO
OOwwwwwwwwwwwwwwwwwwwwwwwwwwwwwwwwwwwwwwwwwwwwwwwwwwwwwwwwwwwwwwwwwAAAAAAAAAAAAAAAAAAAAAAAAAAAAAAAAwwwwwwwwwwwwwwwwwwwwwwwwwwwwwwwwwwwwwwwOO
OOwwwwwwwwwwwwwwwwwwwwwwwwwNNNwwwwwwNNwwwwwwwwwwwwwwwwwwwwwwwwwwwwwAAAAAAAAAAAAAAAAAAAAAAAAAAAAAAAAwwwwwwwwwwwwwwwwwwwwwwwwwwwwwwwwwwwwwwwOO
OOwwwwwwwwwwweeeeeeeeerrrrrrrrNNwwwNNNNNwwwwwwwwwwwwwwwwwwwwwwwwwwwAAAAAAAAAAAAAAAAAAAAAAAAAAAAAAAAwwwwwwwwwwwwwwwwwwwwwwwwwwwwwwwwwwwwwwwOO
OOwwwwwwwwwwwrrrreerrrrrrrrrrrNNwNNNNNNNwwwwwwwwwwwwwwwwwwwwwwwwwwwAAAAAAAAAAAAAAAAAAAAAAAAAAAAAAAAwwwwwwwwwwwwwwwwwwwwwwwwwwwwwwwwwwwwwwwOO
OOwwwwwwwwwwwrrrrrrrrrrrrrrrrrrrrrrrrrrrrrrwwwwwwwwwwwwwwwwwwwwwwwwAAAAAAAAAAAAAAAAAAAAAAAAAAAAAAAAwwwwwwwwwwwwwwwwwwwwwwwwwwwwwwwwwwwwwwwOO
OOwwwwwwwwwwwrrrrrrrrrrrrrrrrrrrrrrrrrrrrrrNwwwwwwwwwwwwwwwwwwwwwwwAAAAAAAAAAAAAAAAAAAAAAAAAAAAAAAAwwwwwwwwwwwwwwwwwwwwwwwwwwwwwwwwwwwwwwwOO
OOwwwwwwwwwNNrrrrrrrrrrrrrrrrrrrrrrrrrrrrrrNNwwwwwwwwwwwwwwwwwwwwwwAAAAAAAAAAAAAAAAAAAAAAAAAAAAAAAAwwwwwwwwwwwwwwwwwwwwwwwwwwwwwwwwwwwwwwwOO
OOwwwwwwwwwNNrrrrrrrrrrrrrrrrjrrrrrrrrrrrrrNNwwwwwwwwwwwwwwwwwwwwwwAAAAAAAAAAAAAAAAAAAAAAAAAAAAAAAAwwwwwwwwwwwwwwwwwwwwwwwwwwwwwwwwwwwwwwwOO
OOwwwwwwwwwNNrrrrrrrrrrrrrrrrrrrrrrrrrrrrrrNNNwwwwwwwwwwwwwwwwwwwwwAAAAAAAAAAAAAAAAAAAAAAAAAAAAAAAAwwwwwwwwwwwwwwwwwwwwwwwwwwwwwwwwwwwwwwwOO
OOwwwwwwwwwNNrrrrrrrrrrrrrrrrrrrrrrrrrrrrrrNNNwwwwwwwwwwwwwwwwwwwwwAAAAAAAAAAAAAAAAAAAAAAAAAAAAAAAAAAAAAAAAAAAAAAAAAAAAAAAAAAAAAAAAAAAAAAwOO
OOwwwwwwwwwwwrrrrrrrrrrrrrrrrrrrrrrrrrrrrrrNNNwwwwwwwwwwwwwwwwwwwwwAAAAAAAAAAAAAAAAAAAAAAAAAAAAAAAAAAAAAAAAAAAAAAAAAAAAAAAAAAAAAAAAAAAAAAwOO
OOwwwwwwwwwwwrrrerrrrrrrrrrrrrrrrrrrrrrrrrrNNNwwwwwwwwwwwwwwwwwwwwwAAAAAAAAAAAAAAAAAAAAAAAAAAAAAAAAAAAAAAAAAAAAAAAAAAAAAAAAAAAAAAAAAAAAAAwOO
OOwwwwwwwwwwweeerrrrrrrrrrrrrrrrrrrrrrrrrrrNNwwwwwwwwwwwwwwwwwwwwwwAAAAAAAAAAAAAAAAAAAAAAAAAAAAAAAAAAAAAAAAAAAAAAAAAAAAAAAAAAAAAAAAAAAAAAwOO
OOwwwwwwwwwwwwwerrrrrrrrrrrrrrrrrrrrrrrrrrrNwwwwwwwwwwwwwwwwwwwwwwwwwwwwwwwwwwwwwwwwwwwwwwwwAAAAAAAAAAAAAAAAAAAAAAAAAAAAAAAAAAAAAAAAAAAAAwOO
OOwwwwwwwwwwwwweeerrrrrrrrrrrrrrrrrrrrrrrrrNwwwwwwwwwwwwwwwwwwwwwwAAAAAAAAAAAAAAAAAAAAAAAAAAAAAAAAAAAAAAAAAAAAAAAAAAAAAAAAAAAAAAAAAAAAAAAwOO
OOwwwwwwwwwwwwweeerrrrrrrrrrrrrrrrrrrrrrrrrNwwwwwwwwwwwwwwwwwwwwwwAAAAAAAAAAAAAAAAAAAAAAAAAAAAAAAAAAAAAAAAAAAAAAAAAAAAAAAAAAAAAAAAAAAAAAAwOO
OOwwwwwwwwwwwwwerrrrrrrrrrrrrrrrrrrrrrrrrrrNwwwwwwwwwwwwwwwwwwwwwwAAAAAAAAAAAAAAAAAAAAAAAAAAAAAAAAAAAAAAAAAAAAAAAAAAAAAAAAAAAAAAAAAAAAAAAwOO
OOwwwwwwwwwwwwweerrrrrrrrrrrrrrrrrrrrrrrrrrNwwwwwwwwwwwwwwwwwwwwwwAAAAAAAAAAAAAAAAAAAAAAAAAAAAAAAAAAAAAAAAAAAAAAAAAAAAAAAAAAAAAAAAAAAAAAAwOO
OOwwwwwwwwwwwwweeerrrrrrrrrrrrrrrrrrrrrrrrrNNwwwwwwwwwwwwwwwwwwwwwAAAAAAAAAAAAAAAAAAAAAAAAAAAAAAAAAAAAAAAAAAAAAAAAAAAAAAAAAAAAAAAAAAAAAAAwOO
OOwwwwwwwwwwwwwwwwrrrrrrrrrrrrrrrrrrrrrrrrrNNwwwwwwwwwwwwwwwwwwwwwAAAAAAAAAAAAAAAAAAAAAAAAAAAAAAAAAAAAAAAAAAAAAAAAAAAAAAAAAAAAAAAAAAAAAAAwOO
OOwwwwwwwwwwwwwwwwrrrrrrrrrrrrrrrrrrrrrrrrrNNwwwwwwwwwwwwwwwwwwwwwAAAAAAAAAAAAAAAAAAAAAAAAAAAAAAAAAAAAAAAAAAAAAAAAAAAAAAAAAAAAAAAAAAAAAAAwOO
OOwwwwwwwwwwwwwwwwwwNNNNNNwwwwwwwwwNwwNNNNNNNwwwwwwwwwwwwwwwwwwwwwAAAAAAAAAAAAAAAAAAAAAAAAAAAAAAAAAAAAAAAAAAAAAAAAAAAAAAAAAAAAAAAAAAAAAAAwOO
OOwwwwwwwwwwwwwwwwwwNNNNNNNwwwwwwwwNwwwwNNNNwwwwwAAAAAAAAAAwwwwwwwAAAAAAAAAAAAAAAAAAAAAAAAAAAAAAAAAAAAAAAAAAAAAAAAAAAAAAAAAAAAAAAAAAAAAAAwOO
OOwwAAAAAAAAAAAwwwwwwwwNNNNwwwwwwwwNNNwwwNNNwwwwwAAAAAAAAAAwwwwwwwAAAAAAAAAAAAAAAAAAAAAAAAAAAAAAAAAAAAAAAAAAAAAAAAAAAAAAAAAAAAAAAAAAAAAAAwOO
OOwwAAAAAAAAAAAwwwwwwwwwwwwwwwwwwwwNNNwwwwwwwwwwwAAAAAAAAAAwwwwwwwAAAAAAAAAAAAAAAAAAAAAAAAAAAAAAAAAAAAAAAAAAAAAAAAAAAAAAAAAAAAAAAAAAAAAAAwOO
OOwwAAAAAAAAAAAwwwwwwwwwwwwwwwwwwwwNNNwwwwwwwwwwwAAAAAAAAAAwwwwwwwAAAAAAAAAAAAAAAAAAAAAAAAAAAAAAAAAAAAAAAAAAAAAAAAAAAAAAAAAAAAAAAAAAAAAAAwOO
OOwwAAAAAAAAAAAwwwwwwwwwwwwwwwwwwwwNNNwwwwwwwwwwwAAAAAAAAAAwwwwwwwAAAAAAAAAAAAAAAAAAAAAAAAAAAAAAAAAAAAAAAAAAAAAAAAAAAAAAAAAAAAAAAAAAAAAAAwOO
OOwwAAAAAAAAAAAwwwwwwwwwwwwwwwwwwwwNNNwwwwwwwwwwwAAAAAAAAAAwwwwwwwAAAAAAAAAAAAAAAAAAAAAAAAAAAAAAAAAAAAAAAAAAAAAAAAAAAAAAAAAAAAAAAAAAAAAAAwOO
OOwwAAAAAAAAAAAwwwwwwwwwwwwwwwwwwwwwNwwwwwwwwwwwwAAAAAAAAAAwwwwwwwAAAAAAAAAAAAAAAAAAAAAAAAAAAAAAAAAAAAAAAAAAAAAAAAAAAAAAAAAAAAAAAAAAAAAAAwOO
OOwwAAAAAAAAAAAwwwwwwwwwwwwwwwwwwwwwNwwwwwwwwwwwwAAAAAAAAAAwwwwwwwAAAAAAAAAAAAAAAAAAAAAAAAAAAAAAAAAAAAAAAAAAAAAAAAAAAAAAAAAAAAAAAAAAAAAAAwOO
OOwwAAAAAAAAAAAwwwwwwwwwwwwwwwwwwwwwNNwwwwwwwwwwwAAAAAAAAAAwwwwwwwAAAAAAAAAAAAAAAAAAAAAAAAAAAAAAAAAAAAAAAAAAAAAAAAAAAAAAAAAAAAAAAAAAAAAAAwOO
OOwwAAAAAAAAAAAwwwwwwwwwwwwwwwwwwwwwNNwwwwwwwwwwwAAAAAAAAAAwwwwwwwAAAAAAAAAAAAAAAAAAAAAAAAAAAAAAAAAAAAAAAAAAAAAAAAAAAAAAAAAAAAAAAAAAAAAAAwOO
OOwwAAAAAAAAAAAwwwwwwwwwwwwwwwwwwwwwwNNwwwwwwwwwwAAAAAAAAAAwwwwwwwAAAAAAAAAAAAAAAAAAAAAAAAAAAAAAAAAAAAAAAAAAAAAAAAAAAAAAAAAAAAAAAAAAAAAAAwOO
OOwwAAAAAAAAAAAwwwwwwwwwwwwwwwwwwwwwwwNNwwwwwwwwwAAAAAAAAAAwwwwwwwAAAAAAAAAAAAAAAAAAAAAAAAAAAAAAAAAAAAAAAAAAAAAAAAAAAAAAAAAAAAAAAAAAAAAAAwOO
OOwwAAAAAAAAAAAwwwwwwwwwwwwwwwwwwwwwwwNNwwwwwwwwwAAAAAAAAAAwwwwwwwAAAAAAAAAAAAAAAAAAAAAAAAAAAAAAAAAAAAAAAAAAAAAAAAAAAAAAAAAAAAAAAAAAAAAAAwOO
OOwwAAAAAAAAAAAwwwwwwwwwwwwwwwwwwwwwwwwNNwwwwwwwwAAAAAAAAAAwwwwwwwAAAAAAAAAAAAAAAAAAAAAAAAAAAAAAAAAAAAAAAAAAAAAAAAAAAAAAAAAAAAAAAAAAAAAAAwOO
OOwwAAAAAAAAAAAwwwwwwwwwwwwwwwwwwwwwwwwwNNwwwwwwwAAAAAAAAAAwwwwwwwAAAAAAAAAAAAAAAAAAAAAAAAAAAAAAAAAAAAAAAAAAAAAAAAAAAAAAAAAAAAAAAAAAAAAAAwOO
OOwwAAAAAAAAAAAwwwwwwwwwwwwwwwwwwwwwwwwwwwNNNwwwwwwwwwwwwwwwwwwwwwAAAAAAAAAAAAAAAAAAAAAAAAAAAAAAAAAAAAAAAAAAAAAAAAAAAAAAAAAAAAAAAAAAAAAAAwOO
OOwwAAAAAAAAAAAwwwwwwwwwwwwwwwwwwwwwwwwwwwNNNNwwwwwwwwwwwwwwwwwwwwAAAAAAAAAAAAAAAAAAAAAAAAAAAAAAAAAAAAAAAAAAAAAAAAAAAAAAAAAAAAAAAAAAAAAAAwOO
OOwwAAAAAAAAAAAwwwwwwwwwwwwwwwwwwwwwwwwwwwNNNNwwwwwwwwwwwwwwwwwwwwAAAAAAAAAAAAAAAAAAAAAAAAAAAAAAAAAAAAAAAAAAAAAAAAAAAAAAAAAAAAAAAAAAAAAAAwOO
OOwwAAAAAAAAAAAwwwwwwwwwwwwwwwwwwwwwwwwwwwwwNNNwwwwwwwwwwwwwwwwwwwAAAAAAAAAAAAAAAAAAAAAAAAAAAAAAAAAAAAAAAAAAAAAAAAAAAAAAAAAAAAAAAAAAAAAAAwOO
OOwwAAAAAAAAAAAwwwwwwwwwwwwwwwwwwwwwwwwwwwwwNNNNNwwwwwwwwwwwwwwwwwAAAAAAAAAAAAAAAAAAAAAAAAAAAAAAAAAAAAAAAAAAAAAAAAAAAAAAAAAAAAAAAAAAAAAAAwOO
OOwwAAAAAAAAAAAwwwwwwwwwwwwwwwwwwwwwwwwwwwwwwNNNNwwwwwwwwwwwwwwwwwAAAAAAAAAAAAAAAAAAAAAAAAAAAAAAAAAAAAAAAAAAAAAAAAAAAAAAAAAAAAAAAAAAAAAAAwOO
OOwwAAAAAAAAAAAwwwwwwwwwwwwwwwwwwwwwwwwwwwwwwNNwNNNNNwwwwwwwwwwwwwAAAAAAAAAAAAAAAAAAAAAAAAAAAAAAAAAAAAAAAAAAAAAAAAAAAAAAAAAAAAAAAAAAAAAAAwOO
OOwwAAAAAAAAAAAwwwwwwwwwwwwwwwwwwwwwwwwwwwwwwwwwNNNNNNNwwwwwwwwwwwAAAAAAAAAAAAAAAAAAAAAAAAAAAAAAAAAAAAAAAAAAAAAAAAAAAAAAAAAAAAAAAAAAAAAAAwOO
OOwwAAAAAAAAAAAwwwwwwwwwwwwwwwwwwwwwwwwwwwwwwwwwwwwwNNNNwwwwwwwwwwAAAAAAAAAAAAAAAAAAAAAAAAAAAAAAAAAAAAAAAAAAAAAAAAAAAAAAAAAAAAAAAAAAAAAAAwOO
OOwwAAAAAAAAAAAwwwwwwwwwwwwwwwwwwwwwwwwwwwwwwwwwwwwwNNNNwwwwwwwwwwAAAAAAAAAAAAAAAAAAAAAAAAAAAAAAAAAAAAAAAAAAAAAAAAAAAAAAAAAAAAAAAAAAAAAAAwOO
OOwwAAAAAAAAAAAwwwwwwwwwwwwwwwwwwwwwwwwwwwwwwwwwwwwwNNNNNwwwwwwwwwAAAAAAAAAAAAAAAAAAAAAAAAAAAAAAAAAAAAAAAAAAAAAAAAAAAAAAAAAAAAAAAAAAAAAAAwOO
OOwwAAAAAAAAAAAwwwwwwwwwwwwwwwwwwwwwwwwwwwwwwwwwwwwwwwwNNwwwwwwwwwAAAAAAAAAAAAAAAAAAAAAAAAAAAAAAAAAAAAAAAAAAAAAAAAAAAAAAAAAAAAAAAAAAAAAAAwOO
OOwwAAAAAAAAAAAwwwwwwwwwwwwwwwwwwwwwwwwwwwwwwwwwwwwwwwwNNNwwwwwwwwAAAAAAAAAAAAAAAAAAAAAAAAAAAAAAAAAAAAAAAAAAAAAAAAAAAAAAAAAAAAAAAAAAAAAAAwOO
OOwwAAAAAAAAAAAwwwwwwwwwwwwwwwwwwwwwwwwwwwwwwwwwwwwwwwwwNNNNwwwwwwwwwwAAAAAAAAAAAAAAAAAAAAAAAAAAAAAAAAAAAAAAAAAAAAAAAAAAAAAAAAAAAAAAAAAAAwOO
OOwwAAAAAAAAAAAwwwwwwwwwwwwwwwwwwwwwwwwwwwwwwwwwwwwwwwwwNNNNwwwwwwwwwwAAAAAAAAAAAAAAAAAAAAAAAAAAAAAAAAAAAAAAAAAAAAAAAAAAAAAAAAAAAAAAAAAAAwOO
OOwwAAAAAAAAAAAwwwwwwwwwwwwwwwwwwwwwwwwwwwwwwwwwwwwwwwwwwwNNwwwwwwwwwwAAAAAAAAAAAAAAAAAAAAAAAAAAAAAAAAAAAAAAAAAAAAAAAAAAAAAAAAAAAAAAAAAAAwOO
OOwwAAAAAAAAAAAwwwwwwwwwwwwwwwwwwwwwwwwwwwwwwwwwwwwwwwwwwwwNNNwwwwwwwwAAAAAAAAAAAAAAAAAAAAAAAAAAAAAAAAAAAAAAAAAAAAAAAAAAAAAAAAAAAAAAAAAAAwOO
OOwwAAAAAAAAAAAwwwwwwwwwwwwwwwwwwwwwwwwwwwwwwwwwwwwwwwwwwwwNNNwwwwwwwwAAAAAAAAAAAAAAAAAAAAAAAAAAAAAAAAAAAAAAAAAAAAAAAAAAAAAAAAAAAAAAAAAAAwOO
OOwwAAAAAAAAAAAwwwwwwwwwwwwwwwwwwwwwwwwwwwwwwwwwwwwwwwwwwwwNNNNwwwwwwwAAAAAAAAAAAAAAAAAAAAAAAAAAAAAAAAAAAAAAAAAAAAAAAAAAAAAAAAAAAAAAAAAAAwOO
OOwwAAAAAAAAAAAwwwwwwwwwwwwwwwwwwwwwwwwwwwwwwwwwwwwwwwwwwwwwwNNNwwwwwwAAAAAAAAAAAAAAAAAAAAAAAAAAAAAAAAAAAAAAAAAAAAAAAAAAAAAAAAAAAAAAAAAAAwOO
OOwwAAAAAAAAAAAwwwwwwwwwwwwwwwwwwwwwwwwwwwwwwwwwwwwwwwwwwwwwwwNNwwwwwwAAAAAAAAAAAAAAAAAAAAAAAAAAAAAAAAAAAAAAAAAAAAAAAAAAAAAAAAAAAAAAAAAAAwOO
OOwwAAAAAAAAAAAwwwwwwwwwwwwwwwwwwwwwwwwwwwwwwwwwwwwwwwwwwwwwwwNNNwwwwwwwwwwwwwwAAAAAAAAAAAAAAAAAAAAAAAAAAAAAAAAAAAAAAAAAAAAAAAAAAAAAAAAAAwOO
OOwwAAAAAAAAAAAwwwwwwwwwwwwwwwwwwwwwwwwwwwwwwwwwwwwwwwwwwwwwwwwNNwwwwwwwwwwwwwwAAAAAAAAAAAAAAAAAAAAAAAAAAAAAAAAAAAAAAAAAAAAAAAAAAAAAAAAAAwOO
OOwwAAAAAAAAAAAwwwwwwwwwwwwwwwwwwwwwwwwwwwwwwwwwwwwwwwwwwwwwwwwNNwwwwwwwwwwwwwwAAAAAAAAAAAAAAAAAAAAAAAAAAAAAAAAAAAAAAAAAAAAAAAAAAAAAAAAAAwOO
OOwwAAAAAAAAAAAwwwwwwwwwwwwwwwwwwwwwwwwwwwwwwwwwwwwwwwwwwwwwwwwNNNwwwwwwwwwwwwwAAAAAAAAAAAAAAAAAAAAAAAAAAAAAAAAAAAAAAAAAAAAAAAAAAAAAAAAAAwOO
OOwwAAAAAAAAAAAwwwwwwwwwwwwwwwwwwwwwwwwwwwwwwwwwwwwwwwwwwwwwwwwwNNNwwwwwwwwwwwwAAAAAAAAAAAAAAAAAAAAAAAAAAAAAAAAAAAAAAAAAAAAAAAAAAAAAAAAAAwOO
OOwwAAAAAAAAAAAwwwwwwwwwwwwwwwwwwwwwwwwwwwwwwwwwwwwwwwwwwwwwwwwwNNNwwwwwwwwwwwwAAAAAAAAAAAAAAAAAAwwwwwwwwwwwwwwwwwwwwwwwwwwwwwwwwwwwwwwwwwOO
OOwwAAAAAAAAAAAwwwwwwwwwwwwwwwwwwwwwwwwwwwwwwwwwwwwwwwwwwwwwwwwwwNNwwwwwwwwwwwwAAAAAAAAAAAAAAAAAAwwwwwwwwwwwwwwwwwwwwwwwwwwwwwwwwwwwwwwwwwOO
OOwwAAAAAAAAAAAwwwwwwwwwwwwwwwwwwwwwwwwwwwwwwwwwwwwwwwwwwwwwwwwwwwNNNwwwwwwwwwwAAAAAAAAAAAAAAAAAAwwwwwwwwwwwwwwwwwwwwwwwwwwwwwwwwwwwwwwwwwOO
OOwwAAAAAAAAAAAwwwwwwwwwwwwwwwwwwwwwwwwwwwwwwwwwwwwwwwwwwwwwwwwwwwNNNwwwwwwwwwwAAAAAAAAAAAAAAAAAAwwwwwwwwwwwwwwwwwwwwwwwwwwwwwwwwwwwwwwwwwOO
OOwwAAAAAAAAAAAwwwwwwwwwwwwwwwwwwwwwwwwwwwwwwwwwwwwwwwwwwwwwwwwwwwNNNwwwwwwwwwwAAAAAAAAAAAAAAAAAAwwwwwwwwwwwwwwwwwwwwwwwwwwwwwwwwwwwwwwwwwOO
OOwwAAAAAAAAAAAwwwwwwwwwwwwwwwwwwwwwwwwwwwwwwwwwwwwwwwwwwwwwwwwwwwwwNNNwwwwwwwwAAAAAAAAAAAAAAAAAAwwwwwwwwwwwwwwwwwwwwwwwwwwwwwwwwwwwwwwwwwOO
OOwwAAAAAAAAAAAwwwwwwwwwwwwwwwwwwwwwwwwwwwwwwwwwwwwwwwwwwwwwwwwwwwwwNNNNwwwwwwwAAAAAAAAAAAAAAAAAAwwwwwwwwwwwwwwwwwwwwwwwwwwwwwwwwwwwwwwwwwOO
OOwwAAAAAAAAAAAwwwwwwwwwwwwwwwwwwwwwwwwwwwwwwwwwwwwwwwwwwwwwwwwwwwwwNNNNwwwwwwwAAAAAAAAAAAAAAAAAAwwwwwwwwwwwwwwwwwwwwwwwwwwwwwwwwwwwwwwwwwOO
OOwwAAAAAAAAAAAwwwwwwwwwwwwwwwwwwwwwwwwwwwwwwwwwwwwwwwwwwwwwwwwwwwwwwwNNwwwwwwwAAAAAAAAAAAAAAAAAAwwwwwwwwwwwwwwwwwwwwwwwwwwwwwwwwwwwwwwwwwOO
OOwwAAAAAAAAAAAwwwwwwwwwwwwwwwwwwwwwwwwwwwwwwwwwwwwwwwwwwwwwwwwwwwwwwwNNNwwwwwwAAAAAAAAAAAAAAAAAAwwwwwwwwwwwwwwwwwwwwwwwwwwwwwwwwwwwwwwwwwOO
OOwwAAAAAAAAAAAwwwwwwwwwwwwwwwwwwwwwwwwwwwwwwwwwwwwwwwwwwwwwwwwwwwwwwwNNNNwwwwwAAAAAAAAAAAAAAAAAAwwwwwwwwwwwwwwwwwwwwwwwwwwwwwwwwwwwwwwwwwOO
OOwwAAAAAAAAAAAwwwwwwwwwwwwwwwwwwwwwwwwwwwwwwwwwwwwwwwwwwwwwwwwwwwwwwwwNNNwwwwwAAAAAAAAAAAAAAAAAAwwwwwwwwwwwwwwwwwwwwwwwwwwwwwwwwwwwwwwwwwOO
OOwwAAAAAAAAAAAwwwwwwwwwwwwwwwwwwwwwwwwwwwwwwwwwwwwwwwwwwwwwwwwwwwwwwwwNNNwwwwwAAAAAAAAAAAAAAAAAAwwwwwwwwwwwwwwwwwwwwwwwwwwwwwwwwwwwwwwwwwOO
OOwwAAAAAAAAAAAwwwwwwwwwwwwwwwwwwwwwwwwwwwwwwwwwwwwwwwwwwwwwwwwwwwwwwwwwNNNwwwwAAAAAAAAAAAAAAAAAAwwwwwwwwwwwwwwwwwwwwwwwwwwwwwwwwwwwwwwwwwOO
OOwwAAAAAAAAAAAwwwwwwwwwwwwwwwwwwwwwwwwwwwwwwwwwwwwwwwwwwwwwwwwwwwwwwwwwNNwwwwwAAAAAAAAAAAAAAAAAAwwwwwwwwwwwwwwwwwwwwwwwwwwwwwwwwwwwwwwwwwOO
OOwwAAAAAAAAAAAwwwwwwwwwwwwwwwwwwwwwwwwwwwwwwwwwwwwwwwwwwwwwwwwwwwwwwwwwwNNNNwwAAAAAAAAAAAAAAAAAAwwwwwwwwwwwwwwwwwwwwwwwwwwwwwwwwwwwwwwwwwOO
OOwwAAAAAAAAAAAwwwwwwwwwwwwwwwwwwwwwwwwwwwwwwwwwwwwwwwwwwwwwwwwwwwwwwwwwwNNNNwwwwwwwwwwwwwwwwwwwwwwwwwwwwwwwwwwwwwwwwwwwwwwwwwwwwwwwwwwwwwOO
OOwwAAAAAAAAAAAwwwwwwwwwwwwwwwwwwwwwwwwwwwwwwwwwwwwwwwwwwwwwwwwwwwwwwwwwwNNNNwwwwwwwwwwwwwwwwwwwwwwwwwwwwwwwwwwwwwwwwwwwwwwwwwwwwwwwwwwwwwOO
OOwwAAAAAAAAAAAAAAAAAAAAAAAAAAAAAAAAAAAAAAAAAAAAAwwwwwwwwwwwwwwwwwwwwwwwwwwNNwwwwwwwwwwwwwwwwwwwwwwwwwwwwwwwwwwwwwwwwwwwwwwwwwwwwwwwwwwwwwOO
OOwwAAAAAAAAAAAAAAAAAAAAAAAAAAAAAAAAAAAAAAAAAAAAAwwwwwwwwwwwwwwwwwwwwwwwwwwNNwwwwwwwwwwwwwwwwwwwwwwwwwwwwwwwwwwwwwwwwwwwwwwwwwwwwwwwwwwwwwOO
OOwwAAAAAAAAAAAAAAAAAAAAAAAAAAAAAAAAAAAAAAAAAAAAAwwwwwwwwwwwwwwwwwwwwwwwwwwNNNwwwwwwwwwwwwwwwwwwwwwwwwwwwwwwwwwwwwwwwwwwwwwwwwwwwwwwwwwwwwOO
OOwwAAAAAAAAAAAAAAAAAAAAAAAAAAAAAAAAAAAAAAAAAAAAAwwwwwwwwwwwwwwwwwwwwwwwwwwwwNNwwwwwwwwwwwwwwwwwwwwwwwwwwwwwwwwwwwwwwwwwwwwwwwwwwwwwwwwwwwOO
OOwwAAAAAAAAAAAAAAAAAAAAAAAAAAAAAAAAAAAAAAAAAAAAAwwwwwwwwwwwwwwwwwwwwwwwwwwwwNNNwwwwwwwwwwwwwwwwwwwwwwwwwwwwwwwwwwwwwwwwwwwwwwwwwwwwwwwwwwOO
OOwwAAAAAAAAAAAAAAAAAAAAAAAAAAAAAAAAAAAAAAAAAAAAAwwwwwwwwwwwwwwwwwwwwwwwwwwwwNNNwwwwwwwwwwwNNNNNNNwwwwwwwwwwwwwwwwwwwwwwwwwwwwwwwwwwwwwwwwOO
OOwwAAAAAAAAAAAAAAAAAAAAAAAAAAAAAAAAAAAAAAAAAAAAAwwwwwwwwwwwwwwwwwwwwwwwwwwwwrrrrrreerrererrrrrrrrrrrerrreereeeewwwwwwwwwwwwwwwwwwwwwwwwwwOO
OOwwAAAAAAAAAAAAAAAAAAAAAAAAAAAAAAAAAAAAAAAAAAAAAwwwwwwwwwwwwwwwwwwwwwwwwwwwweerrrreerrrrerrrrrrrerrrrrrrrrrreeewwwwwwwwwwwwwwwwwwwwwwwwwwOO
OOwwAAAAAAAAAAAAAAAAAAAAAAAAAAAAAAAAAAAAAAAAAAAAAAAAAAAAAAAAAAAAAAAwwwwwwwwwweerrrrrrrrrrrrrrrrrrrrrrrrrrrrrrreewwwwwwwwwwwwwwwwwwwwwwwwwwOO
OOwwAAAAAAAAAAAAAAAAAAAAAAAAAAAAAAAAAAAAAAAAAAAAAAAAAAAAAAAAAAAAAAAwwwwwwwwwweerrrrrrrrrrrrrrrrrrrrrrrrrrrrrreeewwwwwwwwwwwwwwwwwwwwwwwwwwOO
OOwwAAAAAAAAAAAAAAAAAAAAAAAAAAAAAAAAAAAAAAAAAAAAAAAAAAAAAAAAAAAAAAAwwwwwwwwwweeerrrrrrrrrrrrrrjrrrrrrrrrrrrrreeewwwwwwwwwwwwwwwwwwwwwwwwwwOO
OOwwAAAAAAAAAAAAAAAAAAAAAAAAAAAAAAAAAAAAAAAAAAAAAAAAAAAAAAAAAAAAAAAwwwwwwwwwweerrrrrrrrrrrrrrrrrrrrrrrrrrrrrreeewwwwwwwwwwwwwwwwwwwwwwwwwwOO
OOwwAAAAAAAAAAAAAAAAAAAAAAAAAAAAAAAAAAAAAAAAAAAAAAAAAAAAAAAAAAAAAAAwwwwwwwwwweerrrrrrrrrrrrrrrrrrrrrrrrrrrrrrreewwwwwwwwwwwwwwwwwwwwwwwwwwOO
OOwwAAAAAAAAAAAAAAAAAAAAAAAAAAAAAAAAAAAAAAAAAAAAAAAAAAAAAAAAAAAAAAAwwwwwwwwwweerrrrrrrrrrrrrrrrrrrrrrrrrrrrrrreewwwwwwwwwwwwwwwwwwwwwwwwwwOO
OOwwAAAAAAAAAAAAAAAAAAAAAAAAAAAAAAAAAAAAAAAAAAAAAAAAAAAAAAAAAAAAAAAwwwwwwwwwweerrrrrrrrrrrrrrrrrrrrrrrrrrrrrreeewwwwwwwwwwwwwwwwwwwwwwwwwwOO
OOwwAAAAAAAAAAAAAAAAAAAAAAAAAAAAAAAAAAAAAAAAAAAAAAAAAAAAAAAAAAAAAAAwwwwwwwwwweeerrrrrrrrrrrrrrrrrrrrrrrrrrrrrrrrNwwwwwwwwwwwwwwwwwwwwwwwwwOO
OOwwAAAAAAAAAAAAAAAAAAAAAAAAAAAAAAAAAAAAAAAAAAAAAAAAAAAAAAAAAAAAAAAwwwwwwwwwweerrrrrrrrrrrrrrrrrrrrrrrrrrrrrrreeNNwwwwwwwwwwwwwwwwwwwwwwwwOO
OOwwAAAAAAAAAAAAAAAAAAAAAAAAAAAAAAAAAAAAAAAAAAAAAAAAAAAAAAAAAAAAAAAwwwwwwwwwweerrrrrrrrrrrrrrrrrrrrrrrrrrrrrrerrwwwwwwwwwwwwwwwwwwwwwwwwwwOO
OOwwAAAAAAAAAAAAAAAAAAAAAAAAAAAAAAAAAAAAAAAAAAAAAAAAAAAAAAAAAAAAAAAwwwwwwwwwwerrrrrrrrrrrrrrrrrrrrrrrrrrrrrrrrrrwwwwwwwwwwwwwwwwwwwwwwwwwwOO
OOwwAAAAAAAAAAAAAAAAAAAAAAAAAAAAAAAAAAAAAAAAAAAAAAAAAAAAAAAAAAAAAAAwwwwwwwwwwerrrrrrrrrrrrrrrrrrrrrrrrrrrrrrrrrrwwwwwwwwwwwwwwwwwwwwwwwwwwOO
OOwwAAAAAAAAAAAAAAAAAAAAAAAAAAAAAAAAAAAAAAAAAAAAAAAAAAAAAAAAAAAAAAAwwwwwwwwwweerrrrrrrrrrrrrrrrrrrrrrrrrrrrrrrrewwwwwwwwwwwwwwwwwwwwwwwwwwOO
OOwwAAAAAAAAAAAAAAAAAAAAAAAAAAAAAAAAAAAAAAAAAAAAAAAAAAAAAAAAAAAAAAAwwwwwwwwwweerrrrrrrrrrrrrrrrrrrrrrrrrrrrrrrrewwwwwwwwwwwwwwwwwwwwwwwwwwOO
OOwwwwwwwwwwAAAAAAAAAAAAAAAAAAAAAAAAAAAAAAAAAAAAAAAAAAAAAAAAAAAAAAAwwwwwwwwwweerrrrrrrrrrrrrrrrrrrrrrrrrrrrrrrrewwwwwwwwwwwwwwwwwwwwwwwwwwOO
OOwwwwwwwwwwAAAAAAAAAAAAAAAAAAAAAAAAAAAAAAAAAAAAAAAAAAAAAAAAAAAAAAAwwwwwwwwwweerrrrrrrrrrrrrrrrrrrrrrrrrrrrrrreewwwwwwwwwwwwwwwwwwwwwwwwwwOO
OOwwwwwwwwwwAAAAAAAAAAAAAAAAAAAAAAAAAAAAAAAAAAAAAAAAAAAAAAAAAAAAAAAwwwwwwwwwweerrrrrrrrrrrrrrrrrrrrrrrrrrrrrrreewwwwwwwwwwwwwwwwwwwwwwwwwwOO
OOwwwwwwwwwwAAAAAAAAAAAAAAAAAAAAAAAAAAAAAAAAAAAAAAAAAAAAAAAAAAAAAAAwwwwwwwwwweerrrrrrrrrrrrrrrrrrrrrrrrrrrrrrreewwwwwwwwwwwwwwwwwwwwwwwwwwOO
OOwwwwwwwwwwAAAAAAAAAAAAAAAAAAAAAAAAAAAAAAAAAAAAAAAAAAAAAAAAAAAAAAAwwwwwwwwwweeererrrreeererrrrrrrrrrrrrrrreeeeewwwwwwwwwwwwwwwwwwwwwwwwwwOO
OOwwwwwwwwwwAAAAAAAAAAAAAAAAAAAAAAAAAAAAAAAAAAAAAAAAAAAAAAAAAAAAAAAwwwwwwwwwwwwwwNNwwNNwwNNwwNNwNNNwNNwwwwwwwwwwwwwwwwwwwwwwwwwwwwwwwwwwwwOO
OOwwwwwwwwwwAAAAAAAAAAAAAAAAAAAAAAAAAAAAAAAAAAAAAAAAAAAAAAAAAAAAAAAwwwwwwwwwwwwwwwwwwNNwwwwwwwwwwwwwwwwwwwwwwwwwwwwwwwwwwwwwwwwwwwwwwwwwwwOO
OOwwwwwwwwwwAAAAAAAAAAAAAAAAAAAAAAAAAAAAAAAAAAAAAAAAAAAAAAAAAAAAAAAwwwwwwwwwwwwwwwwwwwwwwwwwwwwwwwwwwwwwwwwwwwwwwwwwwwwwwwwwwwwwwwwwwwwwwwOO
OOwwwwwwwwwwAAAAAAAAAAAAAAAAAAAAAAAAAAAAAAAAAAAAAAAAAAAAAAAAAAAAAAAwwwwwwwwwwwwwwwwwwwwwwwwwwwwwwwwwwwwwwwwwwwwwwwwwwwwwwwwwwwwwwwwwwwwwwwOO
OOwwwwwwwwwwAAAAAAAAAAAAAAAAAAAAAAAAAAAAAAAAAAAAAAAAAAAAAAAAAAAAAAAwwwwwwwwwwwwwwwwwwwwwwwwwwwwwwwwwwwwwwwwwwwwwwwwwwwwwwwwwwwwwwwwwwwwwwwOO
OOwwwwwwwwwwAAAAAAAAAAAAAAAAAAAAAAAAAAAAAAAAAAAAAAAAAAAAAAAAAAAAAAAwwwwwwwwwwwwwwwwwwwwwwwwwwwwwwwwwwwwwwwwwwwwwwwwwwwwwwwwwwwwwwwwwwwwwwwOO
OOwwwwwwwwwwAAAAAAAAAAAAAAAAAAAAAAAAAAAAAAAAAAAAAAAAAAAAAAAAAAAAAAAwwwwwwwwwwwwwwwwwwwwwwwwwwwwwwwwwwwwwwwwwwwwwwwwwwwwwwwwwwwwwwwwwwwwwwwOO
OOwwwwwwwwwwAAAAAAAAAAAAAAAAAAAAAAAAAAAAAAAAAAAAAAAAAAAAAAAAAAAAAAAAAAAAAAAAAAAAAAAAAAAAAAAAAAAAAAAAAAAAAAAAAAAAAAAAAAAAAAAAAwwwwwwwwwwwwwOO
OOwwwwwwwwwwAAAAAAAAAAAAAAAAAAAAAAAAAAAAAAAAAAAAAAAAAAAAAAAAAAAAAAAAAAAAAAAAAAAAAAAAAAAAAAAAAAAAAAAAAAAAAAAAAAAAAAAAAAAAAAAAAwwwwwwwwwwwwwOO
OOwwwwwwwwwwAAAAAAAAAAAAAAAAAAAAAAAAAAAAAAAAAAAAAwwwwwwwwwwwwwwwAAAAAAAAAAAAAAAAAAAAAAAAAAAAAAAAAAAAAAAAAAAAAAAAAAAAAAAAAAAAAwwwwwwwwwwwwwOO
OOwwwwwwwwwwAAAAAAAAAAAAAAAAAAAAAAAAAAAAAAAAAAAAAwwwwwwwwwwwwwwwAAAAAAAAAAAAAAAAAAAAAAAAAAAAAAAAAAAAAAAAAAAAAAAAAAAAAAAAAAAAAwwwwwwwwwwwwwOO
OOwwwwwwwwwwAAAAAAAAAAAAAAAAAAAAAAAAAAAAAAAAAAAAAwwwwwwwwwwwwwwwAAAAAAAAAAAAAAAAAAAAAAAAAAAAAAAAAAAAAAAAAAAAAAAAAAAAAAAAAAAAAwwwwwwwwwwwwwOO
OOwwwwwwwwwwwwwwwwwwwwwwwwwwwwwwwwwwwwwwwwwwwwwwwwwwwwwwwwwwwwwwAAAAAAAAAAAAAAAAAAAAAAAAAAAAAAAAAAAAAAAAAAAAAAAAAAAAAAAAAAAAAwwwwwwwwwwwwwOO
OOwwwwwwwwwwwwwwwwwwwwwwwwwwwwwwwwwwwwwwwwwwwwwwwwwwwwwwwwwwwwwwAAAAAAAAAAAAAAAAAAAAAAAAAAAAAAAAAAAAAAAAAAAAAAAAAAAAAAAAAAAAAwwwwwwwwwwwwwOO
OOwwwwwwwwwwwwwwwwwwwwwwwwwwwwwwwwwwwwwwwwwwwwwwwwwwwwwwwwwwwwwwAAAAAAAAAAAAAAAAAAAAAAAAAAAAAAAAAAAAAAAAAAAAAAAAAAAAAAAAAAAAAwwwwwwwwwwwwwOO
OOwwwwwwwwwwwwwwwwwwwwwwwwwwwwwwwwwwwwwwwwwwwwwwwwwwwwwwwwwwwwwwAAAAAAAAAAAAAAAAAAAAAAAAAAAAAAAAAAAAAAAAAAAAAAAAAAAAAAAAAAAAAwwwwwwwwwwwwwOO
OOwwwwwwwwwwwwwwwwwwwwwwwwwwwwwwwwwwwwwwwwwwwwwwwwwwwwwwwwwwwwwwAAAAAAAAAAAAAAAAAAAAAAAAAAAAAAAAAAAAAAAAAAAAAAAAAAAAAAAAAAAAAwwwwwwwwwwwwwOO
OOwwwwwwwwwwwwwwwwwwwwwwwwwwwwwwwwwwwwwwwwwwwwwwwwwwwwwwwwwwwwwwAAAAAAAAAAAAAAAAAAAAAAAAAAAAAAAAAAAAAAAAAAAAAAAAAAAAAAAAAAAAAwwwwwwwwwwwwwOO
OOwwwwwwwwwwwwwwwwwwwwwwwwwwwwwwwwwwwwwwwwwwwwwwwwwwwwwwwwwwwwwwwwwwwwwwwwwwwwwwwwwwwwwwwwwwwwwwwwwwwwwwwwwwwwwwwwwwwwwwwwwwwwwwwwwwwwwwwwOO
OOwwwwwwwwwwwwwwwwwwwwwwwwwwwwwwwwwwwwwwwwwwwwwwwwwwwwwwwwwwwwwwwwwwwwwwwwwwwwwwwwwwwwwwwwwwwwwwwwwwwwwwwwwwwwwwwwwwwwwwwwwwwwwwwwwwwwwwwwOO
OOwwwwwwwwwwwwwwwwwwwwwwwwwwwwwwwwwwwwwwwwwwwwwwwwwwwwwwwwwwwwwwwwwwwwwwwwwwwwwwwwwwwwwwwwwwwwwwwwwwwwwwwwwwwwwwwwwwwwwwwwwwwwwwwwwwwwwwwwOO
OOwwwwwwwwwwwwwwwwwwwwwwwwwwwwwwwwwwwwwwwwwwwwwwwwwwwwwwwwwwwwwwwwwwwwwwwwwwwwwwwwwwwwwwwwwwwwwwwwwwwwwwwwwwwwwwwwwwwwwwwwwwwwwwwwwwwwwwwwOO
OfOOOOOOOOOOOOOOOOOOOOOOOOOOOOOOOOOOOOOOOOOOOOOOOOOOOOOOOOOOOOOOOOOOOOOOOOOOOOOOOOOOOOOOOOOOOOOOOOOOOOOOOOOOOOOOOOOOOOOOOOOOOOOOOOOOOOOOOOOO
aOOOOOOOOOOOOOOOOOOOOOOOOOOOOOOOOOOOOOOOOOOOOOOOOOOOOOOOOOOOOOOOOOOOOOOOOOOOOOOOOOOOOOOOOOOOOOOOOOOOOOOOOOOOOOOOOOOOOOOOOOOOOOOOOOOOOOOOOOOO
"}
