"a" = (/obj/effect/overmap/visitable/sector/mining_planet,/turf/unsimulated/mineral/triumph,/area/triumph_away/mining_planet/unexplored)
"f" = (/obj/away_mission_init/mining_planet,/turf/unsimulated/mineral/triumph,/area/triumph_away/mining_planet/unexplored)
"j" = (/obj/effect/shuttle_landmark/automatic,/turf/simulated/mineral/floor/ignore_cavegen,/area/triumph_away/mining_planet/explored)
"r" = (/turf/simulated/mineral/floor/ignore_cavegen,/area/triumph_away/mining_planet/explored)
"w" = (/turf/simulated/mineral/triumph/rich,/area/triumph_away/mining_planet/unexplored)
"A" = (/turf/simulated/mineral/triumph,/area/triumph_away/mining_planet/unexplored)
"F" = (/turf/simulated/mineral/floor/ignore_cavegen,/area/triumph_away/mining_planet/unexplored)
"N" = (/turf/simulated/mineral/floor,/area/triumph_away/mining_planet/unexplored)
"O" = (/turf/unsimulated/mineral/triumph,/area/triumph_away/mining_planet/unexplored)

(1,1,1) = {"
OOOOOOOOOOOOOOOOOOOOOOOOOOOOOOOOOOOOOOOOOOOOOOOOOOOOOOOOOOOOOOOOOOOOOOOOOOOOOOOOOOOOOOOOOOOOOOOOOOOOOOOOOOOOOOOOOOOOOOOOOOOOOOOOOOOOOOOOOOOO
OOOOOOOOOOOOOOOOOOOOOOOOOOOOOOOOOOOOOOOOOOOOOOOOOOOOOOOOOOOOOOOOOOOOOOOOOOOOOOOOOOOOOOOOOOOOOOOOOOOOOOOOOOOOOOOOOOOOOOOOOOOOOOOOOOOOOOOOOOOO
OOwwwwwwwwwwwwwwwwwwwwwwwwwwwwwwwwwwwwwwwwwwwwwwwwwwwwwwwwwwwwwwwwwwwwwwwwwwwwwwwwwwwwwwwwwwwwwwwwwwwwwwwwwwwwwwwwwwwwwwwwwwwwwwwwwwwwwwwwOO
OOwwwwwwwwwwwwwwwwwwwwwwwwwwwwwwwwwwwwwwwwwwwwwwwwwwwwwwwwwwwwwwwwwwwwwwwwwwwwwwwwwwwwwwwwwwwwwwwwwwwwwwwwwwwwwwwwwwwwwwwwwwwwwwwwwwwwwwwwOO
OOwwwwwwwwwwwwwwwwwwwwwwwwwwwwwwwwwwwwwwwwwwwwwwwwwwwwwwwwwwwwwwwwwwwwwwwwwwwwwwwwwwwwwwwwwwwwwwwwwwwwwwwwwwwwwwwwwwwwwwwwwwwwwwwwwwwwwwwwOO
OOwwwwwwwwwwwwwwwwwwwwwwwwwwwwwwwwwwwwwwwwwwwwwwwwwwwwwwwwwwwwwwwwwwwwwwwwwwwwwwwwwwwwwwwwwwwwwwwwwwwwwwwwwwwwwwwwwwwwwwwwwwwwwwwwwwwwwwwwOO
OOwwwwwwwwwwwwwwwwwwwwwwwwwwwwwwwwwwwwwwwwwwwwwwwwwwwwwwwwwwwwwwwwwwwwwwwwwwwwwwwwwwwwwwwwwwwwwwwwwwwwwwwwwwwwwwwwwwwwwwwwwwwwwwwwwwwwwwwwOO
OOwwwwwwwwwwwwwwwwwwwwwwwwwwwwwwwwwwwwwwwwwwwwwwwwwwwwwwwwwwwwwwwwwwwwwwwwwwwwwwwwwwwwwwwwwwwwwwwwwwwwwwwwwwwwwwwwwwwwwwwwwwwwwwwwwwwwwwwwOO
OOwwwwwwwwwwwwwwwwwwwwwwwwwwwwwwwwwwwwwwwwwwwwwwwwwwwwwwwwwwwwwwwwwAAAAAAAAAAAAAAAAAAAAAAAAAAAAAAAAwwwwwwwwwwwwwwwwwwwwwwwwwwwwwwwwwwwwwwwOO
OOwwwwwwwwwwwwwwwwwwwwwwwwwNNNwwwwwwNNwwwwwwwwwwwwwwwwwwwwwwwwwwwwwAAAAAAAAAAAAAAAAAAAAAAAAAAAAAAAAwwwwwwwwwwwwwwwwwwwwwwwwwwwwwwwwwwwwwwwOO
OOwwwwwwwwwwwrrrrrrrrrrrrrrrrrrrrrrrrrrrrrrrwwwwwwwwwwwwwwwwwwwwwwwAAAAAAAAAAAAAAAAAAAAAAAAAAAAAAAAwwwwwwwwwwwwwwwwwwwwwwwwwwwwwwwwwwwwwwwOO
OOwwwwwwwwwwwrrrrrrrrrrrrrrrrrrrrrrrrrrrrrrrwwwwwwwwwwwwwwwwwwwwwwwAAAAAAAAAAAAAAAAAAAAAAAAAAAAAAAAwwwwwwwwwwwwwwwwwwwwwwwwwwwwwwwwwwwwwwwOO
OOwwwwwwwwwwwrrrrrrrrrrrrrrrrrrrrrrrrrrrrrrrwwwwwwwwwwwwwwwwwwwwwwwAAAAAAAAAAAAAAAAAAAAAAAAAAAAAAAAwwwwwwwwwwwwwwwwwwwwwwwwwwwwwwwwwwwwwwwOO
OOwwwwwwwwwwwrrrrrrrrrrrrrrrrrrrrrrrrrrrrrrrwwwwwwwwwwwwwwwwwwwwwwwAAAAAAAAAAAAAAAAAAAAAAAAAAAAAAAAwwwwwwwwwwwwwwwwwwwwwwwwwwwwwwwwwwwwwwwOO
OOwwwwwwwwwNNrrrrrrrrrrrrrrrrrrrrrrrrrrrrrrrNwwwwwwwwwwwwwwwwwwwwwwAAAAAAAAAAAAAAAAAAAAAAAAAAAAAAAAwwwwwwwwwwwwwwwwwwwwwwwwwwwwwwwwwwwwwwwOO
OOwwwwwwwwwNNrrrrrrrrrrrrrrrrjrrrrrrrrrrrrrrNwwwwwwwwwwwwwwwwwwwwwwAAAAAAAAAAAAAAAAAAAAAAAAAAAAAAAAwwwwwwwwwwwwwwwwwwwwwwwwwwwwwwwwwwwwwwwOO
OOwwwwwwwwwNNrrrrrrrrrrrrrrrrrrrrrrrrrrrrrrrNNwwwwwwwwwwwwwwwwwwwwwAAAAAAAAAAAAAAAAAAAAAAAAAAAAAAAAwwwwwwwwwwwwwwwwwwwwwwwwwwwwwwwwwwwwwwwOO
OOwwwwwwwwwNNrrrrrrrrrrrrrrrrrrrrrrrrrrrrrrrNNwwwwwwwwwwwwwwwwwwwwwAAAAAAAAAAAAAAAAAAAAAAAAAAAAAAAAAAAAAAAAAAAAAAAAAAAAAAAAAAAAAAAAAAAAAAwOO
OOwwwwwwwwwwwrrrrrrrrrrrrrrrrrrrrrrrrrrrrrrrNNwwwwwwwwwwwwwwwwwwwwwAAAAAAAAAAAAAAAAAAAAAAAAAAAAAAAAAAAAAAAAAAAAAAAAAAAAAAAAAAAAAAAAAAAAAAwOO
OOwwwwwwwwwwwrrrrrrrrrrrrrrrrrrrrrrrrrrrrrrrNNwwwwwwwwwwwwwwwwwwwwwAAAAAAAAAAAAAAAAAAAAAAAAAAAAAAAAAAAAAAAAAAAAAAAAAAAAAAAAAAAAAAAAAAAAAAwOO
OOwwwwwwwwwwwrrrrrrrrrrrrrrrrrrrrrrrrrrrrrrrNwwwwwwwwwwwwwwwwwwwwwwAAAAAAAAAAAAAAAAAAAAAAAAAAAAAAAAAAAAAAAAAAAAAAAAAAAAAAAAAAAAAAAAAAAAAAwOO
OOwwwwwwwwwwwrrrrrrrrrrrrrrrrrrrrrrrrrrrrrrrwwwwwwwwwwwwwwwwwwwwwwwwwwwwwwwwwwwwwwwwwwwwwwwwAAAAAAAAAAAAAAAAAAAAAAAAAAAAAAAAAAAAAAAAAAAAAwOO
OOwwwwwwwwwwwrrrrrrrrrrrrrrrrrrrrrrrrrrrrrrrwwwwwwwwwwwwwwwwwwwwwwAAAAAAAAAAAAAAAAAAAAAAAAAAAAAAAAAAAAAAAAAAAAAAAAAAAAAAAAAAAAAAAAAAAAAAAwOO
OOwwwwwwwwwwwrrrrrrrrrrrrrrrrrrrrrrrrrrrrrrrwwwwwwwwwwwwwwwwwwwwwwAAAAAAAAAAAAAAAAAAAAAAAAAAAAAAAAAAAAAAAAAAAAAAAAAAAAAAAAAAAAAAAAAAAAAAAwOO
OOwwwwwwwwwwwrrrrrrrrrrrrrrrrrrrrrrrrrrrrrrrwwwwwwwwwwwwwwwwwwwwwwAAAAAAAAAAAAAAAAAAAAAAAAAAAAAAAAAAAAAAAAAAAAAAAAAAAAAAAAAAAAAAAAAAAAAAAwOO
OOwwwwwwwwwwwrrrrrrrrrrrrrrrrrrrrrrrrrrrrrrrwwwwwwwwwwwwwwwwwwwwwwAAAAAAAAAAAAAAAAAAAAAAAAAAAAAAAAAAAAAAAAAAAAAAAAAAAAAAAAAAAAAAAAAAAAAAAwOO
OOwwwwwwwwwwwrrrrrrrrrrrrrrrrrrrrrrrrrrrrrrrNwwwwwwwwwwwwwwwwwwwwwAAAAAAAAAAAAAAAAAAAAAAAAAAAAAAAAAAAAAAAAAAAAAAAAAAAAAAAAAAAAAAAAAAAAAAAwOO
OOwwwwwwwwwwwrrrrrrrrrrrrrrrrrrrrrrrrrrrrrrrNwwwwwwwwwwwwwwwwwwwwwAAAAAAAAAAAAAAAAAAAAAAAAAAAAAAAAAAAAAAAAAAAAAAAAAAAAAAAAAAAAAAAAAAAAAAAwOO
OOwwwwwwwwwwwrrrrrrrrrrrrrrrrrrrrrrrrrrrrrrrNwwwwwwwwwwwwwwwwwwwwwAAAAAAAAAAAAAAAAAAAAAAAAAAAAAAAAAAAAAAAAAAAAAAAAAAAAAAAAAAAAAAAAAAAAAAAwOO
OOwwwwwwwwwwwwwwwwwwNNNNNNwwwwwwwwwFwwNNNNNNNwwwwwwwwwwwwwwwwwwwwwAAAAAAAAAAAAAAAAAAAAAAAAAAAAAAAAAAAAAAAAAAAAAAAAAAAAAAAAAAAAAAAAAAAAAAAwOO
OOwwwwwwwwwwwwwwwwwwNNNNNNNwwwwwwwwFwwwwNNNNwwwwwAAAAAAAAAAwwwwwwwAAAAAAAAAAAAAAAAAAAAAAAAAAAAAAAAAAAAAAAAAAAAAAAAAAAAAAAAAAAAAAAAAAAAAAAwOO
OOwwAAAAAAAAAAAwwwwwwwwNNNNwwwwwwwwFFFwwwNNNwwwwwAAAAAAAAAAwwwwwwwAAAAAAAAAAAAAAAAAAAAAAAAAAAAAAAAAAAAAAAAAAAAAAAAAAAAAAAAAAAAAAAAAAAAAAAwOO
OOwwAAAAAAAAAAAwwwwwwwwwwwwwwwwwwwwFFFwwwwwwwwwwwAAAAAAAAAAwwwwwwwAAAAAAAAAAAAAAAAAAAAAAAAAAAAAAAAAAAAAAAAAAAAAAAAAAAAAAAAAAAAAAAAAAAAAAAwOO
OOwwAAAAAAAAAAAwwwwwwwwwwwwwwwwwwwwFFFwwwwwwwwwwwAAAAAAAAAAwwwwwwwAAAAAAAAAAAAAAAAAAAAAAAAAAAAAAAAAAAAAAAAAAAAAAAAAAAAAAAAAAAAAAAAAAAAAAAwOO
OOwwAAAAAAAAAAAwwwwwwwwwwwwwwwwwwwwFFFwwwwwwwwwwwAAAAAAAAAAwwwwwwwAAAAAAAAAAAAAAAAAAAAAAAAAAAAAAAAAAAAAAAAAAAAAAAAAAAAAAAAAAAAAAAAAAAAAAAwOO
OOwwAAAAAAAAAAAwwwwwwwwwwwwwwwwwwwwFFFwwwwwwwwwwwAAAAAAAAAAwwwwwwwAAAAAAAAAAAAAAAAAAAAAAAAAAAAAAAAAAAAAAAAAAAAAAAAAAAAAAAAAAAAAAAAAAAAAAAwOO
OOwwAAAAAAAAAAAwwwwwwwwwwwwwwwwwwwwwFFwwwwwwwwwwwAAAAAAAAAAwwwwwwwAAAAAAAAAAAAAAAAAAAAAAAAAAAAAAAAAAAAAAAAAAAAAAAAAAAAAAAAAAAAAAAAAAAAAAAwOO
OOwwAAAAAAAAAAAwwwwwwwwwwwwwwwwwwwwwNwwwwwwwwwwwwAAAAAAAAAAwwwwwwwAAAAAAAAAAAAAAAAAAAAAAAAAAAAAAAAAAAAAAAAAAAAAAAAAAAAAAAAAAAAAAAAAAAAAAAwOO
OOwwAAAAAAAAAAAwwwwwwwwwwwwwwwwwwwwwFFFwwwwwwwwwwAAAAAAAAAAwwwwwwwAAAAAAAAAAAAAAAAAAAAAAAAAAAAAAAAAAAAAAAAAAAAAAAAAAAAAAAAAAAAAAAAAAAAAAAwOO
OOwwAAAAAAAAAAAwwwwwwwwwwwwwwwwwwwwwFFFwwwwwwwwwwAAAAAAAAAAwwwwwwwAAAAAAAAAAAAAAAAAAAAAAAAAAAAAAAAAAAAAAAAAAAAAAAAAAAAAAAAAAAAAAAAAAAAAAAwOO
OOwwAAAAAAAAAAAwwwwwwwwwwwwwwwwwwwwwFFFwwwwwwwwwwAAAAAAAAAAwwwwwwwAAAAAAAAAAAAAAAAAAAAAAAAAAAAAAAAAAAAAAAAAAAAAAAAAAAAAAAAAAAAAAAAAAAAAAAwOO
OOwwAAAAAAAAAAAwwwwwwwwwwwwwwwwwwwwwwwNNwwwwwwwwwAAAAAAAAAAwwwwwwwAAAAAAAAAAAAAAAAAAAAAAAAAAAAAAAAAAAAAAAAAAAAAAAAAAAAAAAAAAAAAAAAAAAAAAAwOO
OOwwAAAAAAAAAAAwwwwwwwwwwwwwwwwwwwwwwwNFFwwwwwwwwAAAAAAAAAAwwwwwwwAAAAAAAAAAAAAAAAAAAAAAAAAAAAAAAAAAAAAAAAAAAAAAAAAAAAAAAAAAAAAAAAAAAAAAAwOO
OOwwAAAAAAAAAAAwwwwwwwwwwwwwwwwwwwwwwwwFFwwwwwwwwAAAAAAAAAAwwwwwwwAAAAAAAAAAAAAAAAAAAAAAAAAAAAAAAAAAAAAAAAAAAAAAAAAAAAAAAAAAAAAAAAAAAAAAAwOO
OOwwAAAAAAAAAAAwwwwwwwwwwwwwwwwwwwwwwwwFFNwwwwwwwAAAAAAAAAAwwwwwwwAAAAAAAAAAAAAAAAAAAAAAAAAAAAAAAAAAAAAAAAAAAAAAAAAAAAAAAAAAAAAAAAAAAAAAAwOO
OOwwAAAAAAAAAAAwwwwwwwwwwwwwwwwwwwwwwwwwwwFFNwwwwwwwwwwwwwwwwwwwwwAAAAAAAAAAAAAAAAAAAAAAAAAAAAAAAAAAAAAAAAAAAAAAAAAAAAAAAAAAAAAAAAAAAAAAAwOO
OOwwAAAAAAAAAAAwwwwwwwwwwwwwwwwwwwwwwwwwwwFFNNwwwwwwwwwwwwwwwwwwwwAAAAAAAAAAAAAAAAAAAAAAAAAAAAAAAAAAAAAAAAAAAAAAAAAAAAAAAAAAAAAAAAAAAAAAAwOO
OOwwAAAAAAAAAAAwwwwwwwwwwwwwwwwwwwwwwwwwwwNNNNwwwwwwwwwwwwwwwwwwwwAAAAAAAAAAAAAAAAAAAAAAAAAAAAAAAAAAAAAAAAAAAAAAAAAAAAAAAAAAAAAAAAAAAAAAAwOO
OOwwAAAAAAAAAAAwwwwwwwwwwwwwwwwwwwwwwwwwwwwwNNNFFwwwwwwwwwwwwwwwwwAAAAAAAAAAAAAAAAAAAAAAAAAAAAAAAAAAAAAAAAAAAAAAAAAAAAAAAAAAAAAAAAAAAAAAAwOO
OOwwAAAAAAAAAAAwwwwwwwwwwwwwwwwwwwwwwwwwwwwwNNNFFwwwwwwwwwwwwwwwwwAAAAAAAAAAAAAAAAAAAAAAAAAAAAAAAAAAAAAAAAAAAAAAAAAAAAAAAAAAAAAAAAAAAAAAAwOO
OOwwAAAAAAAAAAAwwwwwwwwwwwwwwwwwwwwwwwwwwwwwwNNFFwwwwwwwwwwwwwwwwwAAAAAAAAAAAAAAAAAAAAAAAAAAAAAAAAAAAAAAAAAAAAAAAAAAAAAAAAAAAAAAAAAAAAAAAwOO
OOwwAAAAAAAAAAAwwwwwwwwwwwwwwwwwwwwwwwwwwwwwwNNwNNNNNwwwwwwwwwwwwwAAAAAAAAAAAAAAAAAAAAAAAAAAAAAAAAAAAAAAAAAAAAAAAAAAAAAAAAAAAAAAAAAAAAAAAwOO
OOwwAAAAAAAAAAAwwwwwwwwwwwwwwwwwwwwwwwwwwwwwwwwwNFFFNNNwwwwwwwwwwwAAAAAAAAAAAAAAAAAAAAAAAAAAAAAAAAAAAAAAAAAAAAAAAAAAAAAAAAAAAAAAAAAAAAAAAwOO
OOwwAAAAAAAAAAAwwwwwwwwwwwwwwwwwwwwwwwwwwwwwwwwwwFFFNNNNwwwwwwwwwwAAAAAAAAAAAAAAAAAAAAAAAAAAAAAAAAAAAAAAAAAAAAAAAAAAAAAAAAAAAAAAAAAAAAAAAwOO
OOwwAAAAAAAAAAAwwwwwwwwwwwwwwwwwwwwwwwwwwwwwwwwwwFFFNNNNwwwwwwwwwwAAAAAAAAAAAAAAAAAAAAAAAAAAAAAAAAAAAAAAAAAAAAAAAAAAAAAAAAAAAAAAAAAAAAAAAwOO
OOwwAAAAAAAAAAAwwwwwwwwwwwwwwwwwwwwwwwwwwwwwwwwwwwwwNNFFNwwwwwwwwwAAAAAAAAAAAAAAAAAAAAAAAAAAAAAAAAAAAAAAAAAAAAAAAAAAAAAAAAAAAAAAAAAAAAAAAwOO
OOwwAAAAAAAAAAAwwwwwwwwwwwwwwwwwwwwwwwwwwwwwwwwwwwwwwwFFNwwwwwwwwwAAAAAAAAAAAAAAAAAAAAAAAAAAAAAAAAAAAAAAAAAAAAAAAAAAAAAAAAAAAAAAAAAAAAAAAwOO
OOwwAAAAAAAAAAAwwwwwwwwwwwwwwwwwwwwwwwwwwwwwwwwwwwwwwwFFNNwwwwwwwwAAAAAAAAAAAAAAAAAAAAAAAAAAAAAAAAAAAAAAAAAAAAAAAAAAAAAAAAAAAAAAAAAAAAAAAwOO
OOwwAAAAAAAAAAAwwwwwwwwwwwwwwwwwwwwwwwwwwwwwwwwwwwwwwwwwFFNNwwwwwwwwwwAAAAAAAAAAAAAAAAAAAAAAAAAAAAAAAAAAAAAAAAAAAAAAAAAAAAAAAAAAAAAAAAAAAwOO
OOwwAAAAAAAAAAAwwwwwwwwwwwwwwwwwwwwwwwwwwwwwwwwwwwwwwwwwFFNNwwwwwwwwwwAAAAAAAAAAAAAAAAAAAAAAAAAAAAAAAAAAAAAAAAAAAAAAAAAAAAAAAAAAAAAAAAAAAwOO
OOwwAAAAAAAAAAAwwwwwwwwwwwwwwwwwwwwwwwwwwwwwwwwwwwwwwwwwFFNNwwwwwwwwwwAAAAAAAAAAAAAAAAAAAAAAAAAAAAAAAAAAAAAAAAAAAAAAAAAAAAAAAAAAAAAAAAAAAwOO
OOwwAAAAAAAAAAAwwwwwwwwwwwwwwwwwwwwwwwwwwwwwwwwwwwwwwwwwFFwNNNwwwwwwwwAAAAAAAAAAAAAAAAAAAAAAAAAAAAAAAAAAAAAAAAAAAAAAAAAAAAAAAAAAAAAAAAAAAwOO
OOwwAAAAAAAAAAAwwwwwwwwwwwwwwwwwwwwwwwwwwwwwwwwwwwwwwwwwwwwNNNwwwwwwwwAAAAAAAAAAAAAAAAAAAAAAAAAAAAAAAAAAAAAAAAAAAAAAAAAAAAAAAAAAAAAAAAAAAwOO
OOwwAAAAAAAAAAAwwwwwwwwwwwwwwwwwwwwwwwwwwwwwwwwwwwwwwwwwwwwFFFNwwwwwwwAAAAAAAAAAAAAAAAAAAAAAAAAAAAAAAAAAAAAAAAAAAAAAAAAAAAAAAAAAAAAAAAAAAwOO
OOwwAAAAAAAAAAAwwwwwwwwwwwwwwwwwwwwwwwwwwwwwwwwwwwwwwwwwwwwFFFNNwwwwwwAAAAAAAAAAAAAAAAAAAAAAAAAAAAAAAAAAAAAAAAAAAAAAAAAAAAAAAAAAAAAAAAAAAwOO
OOwwAAAAAAAAAAAwwwwwwwwwwwwwwwwwwwwwwwwwwwwwwwwwwwwwwwwwwwwFFFNNwwwwwwAAAAAAAAAAAAAAAAAAAAAAAAAAAAAAAAAAAAAAAAAAAAAAAAAAAAAAAAAAAAAAAAAAAwOO
OOwwAAAAAAAAAAAwwwwwwwwwwwwwwwwwwwwwwwwwwwwwwwwwwwwwwwwwwwwwwFFFNwwwwwwwwwwwwwwAAAAAAAAAAAAAAAAAAAAAAAAAAAAAAAAAAAAAAAAAAAAAAAAAAAAAAAAAAwOO
OOwwAAAAAAAAAAAwwwwwwwwwwwwwwwwwwwwwwwwwwwwwwwwwwwwwwwwwwwwwwFFFNwwwwwwwwwwwwwwAAAAAAAAAAAAAAAAAAAAAAAAAAAAAAAAAAAAAAAAAAAAAAAAAAAAAAAAAAwOO
OOwwAAAAAAAAAAAwwwwwwwwwwwwwwwwwwwwwwwwwwwwwwwwwwwwwwwwwwwwwwFFFNwFwwwwwwwwwwwwAAAAAAAAAAAAAAAAAAAAAAAAAAAAAAAAAAAAAAAAAAAAAAAAAAAAAAAAAAwOO
OOwwAAAAAAAAAAAwwwwwwwwwwwwwwwwwwwwwwwwwwwwwwwwwwwwwwwwwwwwwwwwNNFFwwwwwwwwwwwwAAAAAAAAAAAAAAAAAAAAAAAAAAAAAAAAAAAAAAAAAAAAAAAAAAAAAAAAAAwOO
OOwwAAAAAAAAAAAwwwwwwwwwwwwwwwwwwwwwwwwwwwwwwwwwwwwwwwwwwwwwwwwwNFFwwwwwwwwwwwwAAAAAAAAAAAAAAAAAAAAAAAAAAAAAAAAAAAAAAAAAAAAAAAAAAAAAAAAAAwOO
OOwwAAAAAAAAAAAwwwwwwwwwwwwwwwwwwwwwwwwwwwwwwwwwwwwwwwwwwwwwwwwwNNFFwwwwwwwwwwwAAAAAAAAAAAAAAAAAAwwwwwwwwwwwwwwwwwwwwwwwwwwwwwwwwwwwwwwwwwOO
OOwwAAAAAAAAAAAwwwwwwwwwwwwwwwwwwwwwwwwwwwwwwwwwwwwwwwwwwwwwwwwwwNFFwwwwwwwwwwwAAAAAAAAAAAAAAAAAAwwwwwwwwwwwwwwwwwwwwwwwwwwwwwwwwwwwwwwwwwOO
OOwwAAAAAAAAAAAwwwwwwwwwwwwwwwwwwwwwwwwwwwwwwwwwwwwwwwwwwwwwwwwwwwFFFwwwwwwwwwwAAAAAAAAAAAAAAAAAAwwwwwwwwwwwwwwwwwwwwwwwwwwwwwwwwwwwwwwwwwOO
OOwwAAAAAAAAAAAwwwwwwwwwwwwwwwwwwwwwwwwwwwwwwwwwwwwwwwwwwwwwwwwwwwFFFwwwwwwwwwwAAAAAAAAAAAAAAAAAAwwwwwwwwwwwwwwwwwwwwwwwwwwwwwwwwwwwwwwwwwOO
OOwwAAAAAAAAAAAwwwwwwwwwwwwwwwwwwwwwwwwwwwwwwwwwwwwwwwwwwwwwwwwwwwFFFwwwwwwwwwwAAAAAAAAAAAAAAAAAAwwwwwwwwwwwwwwwwwwwwwwwwwwwwwwwwwwwwwwwwwOO
OOwwAAAAAAAAAAAwwwwwwwwwwwwwwwwwwwwwwwwwwwwwwwwwwwwwwwwwwwwwwwwwwwwwNNNwwwwwwwwAAAAAAAAAAAAAAAAAAwwwwwwwwwwwwwwwwwwwwwwwwwwwwwwwwwwwwwwwwwOO
OOwwAAAAAAAAAAAwwwwwwwwwwwwwwwwwwwwwwwwwwwwwwwwwwwwwwwwwwwwwwwwwwwwwNNFFFwwwwwwAAAAAAAAAAAAAAAAAAwwwwwwwwwwwwwwwwwwwwwwwwwwwwwwwwwwwwwwwwwOO
OOwwAAAAAAAAAAAwwwwwwwwwwwwwwwwwwwwwwwwwwwwwwwwwwwwwwwwwwwwwwwwwwwwwNNFFFwwwwwwAAAAAAAAAAAAAAAAAAwwwwwwwwwwwwwwwwwwwwwwwwwwwwwwwwwwwwwwwwwOO
OOwwAAAAAAAAAAAwwwwwwwwwwwwwwwwwwwwwwwwwwwwwwwwwwwwwwwwwwwwwwwwwwwwwwwFFFwwwwwwAAAAAAAAAAAAAAAAAAwwwwwwwwwwwwwwwwwwwwwwwwwwwwwwwwwwwwwwwwwOO
OOwwAAAAAAAAAAAwwwwwwwwwwwwwwwwwwwwwwwwwwwwwwwwwwwwwwwwwwwwwwwwwwwwwwwFFFwwwwwwAAAAAAAAAAAAAAAAAAwwwwwwwwwwwwwwwwwwwwwwwwwwwwwwwwwwwwwwwwwOO
OOwwAAAAAAAAAAAwwwwwwwwwwwwwwwwwwwwwwwwwwwwwwwwwwwwwwwwwwwwwwwwwwwwwwwNNNNwwwwwAAAAAAAAAAAAAAAAAAwwwwwwwwwwwwwwwwwwwwwwwwwwwwwwwwwwwwwwwwwOO
OOwwAAAAAAAAAAAwwwwwwwwwwwwwwwwwwwwwwwwwwwwwwwwwwwwwwwwwwwwwwwwwwwwwwwwNNFFwwwwAAAAAAAAAAAAAAAAAAwwwwwwwwwwwwwwwwwwwwwwwwwwwwwwwwwwwwwwwwwOO
OOwwAAAAAAAAAAAwwwwwwwwwwwwwwwwwwwwwwwwwwwwwwwwwwwwwwwwwwwwwwwwwwwwwwwwNNFFwwwwAAAAAAAAAAAAAAAAAAwwwwwwwwwwwwwwwwwwwwwwwwwwwwwwwwwwwwwwwwwOO
OOwwAAAAAAAAAAAwwwwwwwwwwwwwwwwwwwwwwwwwwwwwwwwwwwwwwwwwwwwwwwwwwwwwwwwwNFFwwwwAAAAAAAAAAAAAAAAAAwwwwwwwwwwwwwwwwwwwwwwwwwwwwwwwwwwwwwwwwwOO
OOwwAAAAAAAAAAAwwwwwwwwwwwwwwwwwwwwwwwwwwwwwwwwwwwwwwwwwwwwwwwwwwwwwwwwwNFFwwwwAAAAAAAAAAAAAAAAAAwwwwwwwwwwwwwwwwwwwwwwwwwwwwwwwwwwwwwwwwwOO
OOwwAAAAAAAAAAAwwwwwwwwwwwwwwwwwwwwwwwwwwwwwwwwwwwwwwwwwwwwwwwwwwwwwwwwwwNNNNwwAAAAAAAAAAAAAAAAAAwwwwwwwwwwwwwwwwwwwwwwwwwwwwwwwwwwwwwwwwwOO
OOwwAAAAAAAAAAAwwwwwwwwwwwwwwwwwwwwwwwwwwwwwwwwwwwwwwwwwwwwwwwwwwwwwwwwwwNNFFwwwwwwwwwwwwwwwwwwwwwwwwwwwwwwwwwwwwwwwwwwwwwwwwwwwwwwwwwwwwwOO
OOwwAAAAAAAAAAAwwwwwwwwwwwwwwwwwwwwwwwwwwwwwwwwwwwwwwwwwwwwwwwwwwwwwwwwwwNNFFwwwwwwwwwwwwwwwwwwwwwwwwwwwwwwwwwwwwwwwwwwwwwwwwwwwwwwwwwwwwwOO
OOwwAAAAAAAAAAAAAAAAAAAAAAAAAAAAAAAAAAAAAAAAAAAAAwwwwwwwwwwwwwwwwwwwwwwwwwwFFwwwwwwwwwwwwwwwwwwwwwwwwwwwwwwwwwwwwwwwwwwwwwwwwwwwwwwwwwwwwwOO
OOwwAAAAAAAAAAAAAAAAAAAAAAAAAAAAAAAAAAAAAAAAAAAAAwwwwwwwwwwwwwwwwwwwwwwwwwwFFwwwwwwwwwwwwwwwwwwwwwwwwwwwwwwwwwwwwwwwwwwwwwwwwwwwwwwwwwwwwwOO
OOwwAAAAAAAAAAAAAAAAAAAAAAAAAAAAAAAAAAAAAAAAAAAAAwwwwwwwwwwwwwwwwwwwwwwwwwwNNNFwwwwwwwwwwwwwwwwwwwwwwwwwwwwwwwwwwwwwwwwwwwwwwwwwwwwwwwwwwwOO
OOwwAAAAAAAAAAAAAAAAAAAAAAAAAAAAAAAAAAAAAAAAAAAAAwwwwwwwwwwwwwwwwwwwwwwwwwwwwNFwwwwwwwwwwwwwwwwwwwwwwwwwwwwwwwwwwwwwwwwwwwwwwwwwwwwwwwwwwwOO
OOwwAAAAAAAAAAAAAAAAAAAAAAAAAAAAAAAAAAAAAAAAAAAAAwwwwwwwwwwwwwwwwwwwwwwwwwwwwFFNwwwwwwwwwwwwwwwwwwwwwwwwwwwwwwwwwwwwwwwwwwwwwwwwwwwwwwwwwwOO
OOwwAAAAAAAAAAAAAAAAAAAAAAAAAAAAAAAAAAAAAAAAAAAAAwwwwwwwwwwwwwwwwwwwwwwwwwwwwFFFwwwwwwwwwwwNNNNNNNwwwwwwwwwwwwwwwwwwwwwwwwwwwwwwwwwwwwwwwwOO
OOwwAAAAAAAAAAAAAAAAAAAAAAAAAAAAAAAAAAAAAAAAAAAAAwwwwwwwwwwwwwwwwwwwwwwwwwwwwrrrrrrrrrrrrrrrrrrrrrrrrrrrrrrrrrrrwwwwwwwwwwwwwwwwwwwwwwwwwwOO
OOwwAAAAAAAAAAAAAAAAAAAAAAAAAAAAAAAAAAAAAAAAAAAAAwwwwwwwwwwwwwwwwwwwwwwwwwwwwrrrrrrrrrrrrrrrrrrrrrrrrrrrrrrrrrrrwwwwwwwwwwwwwwwwwwwwwwwwwwOO
OOwwAAAAAAAAAAAAAAAAAAAAAAAAAAAAAAAAAAAAAAAAAAAAAAAAAAAAAAAAAAAAAAAwwwwwwwwwwrrrrrrrrrrrrrrrrrrrrrrrrrrrrrrrrrrrwwwwwwwwwwwwwwwwwwwwwwwwwwOO
OOwwAAAAAAAAAAAAAAAAAAAAAAAAAAAAAAAAAAAAAAAAAAAAAAAAAAAAAAAAAAAAAAAwwwwwwwwwwrrrrrrrrrrrrrrrrrrrrrrrrrrrrrrrrrrrwwwwwwwwwwwwwwwwwwwwwwwwwwOO
OOwwAAAAAAAAAAAAAAAAAAAAAAAAAAAAAAAAAAAAAAAAAAAAAAAAAAAAAAAAAAAAAAAwwwwwwwwwwrrrrrrrrrrrrrrrrrjrrrrrrrrrrrrrrrrrwwwwwwwwwwwwwwwwwwwwwwwwwwOO
OOwwAAAAAAAAAAAAAAAAAAAAAAAAAAAAAAAAAAAAAAAAAAAAAAAAAAAAAAAAAAAAAAAwwwwwwwwwwrrrrrrrrrrrrrrrrrrrrrrrrrrrrrrrrrrrwwwwwwwwwwwwwwwwwwwwwwwwwwOO
OOwwAAAAAAAAAAAAAAAAAAAAAAAAAAAAAAAAAAAAAAAAAAAAAAAAAAAAAAAAAAAAAAAwwwwwwwwwwrrrrrrrrrrrrrrrrrrrrrrrrrrrrrrrrrrrwwwwwwwwwwwwwwwwwwwwwwwwwwOO
OOwwAAAAAAAAAAAAAAAAAAAAAAAAAAAAAAAAAAAAAAAAAAAAAAAAAAAAAAAAAAAAAAAwwwwwwwwwwrrrrrrrrrrrrrrrrrrrrrrrrrrrrrrrrrrrwwwwwwwwwwwwwwwwwwwwwwwwwwOO
OOwwAAAAAAAAAAAAAAAAAAAAAAAAAAAAAAAAAAAAAAAAAAAAAAAAAAAAAAAAAAAAAAAwwwwwwwwwwrrrrrrrrrrrrrrrrrrrrrrrrrrrrrrrrrrrwwwwwwwwwwwwwwwwwwwwwwwwwwOO
OOwwAAAAAAAAAAAAAAAAAAAAAAAAAAAAAAAAAAAAAAAAAAAAAAAAAAAAAAAAAAAAAAAwwwwwwwwwwrrrrrrrrrrrrrrrrrrrrrrrrrrrrrrrrrrrNwwwwwwwwwwwwwwwwwwwwwwwwwOO
OOwwAAAAAAAAAAAAAAAAAAAAAAAAAAAAAAAAAAAAAAAAAAAAAAAAAAAAAAAAAAAAAAAwwwwwwwwwwrrrrrrrrrrrrrrrrrrrrrrrrrrrrrrrrrrrNNwwwwwwwwwwwwwwwwwwwwwwwwOO
OOwwAAAAAAAAAAAAAAAAAAAAAAAAAAAAAAAAAAAAAAAAAAAAAAAAAAAAAAAAAAAAAAAwwwwwwwwwwrrrrrrrrrrrrrrrrrrrrrrrrrrrrrrrrrrrwwwwwwwwwwwwwwwwwwwwwwwwwwOO
OOwwAAAAAAAAAAAAAAAAAAAAAAAAAAAAAAAAAAAAAAAAAAAAAAAAAAAAAAAAAAAAAAAwwwwwwwwwwrrrrrrrrrrrrrrrrrrrrrrrrrrrrrrrrrrrwwwwwwwwwwwwwwwwwwwwwwwwwwOO
OOwwAAAAAAAAAAAAAAAAAAAAAAAAAAAAAAAAAAAAAAAAAAAAAAAAAAAAAAAAAAAAAAAwwwwwwwwwwrrrrrrrrrrrrrrrrrrrrrrrrrrrrrrrrrrrwwwwwwwwwwwwwwwwwwwwwwwwwwOO
OOwwAAAAAAAAAAAAAAAAAAAAAAAAAAAAAAAAAAAAAAAAAAAAAAAAAAAAAAAAAAAAAAAwwwwwwwwwwrrrrrrrrrrrrrrrrrrrrrrrrrrrrrrrrrrrwwwwwwwwwwwwwwwwwwwwwwwwwwOO
OOwwAAAAAAAAAAAAAAAAAAAAAAAAAAAAAAAAAAAAAAAAAAAAAAAAAAAAAAAAAAAAAAAwwwwwwwwwwrrrrrrrrrrrrrrrrrrrrrrrrrrrrrrrrrrrwwwwwwwwwwwwwwwwwwwwwwwwwwOO
OOwwwwwwwwwwAAAAAAAAAAAAAAAAAAAAAAAAAAAAAAAAAAAAAAAAAAAAAAAAAAAAAAAwwwwwwwwwwrrrrrrrrrrrrrrrrrrrrrrrrrrrrrrrrrrrwwwwwwwwwwwwwwwwwwwwwwwwwwOO
OOwwwwwwwwwwAAAAAAAAAAAAAAAAAAAAAAAAAAAAAAAAAAAAAAAAAAAAAAAAAAAAAAAwwwwwwwwwwrrrrrrrrrrrrrrrrrrrrrrrrrrrrrrrrrrrwwwwwwwwwwwwwwwwwwwwwwwwwwOO
OOwwwwwwwwwwAAAAAAAAAAAAAAAAAAAAAAAAAAAAAAAAAAAAAAAAAAAAAAAAAAAAAAAwwwwwwwwwwrrrrrrrrrrrrrrrrrrrrrrrrrrrrrrrrrrrwwwwwwwwwwwwwwwwwwwwwwwwwwOO
OOwwwwwwwwwwAAAAAAAAAAAAAAAAAAAAAAAAAAAAAAAAAAAAAAAAAAAAAAAAAAAAAAAwwwwwwwwwwrrrrrrrrrrrrrrrrrrrrrrrrrrrrrrrrrrrwwwwwwwwwwwwwwwwwwwwwwwwwwOO
OOwwwwwwwwwwAAAAAAAAAAAAAAAAAAAAAAAAAAAAAAAAAAAAAAAAAAAAAAAAAAAAAAAwwwwwwwwwwrrrrrrrrrrrrrrrrrrrrrrrrrrrrrrrrrrrwwwwwwwwwwwwwwwwwwwwwwwwwwOO
OOwwwwwwwwwwAAAAAAAAAAAAAAAAAAAAAAAAAAAAAAAAAAAAAAAAAAAAAAAAAAAAAAAwwwwwwwwwwwwwwNNwwNNwwNNwwNNwNNNwNNwwwwwwwwwwwwwwwwwwwwwwwwwwwwwwwwwwwwOO
OOwwwwwwwwwwAAAAAAAAAAAAAAAAAAAAAAAAAAAAAAAAAAAAAAAAAAAAAAAAAAAAAAAwwwwwwwwwwwwwwwwwwNNwwwwwwwwwwwwwwwwwwwwwwwwwwwwwwwwwwwwwwwwwwwwwwwwwwwOO
OOwwwwwwwwwwAAAAAAAAAAAAAAAAAAAAAAAAAAAAAAAAAAAAAAAAAAAAAAAAAAAAAAAwwwwwwwwwwwwwwwwwwwwwwwwwwwwwwwwwwwwwwwwwwwwwwwwwwwwwwwwwwwwwwwwwwwwwwwOO
OOwwwwwwwwwwAAAAAAAAAAAAAAAAAAAAAAAAAAAAAAAAAAAAAAAAAAAAAAAAAAAAAAAwwwwwwwwwwwwwwwwwwwwwwwwwwwwwwwwwwwwwwwwwwwwwwwwwwwwwwwwwwwwwwwwwwwwwwwOO
OOwwwwwwwwwwAAAAAAAAAAAAAAAAAAAAAAAAAAAAAAAAAAAAAAAAAAAAAAAAAAAAAAAwwwwwwwwwwwwwwwwwwwwwwwwwwwwwwwwwwwwwwwwwwwwwwwwwwwwwwwwwwwwwwwwwwwwwwwOO
OOwwwwwwwwwwAAAAAAAAAAAAAAAAAAAAAAAAAAAAAAAAAAAAAAAAAAAAAAAAAAAAAAAwwwwwwwwwwwwwwwwwwwwwwwwwwwwwwwwwwwwwwwwwwwwwwwwwwwwwwwwwwwwwwwwwwwwwwwOO
OOwwwwwwwwwwAAAAAAAAAAAAAAAAAAAAAAAAAAAAAAAAAAAAAAAAAAAAAAAAAAAAAAAwwwwwwwwwwwwwwwwwwwwwwwwwwwwwwwwwwwwwwwwwwwwwwwwwwwwwwwwwwwwwwwwwwwwwwwOO
OOwwwwwwwwwwAAAAAAAAAAAAAAAAAAAAAAAAAAAAAAAAAAAAAAAAAAAAAAAAAAAAAAAAAAAAAAAAAAAAAAAAAAAAAAAAAAAAAAAAAAAAAAAAAAAAAAAAAAAAAAAAAwwwwwwwwwwwwwOO
OOwwwwwwwwwwAAAAAAAAAAAAAAAAAAAAAAAAAAAAAAAAAAAAAAAAAAAAAAAAAAAAAAAAAAAAAAAAAAAAAAAAAAAAAAAAAAAAAAAAAAAAAAAAAAAAAAAAAAAAAAAAAwwwwwwwwwwwwwOO
OOwwwwwwwwwwAAAAAAAAAAAAAAAAAAAAAAAAAAAAAAAAAAAAAwwwwwwwwwwwwwwwAAAAAAAAAAAAAAAAAAAAAAAAAAAAAAAAAAAAAAAAAAAAAAAAAAAAAAAAAAAAAwwwwwwwwwwwwwOO
OOwwwwwwwwwwAAAAAAAAAAAAAAAAAAAAAAAAAAAAAAAAAAAAAwwwwwwwwwwwwwwwAAAAAAAAAAAAAAAAAAAAAAAAAAAAAAAAAAAAAAAAAAAAAAAAAAAAAAAAAAAAAwwwwwwwwwwwwwOO
OOwwwwwwwwwwAAAAAAAAAAAAAAAAAAAAAAAAAAAAAAAAAAAAAwwwwwwwwwwwwwwwAAAAAAAAAAAAAAAAAAAAAAAAAAAAAAAAAAAAAAAAAAAAAAAAAAAAAAAAAAAAAwwwwwwwwwwwwwOO
OOwwwwwwwwwwwwwwwwwwwwwwwwwwwwwwwwwwwwwwwwwwwwwwwwwwwwwwwwwwwwwwAAAAAAAAAAAAAAAAAAAAAAAAAAAAAAAAAAAAAAAAAAAAAAAAAAAAAAAAAAAAAwwwwwwwwwwwwwOO
OOwwwwwwwwwwwwwwwwwwwwwwwwwwwwwwwwwwwwwwwwwwwwwwwwwwwwwwwwwwwwwwAAAAAAAAAAAAAAAAAAAAAAAAAAAAAAAAAAAAAAAAAAAAAAAAAAAAAAAAAAAAAwwwwwwwwwwwwwOO
OOwwwwwwwwwwwwwwwwwwwwwwwwwwwwwwwwwwwwwwwwwwwwwwwwwwwwwwwwwwwwwwAAAAAAAAAAAAAAAAAAAAAAAAAAAAAAAAAAAAAAAAAAAAAAAAAAAAAAAAAAAAAwwwwwwwwwwwwwOO
OOwwwwwwwwwwwwwwwwwwwwwwwwwwwwwwwwwwwwwwwwwwwwwwwwwwwwwwwwwwwwwwAAAAAAAAAAAAAAAAAAAAAAAAAAAAAAAAAAAAAAAAAAAAAAAAAAAAAAAAAAAAAwwwwwwwwwwwwwOO
OOwwwwwwwwwwwwwwwwwwwwwwwwwwwwwwwwwwwwwwwwwwwwwwwwwwwwwwwwwwwwwwAAAAAAAAAAAAAAAAAAAAAAAAAAAAAAAAAAAAAAAAAAAAAAAAAAAAAAAAAAAAAwwwwwwwwwwwwwOO
OOwwwwwwwwwwwwwwwwwwwwwwwwwwwwwwwwwwwwwwwwwwwwwwwwwwwwwwwwwwwwwwAAAAAAAAAAAAAAAAAAAAAAAAAAAAAAAAAAAAAAAAAAAAAAAAAAAAAAAAAAAAAwwwwwwwwwwwwwOO
OOwwwwwwwwwwwwwwwwwwwwwwwwwwwwwwwwwwwwwwwwwwwwwwwwwwwwwwwwwwwwwwwwwwwwwwwwwwwwwwwwwwwwwwwwwwwwwwwwwwwwwwwwwwwwwwwwwwwwwwwwwwwwwwwwwwwwwwwwOO
OOwwwwwwwwwwwwwwwwwwwwwwwwwwwwwwwwwwwwwwwwwwwwwwwwwwwwwwwwwwwwwwwwwwwwwwwwwwwwwwwwwwwwwwwwwwwwwwwwwwwwwwwwwwwwwwwwwwwwwwwwwwwwwwwwwwwwwwwwOO
OOwwwwwwwwwwwwwwwwwwwwwwwwwwwwwwwwwwwwwwwwwwwwwwwwwwwwwwwwwwwwwwwwwwwwwwwwwwwwwwwwwwwwwwwwwwwwwwwwwwwwwwwwwwwwwwwwwwwwwwwwwwwwwwwwwwwwwwwwOO
OOwwwwwwwwwwwwwwwwwwwwwwwwwwwwwwwwwwwwwwwwwwwwwwwwwwwwwwwwwwwwwwwwwwwwwwwwwwwwwwwwwwwwwwwwwwwwwwwwwwwwwwwwwwwwwwwwwwwwwwwwwwwwwwwwwwwwwwwwOO
OfOOOOOOOOOOOOOOOOOOOOOOOOOOOOOOOOOOOOOOOOOOOOOOOOOOOOOOOOOOOOOOOOOOOOOOOOOOOOOOOOOOOOOOOOOOOOOOOOOOOOOOOOOOOOOOOOOOOOOOOOOOOOOOOOOOOOOOOOOO
aOOOOOOOOOOOOOOOOOOOOOOOOOOOOOOOOOOOOOOOOOOOOOOOOOOOOOOOOOOOOOOOOOOOOOOOOOOOOOOOOOOOOOOOOOOOOOOOOOOOOOOOOOOOOOOOOOOOOOOOOOOOOOOOOOOOOOOOOOOO
"}
