//MAP CONVERTED BY dmm2tgm.py THIS HEADER COMMENT PREVENTS RECONVERSION, DO NOT REMOVE
"a" = (
/turf/space,
/area/space)
"g" = (
/turf/simulated/shuttle/wall/voidcraft/survival,
/area/space)
"L" = (
/turf/simulated/shuttle/floor/voidcraft/dark,
/area/space)

(1,1,1) = {"
a
a
a
a
a
a
a
a
a
a
a
a
"}
(2,1,1) = {"
a
a
a
g
g
g
g
g
g
g
g
a
"}
(3,1,1) = {"
a
a
a
g
L
L
L
L
L
L
g
a
"}
(4,1,1) = {"
a
a
a
g
L
L
L
L
L
L
g
a
"}
(5,1,1) = {"
a
a
a
g
L
L
L
L
L
L
g
a
"}
(6,1,1) = {"
a
a
a
g
L
L
L
L
L
L
g
a
"}
(7,1,1) = {"
a
a
a
g
L
L
L
L
L
L
g
a
"}
(8,1,1) = {"
a
a
a
g
L
L
L
L
L
L
g
a
"}
(9,1,1) = {"
a
a
a
g
g
g
g
g
g
g
g
a
"}
(10,1,1) = {"
a
a
a
a
a
a
a
a
a
a
a
a
"}
(11,1,1) = {"
a
a
a
a
a
a
a
a
a
a
a
a
"}
(12,1,1) = {"
a
a
a
a
a
a
a
a
a
a
a
a
"}
