//MAP CONVERTED BY dmm2tgm.py THIS HEADER COMMENT PREVENTS RECONVERSION, DO NOT REMOVE
"au" = (
/obj/structure/table/rack/shelf/steel,
/obj/item/clothing/suit/storage/hazardvest,
/obj/item/clothing/suit/storage/hazardvest,
/obj/item/clothing/head/hardhat/orange,
/obj/item/clothing/head/hardhat/orange,
/turf/simulated/floor/tiled/monotile/indoors,
/area/submap/generic/inside_breath_mix)
"ca" = (
/obj/structure/fence/corner{
	dir = 9
	},
/turf/simulated/floor/concrete/tile/outdoors,
/area/submap/generic/outside_open_air)
"cX" = (
/obj/effect/floor_decal/industrial/danger/corner,
/turf/simulated/floor/concrete/tile/outdoors,
/area/submap/generic/outside_open_air)
"dl" = (
/obj/structure/urinal,
/turf/simulated/floor/plating/indoors,
/area/submap/generic/inside_breath_mix)
"ey" = (
/turf/simulated/wall,
/area/submap/generic/inside_breath_mix)
"eV" = (
/obj/machinery/door/blast/shutters{
	dir = 2
	},
/obj/effect/catwalk_plated/dark,
/obj/structure/fans/tiny,
/turf/simulated/floor/concrete/indoors,
/area/submap/generic/inside_breath_mix)
"fi" = (
/obj/structure/fence/end{
	dir = 4
	},
/turf/simulated/floor/concrete/tile/outdoors,
/area/submap/generic/outside_open_air)
"fm" = (
/turf/simulated/floor/concrete/tile/outdoors,
/area/submap/generic/outside_open_air)
"fY" = (
/obj/structure/largecrate,
/turf/simulated/floor/concrete/indoors,
/area/submap/generic/inside_breath_mix)
"go" = (
/obj/structure/fans/tiny,
/turf/simulated/floor/tiled/monotile/indoors,
/area/submap/generic/inside_breath_mix)
"gG" = (
/obj/effect/floor_decal/industrial/danger{
	dir = 1
	},
/turf/simulated/floor/concrete/tile/outdoors,
/area/submap/generic/outside_open_air)
"gT" = (
/obj/effect/floor_decal/industrial/danger,
/obj/effect/floor_decal/industrial/danger{
	dir = 1
	},
/turf/simulated/floor/concrete/tile/outdoors,
/area/submap/generic/outside_open_air)
"gZ" = (
/obj/structure/table/steel_reinforced,
/obj/item/paper_bin,
/turf/simulated/floor/tiled/monotile/indoors,
/area/submap/generic/inside_breath_mix)
"hO" = (
/obj/machinery/papershredder,
/turf/simulated/floor/tiled/monotile/indoors,
/area/submap/generic/inside_breath_mix)
"iz" = (
/obj/structure/railing,
/obj/structure/table/rack/shelf/steel,
/turf/simulated/floor/concrete/indoors,
/area/submap/generic/inside_breath_mix)
"ku" = (
/obj/effect/debris/cleanable/blood/oil,
/turf/simulated/floor/concrete/outdoors,
/area/submap/generic/outside_open_air)
"lg" = (
/turf/simulated/floor/concrete/outdoors,
/area/submap/generic/inside_breath_mix)
"lx" = (
/obj/effect/floor_decal/industrial/danger{
	dir = 4
	},
/turf/simulated/floor/concrete/indoors,
/area/submap/generic/inside_breath_mix)
"ml" = (
/turf/simulated/floor/tiled/monotile/indoors,
/area/submap/generic/inside_breath_mix)
"mp" = (
/obj/effect/floor_decal/industrial/danger/corner{
	dir = 4
	},
/turf/simulated/floor/concrete/tile/outdoors,
/area/submap/generic/outside_open_air)
"mP" = (
/turf/simulated/wall,
/area/submap/generic/outside_open_air)
"mY" = (
/obj/effect/floor_decal/industrial/danger{
	dir = 4
	},
/turf/simulated/floor/concrete/outdoors,
/area/submap/generic/outside_open_air)
"nD" = (
/obj/effect/floor_decal/industrial/halfstair{
	dir = 8
	},
/obj/effect/floor_decal/industrial/danger{
	dir = 8
	},
/turf/simulated/floor/plating/indoors,
/area/submap/generic/inside_breath_mix)
"oX" = (
/obj/effect/catwalk_plated/dark,
/turf/simulated/floor/plating/indoors,
/area/submap/generic/inside_breath_mix)
"pM" = (
/obj/item/paper/pamphlet/violent_video_games,
/obj/item/paper/pamphlet/vacation,
/obj/structure/noticeboard{
	pixel_y = 32
	},
/turf/simulated/floor/tiled/monotile/indoors,
/area/submap/generic/inside_breath_mix)
"pQ" = (
/obj/structure/fence/door/locked{
	dir = 8
	},
/turf/simulated/floor/concrete/outdoors,
/area/submap/generic/outside_open_air)
"pW" = (
/obj/machinery/door/airlock,
/obj/effect/catwalk_plated/dark,
/obj/structure/fans/tiny,
/turf/simulated/floor/plating/indoors,
/area/submap/generic/inside_breath_mix)
"qg" = (
/obj/structure/ore_box,
/turf/simulated/floor/concrete/indoors,
/area/submap/generic/inside_breath_mix)
"qI" = (
/obj/structure/toilet,
/turf/simulated/floor/plating/indoors,
/area/submap/generic/inside_breath_mix)
"qW" = (
/obj/machinery/door/airlock/maintenance_hatch,
/turf/simulated/floor/tiled/monotile/indoors,
/area/submap/generic/inside_breath_mix)
"rI" = (
/obj/random/crate,
/obj/effect/floor_decal/industrial/danger{
	dir = 1
	},
/turf/simulated/floor/concrete/indoors,
/area/submap/generic/inside_breath_mix)
"sM" = (
/obj/structure/fence,
/turf/simulated/floor/concrete/tile/outdoors,
/area/submap/generic/outside_open_air)
"sN" = (
/obj/effect/floor_decal/industrial/danger/corner{
	dir = 8
	},
/turf/simulated/floor/concrete/tile/outdoors,
/area/submap/generic/outside_open_air)
"tb" = (
/obj/structure/fence/corner{
	dir = 1
	},
/turf/simulated/floor/concrete/tile/outdoors,
/area/submap/generic/outside_open_air)
"va" = (
/obj/effect/floor_decal/industrial/danger{
	dir = 4
	},
/turf/simulated/floor/concrete/tile/outdoors,
/area/submap/generic/outside_open_air)
"vS" = (
/obj/spawner/window/reinforced/full,
/turf/simulated/floor/plating/indoors,
/area/submap/generic/inside_breath_mix)
"wq" = (
/obj/structure/table/rack/shelf/steel,
/turf/simulated/floor/concrete/indoors,
/area/submap/generic/inside_breath_mix)
"wT" = (
/obj/effect/floor_decal/industrial/danger{
	dir = 8
	},
/turf/simulated/floor/concrete/tile/outdoors,
/area/submap/generic/outside_open_air)
"xx" = (
/obj/machinery/door/airlock/maintenance/common,
/turf/simulated/floor/plating/indoors,
/area/submap/generic/inside_breath_mix)
"zT" = (
/obj/structure/railing,
/turf/simulated/floor/concrete/indoors,
/area/submap/generic/inside_breath_mix)
"AU" = (
/obj/effect/floor_decal/industrial/danger{
	dir = 5
	},
/turf/simulated/floor/concrete/indoors,
/area/submap/generic/inside_breath_mix)
"CG" = (
/obj/effect/floor_decal/industrial/danger{
	dir = 1
	},
/turf/simulated/floor/concrete/indoors,
/area/submap/generic/inside_breath_mix)
"Ec" = (
/turf/simulated/floor/concrete/indoors,
/area/submap/generic/inside_breath_mix)
"EF" = (
/obj/structure/table/steel_reinforced,
/obj/item/hand_labeler,
/obj/item/hand_labeler,
/obj/item/hand_labeler,
/obj/item/wrapping_paper,
/obj/item/wrapping_paper,
/turf/simulated/floor/tiled/monotile/indoors,
/area/submap/generic/inside_breath_mix)
"Fp" = (
/obj/structure/fence/corner{
	dir = 6
	},
/turf/simulated/floor/concrete/tile/outdoors,
/area/submap/generic/outside_open_air)
"GA" = (
/obj/structure/sign/poi/engineleft,
/turf/simulated/floor/concrete/outdoors,
/area/submap/generic/outside_open_air)
"GH" = (
/obj/effect/floor_decal/industrial/danger/corner{
	dir = 1
	},
/turf/simulated/floor/concrete/tile/outdoors,
/area/submap/generic/outside_open_air)
"Ib" = (
/obj/structure/fence/corner{
	dir = 4
	},
/turf/simulated/floor/concrete/tile/outdoors,
/area/submap/generic/outside_open_air)
"IU" = (
/obj/machinery/door/airlock,
/turf/simulated/floor/tiled/monotile/indoors,
/area/submap/generic/inside_breath_mix)
"Ki" = (
/obj/machinery/door/airlock/maintenance_hatch,
/turf/simulated/floor/plating/indoors,
/area/submap/generic/inside_breath_mix)
"Kq" = (
/obj/effect/catwalk_plated/dark,
/obj/structure/fans/tiny,
/obj/machinery/door/airlock,
/turf/simulated/floor/plating/indoors,
/area/submap/generic/inside_breath_mix)
"KL" = (
/obj/structure/grille/rustic,
/turf/simulated/floor/concrete/outdoors,
/area/submap/generic/outside_open_air)
"Li" = (
/obj/structure/fence/end{
	dir = 8
	},
/turf/simulated/floor/concrete/tile/outdoors,
/area/submap/generic/outside_open_air)
"Nj" = (
/obj/effect/floor_decal/industrial/danger{
	dir = 4
	},
/obj/structure/ore_box,
/turf/simulated/floor/concrete/indoors,
/area/submap/generic/inside_breath_mix)
"Po" = (
/obj/effect/floor_decal/industrial/danger,
/turf/simulated/floor/concrete/tile/outdoors,
/area/submap/generic/outside_open_air)
"Qf" = (
/obj/structure/safe,
/turf/simulated/floor/plating/indoors,
/area/submap/generic/inside_breath_mix)
"Rc" = (
/turf/simulated/floor/concrete/tile/outdoors,
/area/submap/generic/inside_breath_mix)
"Sz" = (
/obj/structure/fence{
	dir = 4
	},
/turf/simulated/floor/concrete/tile/outdoors,
/area/submap/generic/outside_open_air)
"SW" = (
/obj/random/crate,
/obj/effect/floor_decal/industrial/danger{
	dir = 4
	},
/turf/simulated/floor/concrete/indoors,
/area/submap/generic/inside_breath_mix)
"Tu" = (
/turf/simulated/floor/plating/indoors,
/area/submap/generic/inside_breath_mix)
"VH" = (
/obj/effect/floor_decal/industrial/halfstair,
/turf/simulated/floor/plating/indoors,
/area/submap/generic/inside_breath_mix)
"Xz" = (
/turf/simulated/floor/concrete/outdoors,
/area/submap/generic/outside_open_air)
"XU" = (
/turf/simulated/floor/carpet,
/area/submap/generic/inside_breath_mix)
"Yc" = (
/obj/structure/largecrate,
/obj/effect/floor_decal/industrial/danger{
	dir = 4
	},
/turf/simulated/floor/concrete/indoors,
/area/submap/generic/inside_breath_mix)
"ZE" = (
/obj/random/crate,
/turf/simulated/floor/concrete/indoors,
/area/submap/generic/inside_breath_mix)

(1,1,1) = {"
ca
sM
sM
sM
sM
sM
sM
sM
sM
sM
sM
sM
sM
sM
sM
sM
sM
sM
sM
sM
sM
sM
sM
sM
sM
sM
sM
sM
sM
sM
sM
sM
sM
sM
sM
sM
sM
sM
sM
tb
"}
(2,1,1) = {"
Sz
Xz
Xz
Xz
Xz
Xz
Xz
Xz
Xz
Xz
Xz
Xz
Xz
Xz
Xz
Xz
Xz
Xz
Xz
Xz
Xz
Xz
Xz
Xz
Xz
Xz
Xz
Xz
Xz
KL
KL
KL
KL
Xz
Xz
Xz
Xz
Xz
Xz
Sz
"}
(3,1,1) = {"
Sz
Xz
Xz
Xz
Xz
Xz
Xz
Xz
Xz
Xz
Xz
Xz
Xz
Xz
Xz
Xz
Xz
Xz
Xz
Xz
Xz
Xz
Xz
Xz
Xz
Xz
Xz
Xz
Xz
Xz
Xz
Xz
Xz
Xz
Xz
Xz
Xz
Xz
Xz
Sz
"}
(4,1,1) = {"
Sz
Xz
Xz
ey
ey
ey
ey
ey
ey
ey
ey
ey
ey
ey
ey
ey
ey
ey
ey
ey
mP
mP
mP
mP
mP
mP
mP
mP
mP
fm
Xz
Xz
Xz
Xz
Xz
Xz
Xz
Xz
Xz
Sz
"}
(5,1,1) = {"
Sz
Xz
Xz
ey
wq
wq
wq
wq
wq
wq
iz
rI
ZE
ZE
fY
ZE
fY
fY
fY
ey
Po
Xz
ku
gT
Xz
Xz
gG
fm
mP
fm
Xz
Xz
Xz
Xz
Xz
Xz
Xz
Xz
Xz
Sz
"}
(6,1,1) = {"
Sz
Xz
Xz
ey
Ec
Ec
Ec
Ec
Ec
Ec
zT
CG
qg
Ec
qg
ZE
fY
ZE
fY
ey
Po
Xz
GA
gT
Xz
Xz
gG
fm
Li
fm
Xz
Xz
Xz
Xz
Xz
Xz
Xz
Xz
Xz
Li
"}
(7,1,1) = {"
Sz
Xz
Xz
ey
Ec
wq
wq
wq
wq
Ec
zT
AU
lx
lx
lx
lx
Nj
SW
Yc
ey
fm
Xz
Xz
Xz
Xz
Xz
Xz
Xz
Xz
Xz
Xz
Xz
Xz
Xz
Xz
Xz
Xz
Xz
Xz
Xz
"}
(8,1,1) = {"
Sz
Xz
Xz
ey
Ec
Ec
Ec
Ec
Ec
Ec
Ec
Ec
Ec
Ec
Ec
Ec
Ec
Ec
Ec
eV
Xz
Xz
Xz
Xz
Xz
Xz
Xz
Xz
Xz
Xz
Xz
Xz
Xz
Xz
Xz
Xz
Xz
Xz
Xz
Xz
"}
(9,1,1) = {"
Sz
Xz
Xz
ey
Ec
Ec
Ec
Ec
Ec
Ec
Ec
Ec
Ec
Ec
Ec
Ec
Ec
Ec
Ec
eV
Xz
Xz
Xz
Xz
Xz
Xz
Xz
Xz
Xz
Xz
Xz
Xz
Xz
Xz
Xz
Xz
Xz
Xz
Xz
Xz
"}
(10,1,1) = {"
Sz
Xz
Xz
ey
Ec
wq
wq
wq
wq
Ec
Ec
ey
nD
ey
ey
ey
vS
vS
ey
ey
fm
Xz
Xz
Xz
Xz
Xz
Xz
Xz
Xz
Xz
Xz
Xz
Xz
Xz
Xz
Xz
Xz
Xz
Xz
Xz
"}
(11,1,1) = {"
Sz
Xz
Xz
ey
Ec
Ec
Ec
Ec
Ec
Ec
Ec
ey
IU
ey
au
au
ml
ml
Kq
VH
Po
Xz
Xz
gT
Xz
Xz
gG
fm
fi
fm
Xz
Xz
Xz
Xz
Xz
Xz
Xz
Xz
Xz
fi
"}
(12,1,1) = {"
Sz
Xz
Xz
ey
wq
wq
wq
Ec
wq
wq
wq
ey
ml
ml
ml
ml
ml
ml
ey
ey
Po
Xz
Xz
gT
Xz
ku
gG
fm
mP
fm
Xz
Xz
Xz
Xz
Xz
Xz
Xz
Xz
Xz
Sz
"}
(13,1,1) = {"
Sz
Xz
Xz
ey
ey
ey
ey
Ki
ey
ey
ey
ey
pM
ml
ml
ml
ml
ml
EF
ey
ey
ey
ey
ey
ey
ey
ey
ey
ey
fm
Xz
Xz
Xz
Xz
Xz
Xz
Xz
Xz
Xz
Sz
"}
(14,1,1) = {"
Sz
Xz
Xz
ey
oX
oX
oX
oX
oX
oX
oX
ey
ml
ml
ml
ml
ml
go
gZ
ey
qI
Tu
Tu
Tu
Tu
Tu
Tu
Tu
ey
fm
Xz
Xz
Xz
Xz
Xz
Xz
Xz
Xz
Xz
Sz
"}
(15,1,1) = {"
Sz
Xz
Xz
ey
oX
ey
ey
ey
ey
ey
oX
ey
ml
ml
ml
ml
ml
ml
hO
ey
dl
Tu
Tu
Tu
Tu
Tu
Tu
Tu
ey
fm
Xz
Xz
Xz
Xz
Xz
Xz
Xz
Xz
Xz
Sz
"}
(16,1,1) = {"
Sz
Xz
Xz
ey
oX
ey
Tu
Tu
Tu
ey
oX
ey
ey
ey
qW
qW
ey
ey
ey
ey
oX
oX
Tu
Tu
Tu
Tu
Tu
Tu
ey
fm
Xz
Xz
Xz
Xz
Xz
Xz
Xz
Xz
Xz
Sz
"}
(17,1,1) = {"
Sz
Xz
Xz
ey
oX
ey
Tu
Tu
Tu
xx
oX
oX
oX
oX
oX
oX
oX
oX
oX
oX
oX
oX
Tu
Tu
Tu
Tu
Tu
Tu
ey
fm
Xz
Xz
Xz
Xz
Xz
Xz
Xz
Xz
Xz
Sz
"}
(18,1,1) = {"
Sz
Xz
Xz
ey
oX
ey
Tu
Tu
Tu
ey
ey
ey
ey
ey
oX
oX
ey
ey
ey
ey
oX
oX
Tu
Tu
Tu
Tu
Tu
Tu
ey
fm
Xz
Xz
Xz
Xz
Xz
Xz
Xz
Xz
Xz
Sz
"}
(19,1,1) = {"
Sz
Xz
Xz
ey
oX
ey
Tu
Tu
Tu
Tu
Tu
Tu
Tu
ey
qW
qW
ey
Tu
Tu
Tu
Tu
Tu
Tu
Tu
Tu
Tu
Tu
Tu
ey
fm
Xz
Xz
Xz
Xz
Xz
Xz
Xz
Xz
Xz
Sz
"}
(20,1,1) = {"
Sz
Xz
Xz
ey
oX
ey
Tu
Tu
Tu
Tu
Tu
Tu
Tu
Tu
Tu
Tu
Tu
Tu
Tu
Tu
Tu
Tu
Tu
Tu
Tu
Tu
Tu
Tu
ey
sM
sM
sM
pQ
pQ
sM
sM
tb
Xz
Xz
Sz
"}
(21,1,1) = {"
Sz
Xz
Xz
ey
Tu
Tu
Tu
Tu
Tu
Tu
Tu
Tu
Tu
Tu
Tu
Tu
Tu
Tu
Tu
Tu
Tu
Tu
Tu
Tu
Tu
Tu
Tu
Tu
ey
cX
va
va
mY
mY
va
mp
Sz
Xz
Xz
Sz
"}
(22,1,1) = {"
Sz
Xz
Xz
ey
Tu
Tu
Tu
Tu
Tu
Tu
Tu
Tu
Tu
Tu
Tu
Tu
Tu
Tu
Tu
Tu
Tu
Tu
Tu
Tu
Tu
Tu
Tu
Tu
ey
Po
Xz
Xz
Xz
Xz
Xz
gG
Sz
Xz
Xz
Sz
"}
(23,1,1) = {"
Sz
Xz
Xz
ey
Tu
Tu
Tu
Tu
Tu
Tu
Tu
Tu
Tu
Tu
Tu
Tu
Tu
Tu
Tu
Tu
Tu
Tu
Tu
Tu
Tu
Tu
Tu
Tu
ey
Po
Xz
Xz
Xz
Xz
Xz
gG
Sz
Xz
Xz
Sz
"}
(24,1,1) = {"
Sz
Xz
Xz
ey
Tu
Tu
Tu
Tu
Tu
Tu
Tu
Tu
Tu
Tu
Tu
Tu
Tu
Tu
Tu
Tu
Tu
Tu
Tu
Tu
Tu
Tu
Tu
Tu
ey
Po
Xz
Xz
Xz
Xz
Xz
gG
Sz
Xz
Xz
Sz
"}
(25,1,1) = {"
Sz
Xz
Xz
ey
Tu
Tu
Tu
Tu
Tu
Tu
Tu
Tu
Tu
ml
ml
ml
ml
Tu
Tu
Tu
Tu
Tu
Tu
Tu
Tu
ey
ey
ey
ey
Po
Xz
Xz
Xz
Xz
Xz
gG
Sz
Xz
Xz
Sz
"}
(26,1,1) = {"
Sz
Xz
Xz
ey
Tu
Tu
Tu
Tu
Tu
Tu
Tu
Tu
Tu
ml
XU
XU
ml
Tu
Tu
Tu
Tu
Tu
Tu
Tu
Tu
ey
Rc
Rc
Rc
Po
Xz
Xz
Xz
Xz
Xz
gG
Sz
Xz
Xz
Sz
"}
(27,1,1) = {"
Sz
Xz
Xz
ey
Tu
Tu
Tu
Tu
Tu
Tu
Tu
Tu
Tu
ml
XU
XU
ml
Tu
Tu
Tu
Tu
Tu
Tu
Tu
Tu
ey
lg
lg
Rc
Po
Xz
Xz
Xz
Xz
Xz
gG
Sz
Xz
Xz
Sz
"}
(28,1,1) = {"
Sz
Xz
Xz
ey
Tu
Tu
Tu
Tu
Tu
Tu
Tu
Tu
Tu
ml
XU
XU
ml
Tu
Tu
Tu
Tu
Tu
Tu
Tu
Tu
pW
lg
lg
lg
Po
Xz
Xz
Xz
Xz
Xz
gG
Sz
Xz
Xz
Sz
"}
(29,1,1) = {"
Sz
Xz
Xz
ey
Tu
Tu
Tu
Tu
Tu
Tu
Tu
Tu
Tu
ml
XU
XU
ml
Tu
Tu
Tu
Tu
Tu
Tu
Tu
Tu
ey
lg
lg
lg
Po
Xz
Xz
Xz
Xz
Xz
gG
Sz
Xz
Xz
Sz
"}
(30,1,1) = {"
Sz
Xz
Xz
ey
Tu
Tu
Tu
Tu
Tu
Tu
Tu
Tu
Tu
ml
XU
XU
ml
Tu
Tu
Tu
Tu
Tu
Tu
Tu
Tu
pW
lg
lg
lg
Po
Xz
Xz
Xz
Xz
Xz
gG
Sz
Xz
Xz
Sz
"}
(31,1,1) = {"
Sz
Xz
Xz
ey
Tu
Tu
Tu
Tu
Tu
Tu
Tu
Tu
Tu
ml
XU
XU
ml
Tu
Tu
Tu
Tu
Tu
Tu
Tu
Tu
ey
lg
lg
Rc
Po
Xz
Xz
Xz
Xz
Xz
gG
Sz
Xz
Xz
Sz
"}
(32,1,1) = {"
Sz
Xz
Xz
ey
Qf
Qf
Qf
Qf
Qf
Tu
Tu
Tu
Tu
ml
XU
XU
ml
Tu
Tu
Tu
Tu
Tu
Tu
Tu
Tu
ey
Rc
Rc
Rc
Po
Xz
Xz
Xz
Xz
Xz
gG
Sz
Xz
Xz
Sz
"}
(33,1,1) = {"
Sz
Xz
Xz
ey
Qf
Qf
Qf
Qf
Qf
Tu
Tu
Tu
Tu
ml
XU
XU
ml
Tu
Tu
Tu
Tu
Tu
Tu
Tu
Tu
ey
ey
ey
ey
Po
Xz
Xz
Xz
Xz
Xz
gG
Sz
Xz
Xz
Sz
"}
(34,1,1) = {"
Sz
Xz
Xz
ey
Qf
Qf
Qf
Qf
Qf
Tu
Tu
Tu
Tu
ml
XU
XU
ml
Tu
Tu
Tu
Tu
Tu
Tu
Tu
Tu
Tu
Tu
Tu
ey
Po
Xz
Xz
Xz
Xz
Xz
gG
Sz
Xz
Xz
Sz
"}
(35,1,1) = {"
Sz
Xz
Xz
ey
Qf
Qf
Qf
Qf
Qf
Tu
Tu
Tu
Tu
ml
XU
XU
ml
Tu
Tu
Tu
Tu
Tu
Tu
Tu
Tu
Tu
Tu
Tu
ey
Po
Xz
Xz
Xz
Xz
Xz
gG
Sz
Xz
Xz
Sz
"}
(36,1,1) = {"
Sz
Xz
Xz
ey
Qf
Qf
Qf
Qf
Qf
Tu
Tu
Tu
Tu
ml
ml
ml
ml
Tu
Tu
Tu
Tu
Tu
Tu
Tu
Tu
Tu
Tu
Tu
ey
GH
wT
wT
wT
wT
wT
sN
Sz
Xz
Xz
Sz
"}
(37,1,1) = {"
Sz
Xz
Xz
ey
ey
ey
ey
ey
ey
ey
ey
ey
ey
ey
ey
ey
ey
ey
ey
ey
ey
ey
ey
ey
ey
ey
ey
ey
ey
sM
sM
sM
sM
sM
sM
sM
Fp
Xz
Xz
Sz
"}
(38,1,1) = {"
Sz
Xz
Xz
Xz
Xz
Xz
Xz
Xz
Xz
Xz
Xz
Xz
Xz
Xz
Xz
Xz
Xz
Xz
Xz
Xz
Xz
Xz
Xz
Xz
Xz
Xz
Xz
Xz
Xz
Xz
Xz
Xz
Xz
Xz
Xz
Xz
Xz
Xz
Xz
Sz
"}
(39,1,1) = {"
Sz
Xz
Xz
Xz
Xz
Xz
Xz
Xz
Xz
Xz
Xz
Xz
Xz
Xz
Xz
Xz
Xz
Xz
Xz
Xz
Xz
Xz
Xz
Xz
Xz
Xz
Xz
Xz
Xz
Xz
Xz
Xz
Xz
Xz
Xz
Xz
Xz
Xz
Xz
Sz
"}
(40,1,1) = {"
Ib
sM
sM
sM
sM
sM
sM
sM
sM
sM
sM
sM
sM
sM
sM
sM
sM
sM
sM
sM
sM
sM
sM
sM
sM
sM
sM
sM
sM
sM
sM
sM
sM
sM
sM
sM
sM
sM
sM
Fp
"}
