//MAP CONVERTED BY dmm2tgm.py THIS HEADER COMMENT PREVENTS RECONVERSION, DO NOT REMOVE
"a" = (
/turf/simulated/floor/tiled/default,
/area/space)
"F" = (
/turf/template_noop,
/area/space)
"L" = (
/obj/machinery/atmospherics/component/unary/engine/bigger{
	dir = 8
	},
/turf/template_noop,
/area/space)
"P" = (
/turf/simulated/floor/tiled/outdoors,
/area/space)
"T" = (
/turf/simulated/wall/rshull,
/area/space)
"Y" = (
/turf/simulated/floor/plating/outdoors,
/area/space)

(1,1,1) = {"
F
F
F
F
F
F
F
F
F
F
F
F
F
F
F
F
F
F
F
F
"}
(2,1,1) = {"
F
F
F
F
F
F
F
F
T
T
T
T
F
F
F
F
F
F
F
F
"}
(3,1,1) = {"
F
F
F
F
F
F
F
T
T
a
a
T
T
F
F
F
F
F
F
F
"}
(4,1,1) = {"
F
F
F
F
F
F
F
T
a
a
a
a
T
F
F
F
F
F
F
F
"}
(5,1,1) = {"
F
F
F
F
F
F
F
T
a
a
a
a
T
F
F
F
F
F
F
F
"}
(6,1,1) = {"
F
F
F
F
T
T
T
T
a
a
a
a
T
T
T
T
F
F
F
F
"}
(7,1,1) = {"
F
F
F
F
T
a
a
a
a
a
a
a
a
a
a
T
F
F
F
F
"}
(8,1,1) = {"
F
F
F
T
T
a
a
T
T
T
T
T
T
a
a
T
T
F
F
F
"}
(9,1,1) = {"
F
F
F
T
a
a
a
a
a
a
a
a
a
a
a
a
T
F
F
F
"}
(10,1,1) = {"
F
F
F
T
a
a
a
a
a
a
a
a
a
a
a
a
T
F
F
F
"}
(11,1,1) = {"
F
F
F
T
a
a
a
a
a
a
a
a
a
a
a
a
T
F
F
F
"}
(12,1,1) = {"
F
F
T
T
a
a
a
a
a
a
a
a
a
a
a
a
T
T
F
F
"}
(13,1,1) = {"
F
T
T
a
a
a
a
a
a
Y
a
a
a
a
a
a
a
T
T
F
"}
(14,1,1) = {"
T
T
a
a
a
a
a
a
a
a
a
a
a
a
a
a
a
a
T
T
"}
(15,1,1) = {"
T
a
a
a
a
a
a
a
a
a
a
a
a
a
a
a
a
a
a
T
"}
(16,1,1) = {"
T
a
a
a
a
a
a
a
a
a
a
a
a
a
a
a
a
a
a
T
"}
(17,1,1) = {"
T
T
T
T
T
a
a
a
a
a
a
a
a
a
a
T
T
T
T
T
"}
(18,1,1) = {"
F
L
F
L
T
a
a
a
a
a
a
a
a
a
a
T
F
L
F
L
"}
(19,1,1) = {"
F
F
F
F
T
a
a
a
a
a
a
a
a
a
a
T
F
F
F
F
"}
(20,1,1) = {"
F
F
F
F
T
T
T
a
a
a
a
a
a
T
T
T
F
F
F
F
"}
(21,1,1) = {"
F
F
F
F
F
L
T
a
a
a
a
a
a
T
F
L
F
F
F
F
"}
(22,1,1) = {"
F
F
F
F
F
F
T
a
a
a
a
a
a
T
F
F
F
F
F
F
"}
(23,1,1) = {"
F
F
F
F
F
F
T
T
T
a
a
T
T
T
F
F
F
F
F
F
"}
(24,1,1) = {"
F
F
F
F
F
F
F
L
T
a
a
T
F
L
F
F
F
F
F
F
"}
(25,1,1) = {"
F
F
F
F
F
F
F
F
T
a
a
T
F
F
F
F
F
F
F
F
"}
(26,1,1) = {"
F
P
F
F
F
F
F
F
T
a
a
T
F
F
F
F
F
F
F
F
"}
(27,1,1) = {"
F
F
F
F
F
F
F
F
F
F
F
F
F
F
F
F
F
F
F
F
"}
(28,1,1) = {"
F
F
F
F
F
F
F
F
F
F
F
F
F
F
F
F
F
F
F
F
"}
(29,1,1) = {"
F
F
F
F
F
F
F
F
F
F
F
F
F
F
F
F
F
F
F
F
"}
(30,1,1) = {"
F
F
F
F
F
F
F
F
F
F
F
F
F
F
F
F
F
F
F
F
"}
(31,1,1) = {"
F
F
F
F
F
F
F
F
F
F
F
F
F
F
F
F
F
F
F
F
"}
(32,1,1) = {"
F
F
F
F
F
F
F
F
F
F
F
F
F
F
F
F
F
F
F
F
"}
(33,1,1) = {"
F
F
F
F
F
F
F
F
F
F
F
F
F
F
F
F
F
F
F
F
"}
(34,1,1) = {"
F
F
F
F
F
F
F
F
F
F
F
F
F
F
F
F
F
F
F
F
"}
(35,1,1) = {"
F
F
F
F
F
F
F
F
F
F
F
F
F
F
F
F
F
F
F
F
"}
(36,1,1) = {"
F
F
F
F
F
F
F
F
F
F
F
F
F
F
F
F
F
F
F
F
"}
(37,1,1) = {"
F
F
F
F
F
F
F
F
F
F
F
F
F
F
F
F
F
F
F
F
"}
(38,1,1) = {"
F
F
F
F
F
F
F
F
F
F
F
F
F
F
F
F
F
F
F
F
"}
(39,1,1) = {"
F
F
F
F
F
F
F
F
F
F
F
F
F
F
F
F
F
F
F
F
"}
(40,1,1) = {"
F
F
F
F
F
F
F
F
F
F
F
F
F
F
F
F
F
F
F
F
"}
