"aa" = (/turf/template_noop,/area/template_noop)
"ab" = (/turf/template_noop,/area/submap/virgo2/Blackshuttledown)
"ac" = (/obj/effect/decal/remains/human,/turf/template_noop,/area/submap/virgo2/Blackshuttledown)
"ad" = (/turf/simulated/mineral/ignore_mapgen/virgo2,/area/submap/virgo2/Blackshuttledown)
"ae" = (/obj/effect/decal/cleanable/blood,/turf/template_noop,/area/submap/virgo2/Blackshuttledown)
"af" = (/turf/simulated/mineral/floor/ignore_mapgen/virgo2,/area/submap/virgo2/Blackshuttledown)
"ag" = (/obj/effect/decal/remains/human,/turf/simulated/mineral/floor/ignore_mapgen/virgo2,/area/submap/virgo2/Blackshuttledown)
"ah" = (/obj/effect/decal/cleanable/blood,/turf/simulated/mineral/floor/ignore_mapgen/virgo2,/area/submap/virgo2/Blackshuttledown)
"ai" = (/turf/simulated/mineral/floor/ignore_mapgen/virgo2,/turf/simulated/shuttle/wall/dark{icon_state = "dark6";name = "Unknown Shuttle"},/area/submap/virgo2/Blackshuttledown)
"aj" = (/turf/simulated/shuttle/wall/dark{icon_state = "dark0";name = "Unknown Shuttle"},/area/submap/virgo2/Blackshuttledown)
"ak" = (/turf/simulated/mineral/floor/ignore_mapgen/virgo2,/turf/simulated/shuttle/wall/dark{icon_state = "dark10";name = "Unknown Shuttle"},/area/submap/virgo2/Blackshuttledown)
"al" = (/obj/machinery/door/airlock/external{density = 1;frequency = 1331;id_tag = "merc_shuttle_outer";name = "Ship External Access";req_access = list(150)},/turf/simulated/floor/tiled/steel,/area/submap/virgo2/Blackshuttledown)
"am" = (/obj/structure/shuttle/engine/heater{icon_state = "heater";dir = 4},/turf/simulated/shuttle/wall/dark{icon_state = "dark0";name = "Unknown Shuttle"},/area/submap/virgo2/Blackshuttledown)
"an" = (/obj/structure/shuttle/engine/propulsion{dir = 4;icon_state = "propulsion_l"},/turf/simulated/mineral/floor/ignore_mapgen/virgo2,/area/submap/virgo2/Blackshuttledown)
"ao" = (/obj/machinery/light{dir = 1},/obj/structure/table/rack,/obj/item/clothing/head/helmet/space,/obj/item/clothing/head/helmet/space,/obj/item/clothing/head/helmet/space,/obj/item/clothing/head/helmet/space,/obj/item/clothing/suit/space,/obj/item/clothing/suit/space,/obj/item/clothing/suit/space,/obj/item/clothing/suit/space,/turf/simulated/floor/tiled/steel,/area/submap/virgo2/Blackshuttledown)
"ap" = (/obj/structure/dispenser/oxygen,/turf/simulated/floor/tiled/steel,/area/submap/virgo2/Blackshuttledown)
"aq" = (/turf/simulated/floor/tiled/steel,/area/submap/virgo2/Blackshuttledown)
"ar" = (/obj/machinery/light/small{dir = 4;pixel_y = 0},/turf/simulated/floor/tiled/steel,/area/submap/virgo2/Blackshuttledown)
"as" = (/obj/machinery/light{dir = 1},/turf/simulated/floor/tiled/steel,/area/submap/virgo2/Blackshuttledown)
"at" = (/obj/machinery/organ_printer/flesh,/turf/simulated/floor/tiled/steel,/area/submap/virgo2/Blackshuttledown)
"au" = (/turf/simulated/mineral/floor/ignore_mapgen/virgo2,/turf/simulated/shuttle/wall/dark{icon_state = "dark5";name = "Unknown Shuttle"},/area/submap/virgo2/Blackshuttledown)
"av" = (/obj/structure/table/steel,/obj/item/weapon/gun/projectile/automatic/wt550,/obj/item/weapon/gun/projectile/automatic/p90,/turf/simulated/floor/tiled/steel,/area/submap/virgo2/Blackshuttledown)
"aw" = (/obj/machinery/door/airlock/external,/turf/simulated/floor/tiled/steel,/area/submap/virgo2/Blackshuttledown)
"ax" = (/obj/machinery/optable,/turf/simulated/floor/tiled/steel,/area/submap/virgo2/Blackshuttledown)
"ay" = (/obj/machinery/bodyscanner{dir = 8},/turf/simulated/floor/tiled/steel,/area/submap/virgo2/Blackshuttledown)
"az" = (/turf/simulated/mineral/floor/ignore_mapgen/virgo2,/turf/simulated/shuttle/wall/dark{icon_state = "dark9";name = "Unknown Shuttle"},/area/submap/virgo2/Blackshuttledown)
"aB" = (/mob/living/simple_animal/hostile/viscerator,/mob/living/simple_animal/hostile/viscerator,/mob/living/simple_animal/hostile/viscerator,/turf/simulated/floor/tiled/steel,/area/submap/virgo2/Blackshuttledown)
"aC" = (/obj/structure/table/steel,/obj/item/weapon/gun/projectile/automatic/c20r,/obj/machinery/light/small{dir = 4;pixel_y = 0},/turf/simulated/floor/tiled/steel,/area/submap/virgo2/Blackshuttledown)
"aD" = (/mob/living/simple_animal/hostile/syndicate/ranged/space,/turf/simulated/floor/tiled/steel,/area/submap/virgo2/Blackshuttledown)
"aE" = (/obj/machinery/light{dir = 4;icon_state = "tube1";pixel_x = 0},/turf/simulated/floor/tiled/steel,/area/submap/virgo2/Blackshuttledown)
"aF" = (/obj/structure/table/steel,/turf/simulated/floor/tiled/steel,/area/submap/virgo2/Blackshuttledown)
"aG" = (/obj/structure/table/standard,/obj/item/weapon/storage/firstaid/surgery,/turf/simulated/floor/tiled/steel,/area/submap/virgo2/Blackshuttledown)
"aH" = (/obj/structure/table/standard,/obj/item/weapon/tank/anesthetic,/turf/simulated/floor/tiled/steel,/area/submap/virgo2/Blackshuttledown)
"aI" = (/obj/structure/table/standard,/obj/item/clothing/gloves/sterile,/obj/item/clothing/gloves/sterile,/turf/simulated/floor/tiled/steel,/area/submap/virgo2/Blackshuttledown)
"aJ" = (/obj/structure/table/standard,/obj/item/weapon/reagent_containers/spray/sterilizine,/obj/item/weapon/reagent_containers/spray/sterilizine,/turf/simulated/floor/tiled/steel,/area/submap/virgo2/Blackshuttledown)
"aK" = (/obj/structure/table/standard,/obj/item/weapon/storage/box/masks,/turf/simulated/floor/tiled/steel,/area/submap/virgo2/Blackshuttledown)
"aL" = (/obj/machinery/light{icon_state = "tube1";dir = 8},/turf/simulated/floor/tiled/steel,/area/submap/virgo2/Blackshuttledown)
"aM" = (/obj/structure/bed/chair/office/dark{dir = 1},/turf/simulated/floor/tiled/steel,/area/submap/virgo2/Blackshuttledown)
"aN" = (/obj/machinery/door/airlock/security{locked = 1},/turf/simulated/floor/tiled/steel,/area/submap/virgo2/Blackshuttledown)
"aO" = (/obj/machinery/door/airlock/glass,/turf/simulated/floor/tiled/steel,/area/submap/virgo2/Blackshuttledown)
"aQ" = (/obj/machinery/computer/communications,/turf/simulated/floor/tiled/steel,/area/submap/virgo2/Blackshuttledown)
"aR" = (/obj/structure/closet/secure_closet/freezer/fridge,/turf/simulated/floor/tiled/steel,/area/submap/virgo2/Blackshuttledown)
"aS" = (/obj/structure/table/steel,/obj/item/weapon/material/knife,/turf/simulated/floor/tiled/steel,/area/submap/virgo2/Blackshuttledown)
"aT" = (/mob/living/simple_animal/hostile/syndicate/ranged{desc = "Dosen't look friendly in the slightest.";name = "Unknown Individual";say_got_target = list("Looks like trouble!","Contact!","We've got company!","Perimeter Breached!!");speak = list("One day the'll fix that damn engine..","Next time, We're hidding on the tropical beach planet.","Wish I had better equipment...","I knew I should have been a line chef...","Fuckin' helmet keeps fogging up.","Hate this blocky ass ship.")},/turf/simulated/floor/tiled/steel,/area/submap/virgo2/Blackshuttledown)
"aU" = (/obj/structure/table/steel,/obj/random/toolbox,/turf/simulated/floor/tiled/steel,/area/submap/virgo2/Blackshuttledown)
"aV" = (/obj/structure/table/steel,/obj/machinery/light/small{dir = 4;pixel_y = 0},/turf/simulated/floor/tiled/steel,/area/submap/virgo2/Blackshuttledown)
"aW" = (/obj/structure/grille,/obj/structure/window/reinforced{dir = 1},/obj/structure/window/reinforced{dir = 8},/obj/structure/window/reinforced{dir = 4},/turf/simulated/floor/plating,/area/submap/virgo2/Blackshuttledown)
"aX" = (/obj/item/weapon/stool,/turf/simulated/floor/tiled/steel,/area/submap/virgo2/Blackshuttledown)
"aY" = (/obj/structure/grille,/obj/structure/window/reinforced{dir = 4},/obj/structure/window/reinforced{dir = 8},/turf/simulated/floor/plating,/area/submap/virgo2/Blackshuttledown)
"aZ" = (/obj/structure/table/steel,/obj/item/pizzabox,/turf/simulated/floor/tiled/steel,/area/submap/virgo2/Blackshuttledown)
"ba" = (/obj/machinery/door/airlock,/turf/simulated/floor/tiled/steel,/area/submap/virgo2/Blackshuttledown)
"bb" = (/obj/structure/grille,/obj/structure/window/reinforced,/obj/structure/window/reinforced{dir = 8},/obj/structure/window/reinforced{dir = 4},/turf/simulated/floor/plating,/area/submap/virgo2/Blackshuttledown)
"bc" = (/obj/machinery/power/apc{cell_type = /obj/item/weapon/cell/hyper;dir = 4;name = "Unknown APC";pixel_x = 24},/turf/simulated/shuttle/wall/dark{icon_state = "dark0";name = "Unknown Shuttle"},/area/submap/virgo2/Blackshuttledown)
"bd" = (/obj/machinery/computer/area_atmos,/turf/simulated/floor/tiled/steel,/area/submap/virgo2/Blackshuttledown)
"be" = (/obj/structure/table/steel,/obj/item/weapon/paper{info = "We need to take a short stop. The engine's are in need of minor repairs due to turbulence, should be a week's time. We've got reserve food supplies but pleanty of locale fauna to subsist on too if need be. PCRC is keeping most of there assets near New Reykjavik and locale authorities are more mindful then most to travel in this kind of weather. Our outfit should be at the rendezvous point in less then ten days assuming the upper ecehelon hasn't dropped ties with us yet.";name = "Operation Progress/M-53"},/turf/simulated/floor/tiled/steel,/area/submap/virgo2/Blackshuttledown)
"bf" = (/obj/structure/table/steel,/obj/item/weapon/paper_bin,/turf/simulated/floor/tiled/steel,/area/submap/virgo2/Blackshuttledown)
"bg" = (/obj/machinery/light,/turf/simulated/floor/tiled/steel,/area/submap/virgo2/Blackshuttledown)
"bh" = (/obj/structure/closet/toolcloset,/turf/simulated/floor/tiled/steel,/area/submap/virgo2/Blackshuttledown)
"bi" = (/obj/machinery/portable_atmospherics/canister/empty/oxygen,/turf/simulated/floor/tiled/steel,/area/submap/virgo2/Blackshuttledown)
"bj" = (/obj/machinery/atmospherics/pipe/tank/oxygen,/obj/machinery/light/small{dir = 4;pixel_y = 0},/turf/simulated/floor/tiled/steel,/area/submap/virgo2/Blackshuttledown)
"bk" = (/obj/structure/bed/chair/office/dark,/turf/simulated/floor/tiled/steel,/area/submap/virgo2/Blackshuttledown)
"bl" = (/obj/structure/table/steel,/obj/item/weapon/gun/projectile/automatic/c20r,/turf/simulated/floor/tiled/steel,/area/submap/virgo2/Blackshuttledown)
"bm" = (/obj/structure/bed,/obj/item/weapon/bedsheet,/turf/simulated/floor/tiled/steel,/area/submap/virgo2/Blackshuttledown)
"bn" = (/mob/living/simple_animal/hostile/viscerator,/turf/simulated/floor/tiled/steel,/area/submap/virgo2/Blackshuttledown)
"bo" = (/obj/structure/table/steel,/obj/item/weapon/gun/projectile/pistol,/obj/machinery/light/small{dir = 4;pixel_y = 0},/turf/simulated/floor/tiled/steel,/area/submap/virgo2/Blackshuttledown)
"bp" = (/obj/structure/bed,/obj/item/weapon/bedsheet,/obj/structure/bed,/turf/simulated/floor/tiled/steel,/area/submap/virgo2/Blackshuttledown)
"bq" = (/mob/living/simple_animal/hostile/viscerator,/mob/living/simple_animal/hostile/viscerator,/turf/simulated/floor/tiled/steel,/area/submap/virgo2/Blackshuttledown)
"br" = (/obj/structure/table/steel,/obj/item/weapon/gun/projectile/pistol,/obj/item/weapon/gun/projectile/shotgun/pump,/turf/simulated/floor/tiled/steel,/area/submap/virgo2/Blackshuttledown)
"bs" = (/obj/structure/toilet{dir = 1},/turf/simulated/floor/tiled/steel,/area/submap/virgo2/Blackshuttledown)
"bt" = (/obj/machinery/light,/obj/structure/table/rack,/obj/item/clothing/head/helmet/space,/obj/item/clothing/head/helmet/space,/obj/item/clothing/head/helmet/space,/obj/item/clothing/head/helmet/space,/obj/item/clothing/suit/space,/obj/item/clothing/suit/space,/obj/item/clothing/suit/space,/obj/item/clothing/suit/space,/turf/simulated/floor/tiled/steel,/area/submap/virgo2/Blackshuttledown)
"bu" = (/obj/structure/bed,/obj/item/weapon/bedsheet,/obj/machinery/light,/turf/simulated/floor/tiled/steel,/area/submap/virgo2/Blackshuttledown)
"bv" = (/obj/structure/bed,/obj/item/weapon/bedsheet,/obj/item/toy/plushie/spider,/turf/simulated/floor/tiled/steel,/area/submap/virgo2/Blackshuttledown)
"by" = (/obj/structure/table/steel,/turf/simulated/mineral/floor/ignore_mapgen/virgo2,/area/submap/virgo2/Blackshuttledown)
"bz" = (/mob/living/simple_animal/hostile/syndicate/ranged/space,/turf/simulated/mineral/floor/ignore_mapgen/virgo2,/area/submap/virgo2/Blackshuttledown)

(1,1,1) = {"
aaaaaaaaaaaaaaaaaaaaaaaaaaaaaaaaaaaaaaaaaaaaaaaaaaaaaaaaaaaaaaaaaaaaaa
aaafafafafafagafafafafafafafafadadafagafafafafafagafafafafafafafafabaa
aaafafafafafafahafafafafafafafadadafafafafafafafafafafafafadafafafacaa
aaabafafafafafafafafafafafafadadafafafafafafafafafafahafafadadafafafaa
aaabafafafadadadafafafafafafafafafafafafafafafafafafafafafadadafafafaa
aaabafafafafafadadafagafafafafbybybybybybyafafafafafagafafafadafafabaa
aaabafafafafafadadafafafafafafbybzafafafbyafafafafafafafafafafafafabaa
aaababafafafafafaiajajajakafafbyafafafbzbyafafafafaiajajajajakafafafaa
aaababafafafafafajajajajajajajajajalalajajajajajajajajajajajamanafafaa
aaabababafafafafajajajajajajaoapajaqarajaqaqasaqatajajajajajamanafafaa
aaabababafafafafauajajaqavajaqaqajawawajaqaxaqaqaqaqayajajazafafafafaa
aaabababafafafafaiajajaBaCajaqaqaqaqaqajaqaqaqaqaDaqaEajazafafafafafaa
aaabababafafafaiajaFajaqaFajaqaqaqaqaEajaGaHaqaqaIaJaKajafafafafafabaa
aaabababafafaiajaLaMajaNajajaqaqajajajajajajaOajajajajajakafafafafabaa
aaabababafafajaQaqaqajaqaqaqaqaqajaRaSaqasaqaDaqajaUaUaVajakafafafabaa
aaafafafafafaWaFaqaqajaLaqaqaqaEajaqaqaXaXaXaqaqajaFaqaqaqamanafafabaa
aaafafafafafaYaFaqaqaOaqaqaqaqaqaOaqaqaZaFaFaqaqbaaqaqaqaqamanafafafaa
aaafafafafafaYaFaqaqaOaqaqaqaqaqaOaqaqaFaFaFaqaqbaaqaqaqaqamanafafafaa
aaafafafafafbbaFaqaqajaLaqaqaqaEajaqaqaXaXaXaqaqbcaqaqaqaDamanafafafaa
aaafafafafafajbdaqaTajaqaqaqaqaqajbebfaqbgaDaqaqajbhbibjajazafafafafaa
aaafafafafafauajaLbkajaNajajaqaqajajajajajajaOajajajajajazafafafafafaa
aaafafafafafafauajaFajaqblajaqaqaqaqaEajbmaqaqaqaqbaaqajafafafafafafaa
aaafafafafafafafauajajbnboajaqaqaqaqaqajbpaqbmaqbmajarajakafafafafafaa
aaafafafafafafafaiajajbqbrajaqaDajawawajbmaqbmaqbmajbsajajakafafafabaa
aaafafafafafafafajajajajajajbtapajaqarajbmaqbuaqbvajajajajamanafafabaa
aaafafafafafafafajajajajajajajajajalalajajajajajajajajajajamanafafabaa
aaafafafafafafafauajajajazafafbybzafafafbyafafafauajajajajazafafafabaa
aaafafafadafafafafafafafafafafbyafafafbzbyafafafafafafafafadadadafabaa
aaafafadadafagafafafafafafafafbybybybybybyafafafafagafafadadadadafabaa
aaafadadadafafafababababaeababababababababababadadafafafadadadadafabaa
aaafafadadafafagabadababababababababababababadadadafafafafadadafafafaa
aaafafafafafafafadadabababababababababacabadadadafafafafafafafafafafaa
aaafafafafafafadadadababababababababababadadadadafafafafafafafafafafaa
aaafafafafafafafadadabacabababababababababababadahafagafafafafafafabaa
aaaaaaaaaaaaaaaaaaaaaaaaaaaaaaaaaaaaaaaaaaaaaaaaaaaaaaaaaaaaaaaaaaaaaa
"}
