"a" = (/turf/template_noop,/area/template_noop)
"b" = (/turf/template_noop,/area/submap/virgo2/CaveS)
"c" = (/obj/item/ammo_casing/a45,/turf/template_noop,/area/submap/virgo2/CaveS)
"d" = (/turf/simulated/mineral/ignore_mapgen/virgo2,/area/submap/virgo2/CaveS)
"e" = (/obj/item/ammo_casing/a45,/obj/item/weapon/reagent_containers/food/snacks/xenomeat/spidermeat,/turf/template_noop,/area/submap/virgo2/CaveS)
"f" = (/obj/tether_away_spawner/aerostat_surface,/turf/simulated/mineral/floor/ignore_mapgen/virgo2,/area/submap/virgo2/CaveS)
"g" = (/obj/effect/spider/stickyweb,/turf/simulated/mineral/floor/ignore_mapgen/virgo2,/area/submap/virgo2/CaveS)
"h" = (/obj/item/ammo_casing/a45,/obj/item/ammo_casing/a45,/turf/template_noop,/area/submap/virgo2/CaveS)
"i" = (/obj/item/weapon/reagent_containers/food/snacks/xenomeat/spidermeat,/turf/template_noop,/area/submap/virgo2/CaveS)
"j" = (/obj/item/clothing/accessory/storage/webbing,/obj/item/weapon/material/knife/tacknife/combatknife,/turf/simulated/mineral/floor/ignore_mapgen/virgo2,/area/submap/virgo2/CaveS)
"k" = (/obj/tether_away_spawner/aerostat_surface,/turf/simulated/floor,/area/submap/virgo2/CaveS)
"l" = (/obj/effect/decal/cleanable/cobweb,/turf/simulated/mineral/floor/ignore_mapgen/virgo2,/area/submap/virgo2/CaveS)
"m" = (/mob/living/simple_animal/hostile/giant_spider/lurker,/turf/simulated/mineral/floor/ignore_mapgen/virgo2,/area/submap/virgo2/CaveS)
"n" = (/obj/effect/decal/cleanable/cobweb2,/turf/simulated/mineral/floor/ignore_mapgen/virgo2,/area/submap/virgo2/CaveS)
"o" = (/obj/effect/mine,/turf/simulated/mineral/floor/ignore_mapgen/virgo2,/area/submap/virgo2/CaveS)
"q" = (/obj/effect/decal/cleanable/cobweb2,/mob/living/simple_animal/hostile/giant_spider/lurker,/turf/simulated/mineral/floor/ignore_mapgen/virgo2,/area/submap/virgo2/CaveS)
"r" = (/turf/simulated/mineral/floor/ignore_mapgen/virgo2,/area/submap/virgo2/CaveS)
"u" = (/turf/simulated/floor,/area/submap/virgo2/CaveS)
"v" = (/obj/structure/closet/crate,/obj/item/stack/cable_coil,/obj/item/stack/cable_coil,/obj/item/weapon/storage/toolbox,/obj/random/toolbox,/turf/simulated/floor,/area/submap/virgo2/CaveS)
"w" = (/obj/structure/loot_pile/surface,/turf/simulated/floor,/area/submap/virgo2/CaveS)
"x" = (/obj/structure/table/woodentable,/turf/simulated/floor,/area/submap/virgo2/CaveS)
"y" = (/obj/machinery/power/port_gen/pacman,/obj/structure/cable{icon_state = "0-2";d2 = 2},/turf/simulated/floor,/area/submap/virgo2/CaveS)
"z" = (/turf/simulated/wall,/area/submap/virgo2/CaveS)
"A" = (/obj/structure/closet/crate,/obj/item/weapon/reagent_containers/hypospray,/obj/item/weapon/reagent_containers/glass/bottle/stoxin,/obj/item/weapon/reagent_containers/glass/bottle/antitoxin,/obj/item/weapon/reagent_containers/pill/antitox,/obj/item/weapon/reagent_containers/pill/antitox,/obj/item/weapon/reagent_containers/pill/antitox,/obj/item/weapon/reagent_containers/pill/paracetamol,/obj/random/firstaid,/turf/simulated/floor,/area/submap/virgo2/CaveS)
"B" = (/obj/structure/cable{d1 = 1;d2 = 2;icon_state = "1-2";pixel_y = 0},/turf/simulated/floor,/area/submap/virgo2/CaveS)
"C" = (/obj/structure/closet/crate,/obj/random/contraband,/obj/random/contraband,/obj/random/contraband,/obj/random/energy,/obj/item/weapon/material/star,/obj/item/weapon/material/star,/obj/item/weapon/material/star,/obj/item/weapon/material/star,/obj/item/weapon/material/star,/turf/simulated/floor,/area/submap/virgo2/CaveS)
"D" = (/obj/effect/spider/stickyweb,/mob/living/simple_animal/hostile/giant_spider/lurker,/turf/simulated/mineral/floor/ignore_mapgen/virgo2,/area/submap/virgo2/CaveS)
"E" = (/obj/structure/cable{d1 = 1;d2 = 4;icon_state = "1-4"},/turf/simulated/floor,/area/submap/virgo2/CaveS)
"F" = (/obj/structure/cable{d1 = 4;d2 = 8;icon_state = "4-8";pixel_x = 0},/turf/simulated/floor,/area/submap/virgo2/CaveS)
"G" = (/obj/machinery/computer/communications,/obj/structure/cable{d2 = 8;icon_state = "0-8"},/turf/simulated/floor,/area/submap/virgo2/CaveS)

(1,1,1) = {"
aaaaaaaaaaaaaaaaaaaaaaaaaaaaaaaaaaaaaaaa
abbbbbbbbbbbbbbbbbbbbbbbbbbbbbbbbbbbbbba
abbbbbbbbbbbbbbbbbbbbbbbbbbbbbbbbbbbbbba
abbbbbbbbbbbbbbbbbbbbbbbbbbbbbbbbbbbbbba
abbbbbbbbbbbbbbbbbbbbbcbbbbbbbbbbbbbbbba
abbbbbbbbbbbbbbbbbbbbbbbbbbbbbbbbbbbbbba
abbbbbbbbbbbbbbbcbbbbbbcccdddddbbbbbbbba
abbbbbbbbbbbbbbbbbbbbbbbeddddddddbbddbba
abbbbbbbbbbbbbbbbbbbbbbbdddddddddddddbba
abbbbdddddbbbbcbbbbcbbbrgddddddddddddbba
abbbbddddddddbbbbbhbbbbrrddddddddddddbba
abbbddddddddddbbbbcbibdgrggdddddddddbbba
abbbdddddddddddbbbbbbdddgrrrdddddddbbbba
abbbddddddddddddbbbbddddddrrgddddddbbbba
abbdddddjdrrgdddbbddddddddrrrrrrddddbbba
abbdddrrrrrrrdddbbdddddddlrfrrrrrdddbbba
abbdddgrrrrrmddbbddddddddrrrrrrrdddddbba
abbddddrrrfrdddbdddddddddrrddddrnddddbba
abdddddddrrrrddddddddddddorddddrrdddddba
abdddddddrrrrndddddlrrrrrrddddlrddddddba
abddddddddrrrrrrrrrrrrrrrrddddorddddddda
abdddddddddrrrrrrrrrrrrrrrrqddrrddddddda
abdddddrrdddddrrdddmdddddgrrrrrrddddddba
abdddrrrrdddddrrddddddddddorrrrddddddbba
abddrrrrrdddddrrmdddddddddddddddddddbbba
abddrrfrrrdddddrrrrrddddddddmrddddddbbba
abdddrrrrrgddddrrrorrrogdddrrrrrdddbbbba
abdddrrrrrrrrrrrrdrrrrrgddrrukvrrrddbbba
abddrrrrrrrrrrrgdddgrrrrrrrruuuwrdddbbba
abddrrrrrfrrddddddddrorrrrruxxuurrddbbba
abdddrrrrrrrmddddddrrrgdrruyzzArrrdddbba
abdddddrrrrddddddgrrrrddrruBzzCrrddddbba
abdddddddrgddddddDrrrrddrfuEFGuuddddbbba
abbddddddddddddddrrrrrdddrruuuudddddbbba
abbdddddddddddddddrgdddddrrrwudddddbbbba
abbdddddddddddddddddddddddmrrddddbbbbbba
abbbdddddddddddddddddddddddddddbbbbbbbba
abbbddddbbbbdddddddbbdddddddddbbbbbbbbba
abbbddbbbbbbbddddbbbbdbbdddddbbbbbbbbbba
aaaaaaaaaaaaaaaaaaaaaaaaaaaaaaaaaaaaaaaa
"}
