"a" = (/turf/template_noop,/area/template_noop)
"b" = (/turf/template_noop,/area/submap/virgo2/GovPatrol)
"c" = (/obj/tether_away_spawner/aerostat_surface,/turf/simulated/mineral/floor/ignore_mapgen/virgo2,/area/submap/virgo2/GovPatrol)
"d" = (/turf/simulated/mineral/floor/ignore_mapgen/virgo2,/area/submap/virgo2/GovPatrol)
"e" = (/obj/item/device/radio/off,/turf/simulated/mineral/floor/ignore_mapgen/virgo2,/area/submap/virgo2/GovPatrol)
"f" = (/obj/item/weapon/storage/box/flare,/turf/simulated/mineral/floor/ignore_mapgen/virgo2,/area/submap/virgo2/GovPatrol)
"g" = (/obj/item/ammo_casing,/turf/template_noop,/area/submap/virgo2/GovPatrol)
"h" = (/obj/item/ammo_casing,/turf/simulated/mineral/floor/ignore_mapgen/virgo2,/area/submap/virgo2/GovPatrol)
"i" = (/obj/item/clothing/under/utility/sifguard,/obj/item/clothing/shoes/boots/jackboots,/obj/effect/decal/remains,/turf/simulated/mineral/floor/ignore_mapgen/virgo2,/area/submap/virgo2/GovPatrol)
"j" = (/obj/item/stack/material/wood/sif,/turf/simulated/mineral/floor/ignore_mapgen/virgo2,/area/submap/virgo2/GovPatrol)
"k" = (/obj/item/weapon/gun/projectile/shotgun/pump/rifle/lever,/turf/simulated/mineral/floor/ignore_mapgen/virgo2,/area/submap/virgo2/GovPatrol)
"m" = (/obj/effect/decal/remains,/turf/simulated/mineral/floor/ignore_mapgen/virgo2,/area/submap/virgo2/GovPatrol)

(1,1,1) = {"
aaaaaaaaaaaaa
abbbbbbbbdbba
abbbbbbddddba
abdddddddddba
abdddddddddba
abdddddddddba
abdddecdddbba
abdddddfhdbba
abdhdiddddbba
abdjdddddddba
abddkdddddhba
abdgdddddmgba
aaaaaaaaaaaaa
"}
