"a" = (/turf/template_noop,/area/template_noop)
"b" = (/turf/template_noop,/area/submap/virgo2/MHR)
"c" = (/turf/simulated/mineral/floor/ignore_mapgen/virgo2{outdoors = 0},/area/template_noop)
"d" = (/turf/simulated/mineral/floor/ignore_mapgen/virgo2{outdoors = 0},/area/submap/virgo2/MHR)
"e" = (/turf/simulated/mineral/ignore_mapgen/virgo2,/area/submap/virgo2/MHR)
"f" = (/obj/effect/decal/cleanable/spiderling_remains,/turf/simulated/mineral/floor/ignore_mapgen/virgo2{outdoors = 0},/area/submap/virgo2/MHR)
"g" = (/turf/simulated/mineral/floor/ignore_mapgen/virgo2,/area/submap/virgo2/MHR)
"h" = (/obj/structure/table/rack,/obj/item/weapon/storage/backpack,/turf/simulated/mineral/floor/ignore_mapgen/virgo2{outdoors = 0},/area/submap/virgo2/MHR)
"i" = (/obj/structure/table/standard,/turf/simulated/mineral/floor/ignore_mapgen/virgo2{outdoors = 0},/area/submap/virgo2/MHR)
"j" = (/obj/structure/table/standard,/obj/item/weapon/paper{info = "Do not enter the cave. The estimated active time of the Vicerators is much longer due to the improvements on the rotor bearings. It's estimated to be roughly a few months before we start to see any chancces of mechanical failure. ";name = "NOTICE: DO NOT ENTER"},/turf/simulated/mineral/floor/ignore_mapgen/virgo2{outdoors = 0},/area/submap/virgo2/MHR)
"k" = (/obj/effect/decal/cleanable/cobweb2,/turf/simulated/mineral/floor/ignore_mapgen/virgo2{outdoors = 0},/area/submap/virgo2/MHR)
"l" = (/obj/tether_away_spawner/aerostat_surface,/turf/simulated/mineral/floor/ignore_mapgen/virgo2{outdoors = 0},/area/submap/virgo2/MHR)
"m" = (/obj/item/weapon/reagent_containers/food/snacks/xenomeat/spidermeat,/turf/simulated/mineral/floor/ignore_mapgen/virgo2{outdoors = 0},/area/submap/virgo2/MHR)
"n" = (/obj/effect/decal/cleanable/spiderling_remains,/obj/tether_away_spawner/aerostat_surface,/turf/simulated/mineral/floor/ignore_mapgen/virgo2{outdoors = 0},/area/submap/virgo2/MHR)
"o" = (/obj/effect/decal/cleanable/cobweb,/turf/simulated/mineral/floor/ignore_mapgen/virgo2{outdoors = 0},/area/submap/virgo2/MHR)
"p" = (/obj/effect/decal/cleanable/spiderling_remains,/obj/effect/decal/cleanable/cobweb,/turf/simulated/mineral/floor/ignore_mapgen/virgo2{outdoors = 0},/area/submap/virgo2/MHR)
"q" = (/obj/effect/decal/remains/robot,/turf/simulated/mineral/floor/ignore_mapgen/virgo2{outdoors = 0},/area/submap/virgo2/MHR)
"r" = (/obj/effect/decal/remains,/obj/item/clothing/mask/gas/explorer,/obj/item/weapon/material/twohanded/fireaxe,/turf/simulated/mineral/floor/ignore_mapgen/virgo2{outdoors = 0},/area/submap/virgo2/MHR)
"s" = (/obj/item/weapon/reagent_containers/food/snacks/xenomeat/spidermeat,/obj/item/weapon/reagent_containers/food/snacks/xenomeat/spidermeat,/turf/simulated/mineral/floor/ignore_mapgen/virgo2{outdoors = 0},/area/submap/virgo2/MHR)

(1,1,1) = {"
aaaccccccccccccaaaaa
abdddddddddddddeeeba
abddddddddddddfeeeea
abddddddddddfddgeeea
abddbdhijeeeedddeeea
abbbbeeeeeeeeeddeeea
abbbeeeeeeeeeeddeeea
abbeeeeeeeeeeeddeeea
abeeeeeeeeeeedddkeea
abeeeeedmkeeoddddeea
abeeepldddqfdddddeea
abeeedddddddldddreea
abeeedddndddddddeeea
abbeeldddddsddqeeeea
abbeeefeesdddleeeeba
abbeeeeeeeeeeeeeebba
abbbeeeeeeeeeeeeebba
abbbbeeeeeeeebbbbbba
abbbbbbbbbbbbbbbbbba
aaaaaaaaaaaaaaaaaaaa
"}
