"a" = (/turf/template_noop,/area/template_noop)
"b" = (/turf/simulated/wall/log_sif,/area/submap/virgo2/Shack1)
"c" = (/turf/template_noop,/area/submap/virgo2/Shack1)
"d" = (/turf/simulated/mineral/floor/ignore_mapgen/virgo2,/area/submap/virgo2/Shack1)
"e" = (/obj/effect/decal/cleanable/cobweb,/turf/simulated/floor/holofloor/wood{icon_state = "wood_broken1"},/area/submap/virgo2/Shack1)
"f" = (/obj/structure/table/wooden_reinforced,/turf/simulated/floor/wood,/area/submap/virgo2/Shack1)
"g" = (/obj/structure/closet/cabinet,/obj/item/clothing/suit/storage/apron/overalls,/obj/item/clothing/under/overalls,/turf/simulated/floor/wood,/area/submap/virgo2/Shack1)
"h" = (/obj/effect/decal/cleanable/dirt,/turf/simulated/floor/wood,/area/submap/virgo2/Shack1)
"i" = (/turf/simulated/floor/wood,/area/submap/virgo2/Shack1)
"j" = (/turf/simulated/floor/holofloor/wood{icon_state = "wood_broken0"},/area/submap/virgo2/Shack1)
"k" = (/obj/effect/decal/cleanable/dirt,/turf/simulated/floor/holofloor/wood{icon_state = "wood_broken5"},/area/submap/virgo2/Shack1)
"m" = (/obj/structure/simple_door/wood,/turf/simulated/floor/wood,/area/submap/virgo2/Shack1)
"n" = (/turf/simulated/floor/holofloor/wood{icon_state = "wood_broken3"},/area/submap/virgo2/Shack1)
"o" = (/obj/structure/table/bench/wooden,/turf/simulated/floor/wood,/area/submap/virgo2/Shack1)
"p" = (/obj/effect/decal/cleanable/dirt,/obj/structure/table/wooden_reinforced,/obj/item/weapon/storage/toolbox,/turf/simulated/floor/wood,/area/submap/virgo2/Shack1)
"q" = (/obj/effect/decal/cleanable/dirt,/obj/structure/table/wooden_reinforced,/obj/item/weapon/material/twohanded/fireaxe/scythe,/turf/simulated/floor/wood,/area/submap/virgo2/Shack1)
"r" = (/obj/effect/decal/cleanable/spiderling_remains,/turf/simulated/floor/wood,/area/submap/virgo2/Shack1)
"s" = (/turf/simulated/floor/holofloor/wood{icon_state = "wood_broken6"},/area/submap/virgo2/Shack1)
"t" = (/obj/effect/decal/cleanable/dirt,/obj/structure/table/wooden_reinforced,/obj/item/device/flashlight/lamp,/turf/simulated/floor/wood,/area/submap/virgo2/Shack1)
"v" = (/turf/simulated/mineral/floor/ignore_mapgen/virgo2,/area/template_noop)

(1,1,1) = {"
aaaaaaaaaaavvaa
abbbbbbbcccddca
abefghhbcccddca
abhijhkbcccddca
abiiiiimdddddca
abniiiimdddddca
abhoiiibcccddca
abpqrstbcccddca
abbbbbbbcccddca
aaaaaaaaaaavvaa
"}
