"a" = (/turf/template_noop,/area/template_noop)
"b" = (/turf/simulated/mineral/floor/ignore_mapgen/virgo2,/area/submap/virgo2/Small1)
"c" = (/turf/template_noop,/area/submap/virgo2/Small1)
"d" = (/obj/tether_away_spawner/aerostat_surface,/turf/simulated/mineral/floor/ignore_mapgen/virgo2,/area/submap/virgo2/Small1)

(1,1,1) = {"
aaaaaaaaaa
accbbbbcca
acbbbbbbca
abbdbbbbba
abbbbbbbba
abbbbbbbba
abbbbbdbba
acbbbbbbca
accbbbbcca
aaaaaaaaaa
"}
