//MAP CONVERTED BY dmm2tgm.py THIS HEADER COMMENT PREVENTS RECONVERSION, DO NOT REMOVE
"a" = (
/turf/simulated/mineral/ignore_cavegen/lythios43c,
/area/rift/surfacebase/outside/west_base)
"P" = (
/turf/template_noop,
/area/template_noop)

(1,1,1) = {"
P
P
a
a
P
"}
(2,1,1) = {"
P
a
a
a
a
"}
(3,1,1) = {"
P
a
a
a
a
"}
(4,1,1) = {"
a
a
a
a
P
"}
(5,1,1) = {"
a
a
a
a
P
"}
