//MAP CONVERTED BY dmm2tgm.py THIS HEADER COMMENT PREVENTS RECONVERSION, DO NOT REMOVE
"as" = (
/obj/machinery/portable_atmospherics/powered/scrubber,
/turf/template_noop,
/area/template_noop)
"ba" = (
/obj/structure/cable/yellow{
	d1 = 1;
	d2 = 2;
	icon_state = "1-2"
	},
/obj/machinery/atmospherics/pipe/simple/visible/red{
	dir = 9
	},
/turf/simulated/floor/tiled/steel_grid,
/area/engineering/engine_room)
"bf" = (
/obj/machinery/atmospherics/pipe/simple/visible/green{
	dir = 4
	},
/obj/machinery/atmospherics/pipe/simple/visible/green{
	dir = 4
	},
/turf/simulated/floor/tiled/techfloor/grid,
/area/engineering/engine_room)
"bR" = (
/obj/machinery/atmospherics/pipe/simple/hidden/scrubbers{
	dir = 4
	},
/obj/machinery/atmospherics/pipe/simple/hidden/supply{
	dir = 4
	},
/obj/structure/cable/yellow{
	d1 = 4;
	d2 = 8;
	icon_state = "4-8"
	},
/obj/structure/cable/yellow{
	d1 = 1;
	d2 = 8;
	icon_state = "1-8"
	},
/obj/machinery/atmospherics/pipe/simple/visible/black{
	dir = 8
	},
/turf/simulated/floor/tiled/steel_ridged,
/area/engineering/engine_room)
"cj" = (
/obj/machinery/atmospherics/unary/vent_scrubber/on{
	dir = 4
	},
/obj/machinery/computer/general_air_control/large_tank_control{
	frequency = 1439;
	name = "Waste Port";
	output_tag = "waste_out";
	sensors = null
	},
/turf/simulated/floor/tiled/steel_grid,
/area/engineering/engine_room)
"cz" = (
/obj/machinery/atmospherics/pipe/simple/visible/blue{
	dir = 5
	},
/turf/simulated/floor/tiled/techfloor/grid,
/area/engineering/engine_room)
"dn" = (
/obj/structure/window/phoronreinforced/full,
/obj/structure/grille,
/turf/simulated/floor/plating,
/area/engineering/engine_room)
"eh" = (
/obj/structure/cable/yellow{
	d1 = 1;
	d2 = 2;
	icon_state = "1-2"
	},
/turf/simulated/floor/tiled/steel_grid,
/area/engineering/engine_room)
"es" = (
/obj/machinery/atmospherics/pipe/simple/visible/green{
	dir = 4
	},
/obj/machinery/atmospherics/portables_connector,
/turf/simulated/floor/tiled/steel_grid,
/area/engineering/engine_room)
"eu" = (
/obj/machinery/atmospherics/unary/outlet_injector{
	dir = 4;
	use_power = 1;
	volume_rate = 700
	},
/turf/simulated/floor/reinforced/phoron,
/area/engineering/engine_room)
"ey" = (
/obj/machinery/atmospherics/pipe/simple/visible/green{
	dir = 4
	},
/turf/simulated/floor/tiled/techfloor/grid,
/area/engineering/engine_room)
"eA" = (
/obj/machinery/atmospherics/binary/pump/high_power,
/turf/simulated/floor/tiled/steel_grid,
/area/engineering/engine_room)
"eW" = (
/obj/machinery/atmospherics/pipe/simple/heat_exchanging{
	dir = 4
	},
/obj/machinery/air_sensor{
	frequency = 1445;
	id_tag = "burn_chamber1_phoronsensor";
	output = 4
	},
/turf/simulated/floor/reinforced/airless,
/area/engineering/engine_room)
"gd" = (
/obj/machinery/atmospherics/pipe/simple/heat_exchanging,
/turf/simulated/floor/reinforced/airless,
/area/engineering/engine_room)
"gt" = (
/obj/machinery/computer/general_air_control/large_tank_control{
	frequency = 1445;
	input_tag = "burn_chamber1_in";
	name = "Burn Chamber Air Control";
	output_tag = "burn_chamber1_out";
	pressure_setting = 0;
	sensors = list("burssn_chamber1_phoronsensor" = "Phoron Conent",)
	},
/obj/machinery/atmospherics/pipe/simple/visible/black,
/turf/simulated/floor/tiled/steel_ridged,
/area/engineering/engine_room)
"gV" = (
/turf/template_noop,
/area/template_noop)
"in" = (
/obj/effect/floor_decal/industrial/hatch/yellow,
/obj/machinery/atmospherics/pipe/simple/visible/red,
/turf/simulated/floor/tiled/techfloor/grid,
/area/engineering/engine_room)
"ip" = (
/obj/machinery/atmospherics/binary/circulator{
	anchored = 1;
	dir = 1
	},
/turf/simulated/floor,
/area/engineering/engine_room)
"iB" = (
/obj/machinery/atmospherics/pipe/simple/visible/blue{
	dir = 8
	},
/turf/simulated/floor/tiled/steel_ridged,
/area/engineering/engine_room)
"iV" = (
/obj/effect/floor_decal/industrial/danger{
	dir = 1
	},
/obj/machinery/atmospherics/pipe/simple/visible/black{
	dir = 10
	},
/turf/simulated/floor/tiled/techmaint,
/area/engineering/engine_room)
"ja" = (
/obj/machinery/atmospherics/binary/pump/high_power{
	dir = 8
	},
/turf/simulated/floor/tiled/steel_grid,
/area/engineering/engine_room)
"jc" = (
/obj/effect/floor_decal/industrial/hatch/yellow,
/obj/machinery/atmospherics/pipe/simple/visible/green{
	dir = 1
	},
/obj/machinery/meter,
/turf/simulated/floor/tiled/techfloor/grid,
/area/engineering/engine_room)
"je" = (
/obj/machinery/atmospherics/portables_connector{
	dir = 8
	},
/turf/simulated/floor/tiled/techmaint,
/area/engineering/engine_room)
"jC" = (
/obj/machinery/atmospherics/pipe/simple/visible/blue{
	dir = 8
	},
/turf/simulated/floor/tiled/techfloor/grid,
/area/engineering/engine_room)
"jD" = (
/obj/machinery/portable_atmospherics/canister/phoron,
/turf/simulated/floor/reinforced/phoron,
/area/engineering/engine_room)
"jO" = (
/obj/machinery/portable_atmospherics/canister/oxygen,
/turf/simulated/floor/reinforced/oxygen,
/area/engineering/engine_room)
"ke" = (
/obj/structure/cable/yellow{
	d1 = 1;
	d2 = 2;
	icon_state = "1-2"
	},
/obj/machinery/atmospherics/pipe/simple/visible/red{
	dir = 4
	},
/turf/simulated/floor/tiled/steel_grid,
/area/engineering/engine_room)
"kL" = (
/obj/machinery/atmospherics/pipe/simple/heat_exchanging{
	dir = 4
	},
/turf/simulated/floor/reinforced/airless,
/area/engineering/engine_room)
"mz" = (
/turf/simulated/floor/tiled/techfloor/grid,
/area/engineering/engine_room)
"mZ" = (
/obj/effect/floor_decal/industrial/loading{
	dir = 8
	},
/obj/machinery/atmospherics/pipe/simple/hidden/aux{
	dir = 4
	},
/turf/simulated/floor/tiled/steel_grid,
/area/engineering/engine_room)
"nN" = (
/obj/machinery/power/apc{
	name = "south bump";
	pixel_y = -28
	},
/obj/structure/cable/cyan{
	d2 = 4;
	icon_state = "0-4"
	},
/obj/machinery/atmospherics/pipe/manifold/hidden/supply,
/obj/machinery/atmospherics/pipe/manifold/hidden/scrubbers,
/obj/machinery/atmospherics/pipe/simple/hidden/fuel{
	dir = 8
	},
/turf/simulated/floor/tiled/steel_ridged,
/area/engineering/engine_room)
"oP" = (
/obj/machinery/shield_diffuser,
/obj/machinery/atmospherics/unary/outlet_injector{
	dir = 4;
	frequency = 1439;
	id = "waste_out";
	name = "Waste Ejector";
	pixel_y = 1;
	power_rating = 30000;
	use_power = 1;
	volume_rate = 700
	},
/turf/simulated/floor/airless,
/area/engineering/engine_room)
"oY" = (
/obj/machinery/door/blast/regular{
	density = 0;
	icon_state = "pdoor0";
	id = "EngineRadiatorViewport";
	name = "Engine Radiator Viewport Shutter";
	opacity = 0
	},
/obj/machinery/atmospherics/pipe/simple/visible/universal{
	dir = 4
	},
/turf/simulated/floor/tiled/techfloor/grid,
/area/engineering/engine_room)
"pD" = (
/obj/effect/floor_decal/industrial/outline,
/obj/machinery/atmospherics/pipe/simple/visible/purple{
	dir = 4
	},
/obj/machinery/atmospherics/pipe/simple/visible/black,
/turf/simulated/floor/tiled/steel_grid,
/area/engineering/engine_room)
"pF" = (
/obj/machinery/alarm{
	dir = 4;
	pixel_x = -22
	},
/obj/machinery/atmospherics/unary/vent_pump/on{
	dir = 4
	},
/obj/machinery/firealarm{
	dir = 1;
	pixel_y = -24
	},
/turf/simulated/floor/tiled/steel_ridged,
/area/engineering/engine_room)
"pL" = (
/obj/machinery/atmospherics/pipe/simple/visible/blue{
	dir = 10
	},
/turf/simulated/floor/tiled/techfloor/grid,
/area/engineering/engine_room)
"pO" = (
/obj/machinery/atmospherics/pipe/simple/visible/purple,
/turf/simulated/floor/tiled/steel_ridged,
/area/engineering/engine_room)
"pT" = (
/obj/machinery/button/remote/blast_door{
	desc = "A remote control-switch for the engine radiator viewport shutters.";
	id = "EngineRadiatorViewport";
	name = "Engine Radiator Viewport Shutters";
	pixel_x = -25;
	req_access = list(10)
	},
/obj/effect/floor_decal/industrial/loading,
/obj/machinery/atmospherics/pipe/simple/visible/black{
	dir = 6
	},
/turf/simulated/floor/tiled/steel_grid,
/area/engineering/engine_room)
"qm" = (
/obj/machinery/atmospherics/pipe/simple/visible/black{
	dir = 5
	},
/obj/machinery/meter,
/turf/simulated/floor/tiled/techmaint,
/area/engineering/engine_room)
"qt" = (
/obj/machinery/atmospherics/pipe/simple/heat_exchanging{
	dir = 9
	},
/turf/simulated/floor/reinforced/airless,
/area/engineering/engine_room)
"rH" = (
/obj/structure/window/phoronreinforced/full,
/obj/structure/grille,
/obj/machinery/atmospherics/pipe/simple/visible/universal{
	dir = 4
	},
/turf/simulated/floor/plating,
/area/engineering/engine_room)
"rT" = (
/obj/machinery/atmospherics/unary/outlet_injector{
	dir = 8;
	use_power = 1;
	volume_rate = 700
	},
/turf/simulated/floor/reinforced/oxygen,
/area/engineering/engine_room)
"rX" = (
/turf/simulated/floor/reinforced/oxygen,
/area/engineering/engine_room)
"to" = (
/obj/machinery/atmospherics/pipe/simple/hidden/scrubbers{
	dir = 4
	},
/obj/machinery/atmospherics/pipe/simple/hidden/supply{
	dir = 4
	},
/obj/structure/cable/yellow{
	d1 = 4;
	d2 = 8;
	icon_state = "4-8"
	},
/obj/machinery/atmospherics/pipe/simple/visible/black{
	dir = 10
	},
/turf/simulated/floor/tiled/steel_ridged,
/area/engineering/engine_room)
"tJ" = (
/obj/machinery/power/generator{
	anchored = 1;
	dir = 4
	},
/obj/structure/cable/yellow{
	d2 = 2;
	icon_state = "0-2"
	},
/turf/simulated/floor,
/area/engineering/engine_room)
"tL" = (
/turf/simulated/floor/reinforced/phoron,
/area/engineering/engine_room)
"ud" = (
/obj/structure/sign/vacuum,
/turf/simulated/wall/r_wall,
/area/engineering/engine_room)
"uF" = (
/obj/machinery/atmospherics/portables_connector{
	dir = 4
	},
/turf/simulated/floor/tiled/techmaint,
/area/engineering/engine_room)
"xl" = (
/obj/machinery/atmospherics/pipe/vent/high_volume{
	dir = 8
	},
/turf/simulated/floor/reinforced/oxygen,
/area/engineering/engine_room)
"xU" = (
/obj/machinery/atmospherics/pipe/simple/hidden/supply,
/obj/machinery/atmospherics/pipe/simple/hidden/scrubbers,
/obj/structure/cable/yellow{
	d1 = 1;
	d2 = 4;
	icon_state = "1-4"
	},
/turf/simulated/floor/tiled/steel_ridged,
/area/engineering/engine_room)
"xY" = (
/obj/machinery/atmospherics/pipe/simple/visible/blue{
	dir = 8
	},
/obj/structure/cable/yellow{
	d1 = 1;
	d2 = 2;
	icon_state = "1-2"
	},
/turf/simulated/floor/tiled/techfloor/grid,
/area/engineering/engine_room)
"yg" = (
/obj/structure/cable/yellow{
	d1 = 1;
	d2 = 2;
	icon_state = "1-2"
	},
/obj/machinery/atmospherics/pipe/simple/visible/red{
	dir = 6
	},
/turf/simulated/floor/tiled/steel_grid,
/area/engineering/engine_room)
"yk" = (
/obj/machinery/atmospherics/pipe/simple/hidden/aux{
	dir = 4
	},
/turf/simulated/floor/tiled/steel_grid,
/area/engineering/engine_room)
"zy" = (
/obj/machinery/atmospherics/pipe/simple/visible/green,
/obj/machinery/atmospherics/pipe/simple/visible/purple{
	dir = 4
	},
/turf/simulated/floor/tiled/techfloor/grid,
/area/engineering/engine_room)
"zz" = (
/obj/machinery/atmospherics/pipe/simple/hidden/scrubbers,
/obj/machinery/atmospherics/pipe/simple/hidden/supply,
/obj/machinery/door/firedoor/glass/hidden/steel{
	dir = 2
	},
/obj/structure/cable/yellow{
	d1 = 1;
	d2 = 2;
	icon_state = "1-2"
	},
/obj/machinery/atmospherics/pipe/simple/hidden/aux,
/turf/simulated/floor/tiled/steel_ridged,
/area/engineering/engine_room)
"zD" = (
/obj/machinery/atmospherics/pipe/simple/hidden/fuel{
	dir = 6
	},
/obj/machinery/atmospherics/pipe/manifold/hidden/supply{
	dir = 1
	},
/obj/machinery/atmospherics/pipe/manifold/hidden/scrubbers{
	dir = 8
	},
/turf/simulated/floor/tiled/steel_ridged,
/area/engineering/engine_room)
"Aq" = (
/obj/machinery/atmospherics/pipe/vent/high_volume{
	dir = 4
	},
/turf/simulated/floor/reinforced/phoron,
/area/engineering/engine_room)
"AG" = (
/obj/machinery/atmospherics/pipe/simple/heat_exchanging{
	dir = 6
	},
/turf/simulated/floor/reinforced/airless,
/area/engineering/engine_room)
"BC" = (
/obj/machinery/atmospherics/binary/pump/high_power{
	dir = 4
	},
/turf/simulated/floor/tiled/steel_grid,
/area/engineering/engine_room)
"BT" = (
/obj/machinery/atmospherics/pipe/simple/visible/purple{
	dir = 6
	},
/turf/simulated/floor/tiled/steel_ridged,
/area/engineering/engine_room)
"Ct" = (
/obj/machinery/atmospherics/pipe/simple/hidden/scrubbers,
/obj/machinery/atmospherics/pipe/manifold/visible/red{
	dir = 4
	},
/turf/simulated/floor/tiled/steel_grid,
/area/engineering/engine_room)
"CF" = (
/obj/machinery/atmospherics/unary/vent_pump/on{
	dir = 8
	},
/turf/simulated/floor/tiled/steel_grid,
/area/engineering/engine_room)
"Dq" = (
/turf/template_noop,
/area/space)
"DJ" = (
/obj/machinery/atmospherics/pipe/simple/visible/purple{
	dir = 4
	},
/obj/machinery/atmospherics/pipe/simple/visible/red,
/turf/simulated/floor/tiled/steel_ridged,
/area/engineering/engine_room)
"DU" = (
/obj/machinery/atmospherics/pipe/simple/visible/green{
	dir = 4
	},
/obj/machinery/light{
	dir = 1
	},
/turf/simulated/floor/tiled/techfloor/grid,
/area/engineering/engine_room)
"EA" = (
/obj/machinery/light{
	dir = 1
	},
/turf/simulated/floor/tiled/techfloor/grid,
/area/engineering/engine_room)
"EJ" = (
/obj/machinery/door/firedoor/glass/hidden/steel{
	dir = 2
	},
/turf/simulated/floor/tiled/steel_grid,
/area/engineering/engine_room)
"EU" = (
/obj/machinery/atmospherics/pipe/manifold/visible/red,
/turf/simulated/floor/tiled/steel_grid,
/area/engineering/engine_room)
"Fh" = (
/obj/machinery/atmospherics/pipe/simple/hidden/scrubbers{
	dir = 4
	},
/obj/machinery/atmospherics/pipe/simple/hidden/supply{
	dir = 4
	},
/obj/structure/cable/yellow{
	d1 = 4;
	d2 = 8;
	icon_state = "4-8"
	},
/obj/machinery/atmospherics/pipe/simple/visible/black{
	dir = 8
	},
/obj/machinery/light,
/turf/simulated/floor/tiled/steel_ridged,
/area/engineering/engine_room)
"FI" = (
/obj/machinery/atmospherics/pipe/simple/hidden/supply{
	dir = 4
	},
/obj/machinery/atmospherics/pipe/simple/hidden/scrubbers{
	dir = 9
	},
/obj/machinery/atmospherics/portables_connector{
	dir = 1
	},
/obj/item/paper{
	info = "To start up this engine:\n Fill one(1) canister of Phoron into the Blue Green Loop, to do that connect it with a wrench in the Corner.\n Then fill half a canister of phoron into the connector you found this paper on.\n Max all pumps in this room.\n begin injecting into the chamber via the console."
	},
/turf/simulated/floor/tiled/steel_ridged,
/area/engineering/engine_room)
"FP" = (
/obj/effect/floor_decal/industrial/outline,
/obj/machinery/atmospherics/pipe/simple/visible/red{
	dir = 4
	},
/obj/machinery/atmospherics/pipe/simple/visible/black,
/obj/machinery/atmospherics/pipe/simple/hidden/aux,
/turf/simulated/floor/tiled/steel_grid,
/area/engineering/engine_room)
"Gn" = (
/obj/machinery/atmospherics/pipe/simple/hidden/scrubbers{
	dir = 4
	},
/obj/machinery/atmospherics/pipe/simple/hidden/supply{
	dir = 4
	},
/obj/machinery/light,
/turf/simulated/floor/tiled/steel_ridged,
/area/engineering/engine_room)
"Gw" = (
/obj/machinery/atmospherics/pipe/simple/hidden/supply,
/obj/machinery/atmospherics/pipe/simple/hidden/scrubbers,
/obj/machinery/light{
	dir = 4
	},
/obj/structure/cable/yellow{
	d1 = 1;
	d2 = 2;
	icon_state = "1-2"
	},
/obj/machinery/atmospherics/pipe/simple/hidden/aux{
	dir = 9
	},
/turf/simulated/floor/tiled/steel_ridged,
/area/engineering/engine_room)
"Gz" = (
/obj/machinery/atmospherics/pipe/simple/hidden/scrubbers,
/obj/machinery/atmospherics/binary/pump/high_power{
	dir = 1
	},
/turf/simulated/floor/tiled/steel_grid,
/area/engineering/engine_room)
"GS" = (
/turf/simulated/floor/tiled/steel_ridged,
/area/engineering/engine_room)
"HD" = (
/obj/structure/window/phoronreinforced/full,
/obj/structure/grille,
/obj/machinery/atmospherics/pipe/simple/visible/universal,
/turf/simulated/floor/plating,
/area/engineering/engine_room)
"JD" = (
/turf/simulated/floor/tiled/steel_grid,
/area/engineering/engine_room)
"JN" = (
/obj/structure/grille,
/obj/structure/window/phoronreinforced/full,
/turf/simulated/floor/plating,
/area/engineering/engine_room)
"JQ" = (
/obj/machinery/atmospherics/pipe/manifold/visible/blue,
/obj/effect/floor_decal/industrial/hatch,
/obj/machinery/meter,
/turf/simulated/floor/tiled/techfloor/grid,
/area/engineering/engine_room)
"Ke" = (
/obj/machinery/atmospherics/pipe/simple/visible/blue{
	dir = 8
	},
/obj/effect/floor_decal/industrial/hatch/yellow,
/obj/machinery/atmospherics/pipe/simple/visible/red,
/turf/simulated/floor/tiled/techfloor/grid,
/area/engineering/engine_room)
"KH" = (
/obj/machinery/atmospherics/pipe/simple/hidden/scrubbers{
	dir = 4
	},
/obj/machinery/atmospherics/pipe/simple/hidden/supply{
	dir = 4
	},
/obj/structure/cable/yellow{
	d1 = 4;
	d2 = 8;
	icon_state = "4-8"
	},
/turf/simulated/floor/tiled/steel_ridged,
/area/engineering/engine_room)
"KN" = (
/obj/machinery/atmospherics/pipe/simple/visible/purple{
	dir = 4
	},
/turf/simulated/floor/tiled/steel_ridged,
/area/engineering/engine_room)
"KZ" = (
/turf/simulated/wall/r_wall,
/area/engineering/engine_room)
"Lp" = (
/obj/machinery/atmospherics/pipe/cap/visible{
	dir = 4
	},
/turf/simulated/floor/tiled/steel_grid,
/area/engineering/engine_room)
"LY" = (
/obj/machinery/atmospherics/pipe/simple/visible/purple{
	dir = 10
	},
/turf/simulated/floor/tiled/steel_ridged,
/area/engineering/engine_room)
"Mo" = (
/obj/machinery/atmospherics/pipe/simple/visible/red{
	dir = 4
	},
/turf/simulated/floor/tiled/steel_grid,
/area/engineering/engine_room)
"MD" = (
/obj/machinery/door/blast/regular{
	dir = 4;
	id = "EngineVent";
	name = "Reactor Vent"
	},
/turf/simulated/floor/reinforced/airless,
/area/engineering/engine_room)
"NJ" = (
/obj/effect/floor_decal/industrial/loading{
	dir = 4
	},
/obj/machinery/atmospherics/pipe/simple/visible/black,
/obj/machinery/atmospherics/pipe/simple/hidden/aux{
	dir = 10
	},
/turf/simulated/floor/tiled/steel_grid,
/area/engineering/engine_room)
"Og" = (
/obj/machinery/atmospherics/pipe/simple/visible/green{
	dir = 4
	},
/turf/simulated/floor/tiled/steel_ridged,
/area/engineering/engine_room)
"Oi" = (
/obj/machinery/atmospherics/pipe/manifold/visible/red,
/obj/machinery/meter,
/turf/simulated/floor/tiled/steel_grid,
/area/engineering/engine_room)
"Ok" = (
/obj/structure/cable/yellow{
	d1 = 1;
	d2 = 2;
	icon_state = "1-2"
	},
/obj/machinery/atmospherics/pipe/simple/visible/purple{
	dir = 4
	},
/obj/machinery/meter,
/turf/simulated/floor/tiled/steel_ridged,
/area/engineering/engine_room)
"Ol" = (
/obj/machinery/door/airlock/vault{
	name = "REACTOR ROOM";
	req_one_access = list(10)
	},
/obj/machinery/atmospherics/pipe/simple/hidden/supply,
/obj/machinery/atmospherics/pipe/simple/hidden/scrubbers,
/obj/machinery/door/firedoor,
/obj/machinery/atmospherics/pipe/simple/hidden/fuel,
/turf/simulated/floor/tiled/techfloor/grid,
/area/engineering/engine_room)
"On" = (
/obj/machinery/atmospherics/binary/circulator{
	anchored = 1
	},
/turf/simulated/floor,
/area/engineering/engine_room)
"OY" = (
/obj/machinery/atmospherics/pipe/simple/heat_exchanging{
	dir = 5
	},
/turf/simulated/floor/reinforced/airless,
/area/engineering/engine_room)
"Pv" = (
/obj/machinery/igniter,
/turf/simulated/floor/reinforced/airless,
/area/engineering/engine_room)
"PH" = (
/obj/effect/floor_decal/industrial/hatch,
/obj/machinery/meter,
/obj/machinery/atmospherics/pipe/simple/visible/purple{
	dir = 6
	},
/turf/simulated/floor/tiled/techfloor/grid,
/area/engineering/engine_room)
"Qp" = (
/obj/machinery/atmospherics/pipe/simple/visible/black{
	dir = 9
	},
/obj/machinery/meter,
/turf/simulated/floor/tiled/techmaint,
/area/engineering/engine_room)
"Qw" = (
/obj/machinery/door/firedoor,
/obj/machinery/door/airlock/vault{
	name = "REACTOR ROOM";
	req_one_access = list(10)
	},
/turf/simulated/floor/tiled/techfloor/grid,
/area/engineering/engine_room)
"Qx" = (
/obj/machinery/atmospherics/pipe/simple/visible/purple{
	dir = 9
	},
/turf/simulated/floor/tiled/steel_grid,
/area/engineering/engine_room)
"Qy" = (
/obj/machinery/atmospherics/pipe/simple/hidden/scrubbers{
	dir = 4
	},
/obj/machinery/atmospherics/pipe/simple/hidden/supply{
	dir = 4
	},
/obj/structure/cable/yellow{
	d1 = 1;
	d2 = 8;
	icon_state = "1-8"
	},
/turf/simulated/floor/tiled/steel_ridged,
/area/engineering/engine_room)
"RE" = (
/obj/effect/floor_decal/industrial/danger{
	dir = 1
	},
/obj/machinery/atmospherics/trinary/mixer{
	dir = 1;
	node1_concentration = 0.60;
	node2_concentration = 0.4
	},
/turf/simulated/floor/tiled/techmaint,
/area/engineering/engine_room)
"RI" = (
/obj/machinery/atmospherics/pipe/simple/visible/blue{
	dir = 9
	},
/obj/effect/floor_decal/industrial/hatch,
/turf/simulated/floor/tiled/techfloor/grid,
/area/engineering/engine_room)
"RY" = (
/obj/machinery/atmospherics/pipe/simple/hidden/scrubbers{
	dir = 10
	},
/turf/simulated/floor/tiled/steel_grid,
/area/engineering/engine_room)
"Tl" = (
/obj/machinery/door/firedoor,
/obj/structure/cable/yellow{
	d1 = 4;
	d2 = 8;
	icon_state = "4-8"
	},
/obj/machinery/door/airlock/vault{
	name = "REACTOR ROOM";
	req_one_access = list(10)
	},
/turf/simulated/floor/tiled/techfloor/grid,
/area/engineering/engine_room)
"TK" = (
/obj/machinery/atmospherics/pipe/simple/visible/green{
	dir = 10
	},
/turf/simulated/floor/tiled/techfloor/grid,
/area/engineering/engine_room)
"TW" = (
/obj/machinery/atmospherics/pipe/simple/hidden/scrubbers{
	dir = 4
	},
/obj/machinery/atmospherics/pipe/simple/hidden/supply{
	dir = 4
	},
/obj/structure/cable/yellow{
	d1 = 4;
	d2 = 8;
	icon_state = "4-8"
	},
/obj/machinery/atmospherics/pipe/simple/visible/black{
	dir = 8
	},
/turf/simulated/floor/tiled/steel_ridged,
/area/engineering/engine_room)
"Ul" = (
/obj/machinery/atmospherics/pipe/simple/heat_exchanging/junction{
	dir = 8
	},
/turf/simulated/floor/reinforced/airless,
/area/engineering/engine_room)
"Uu" = (
/obj/machinery/atmospherics/pipe/simple/hidden/supply{
	dir = 4
	},
/obj/machinery/atmospherics/pipe/simple/hidden/scrubbers{
	dir = 4
	},
/obj/machinery/door/firedoor,
/obj/structure/cable/cyan{
	d1 = 4;
	d2 = 8;
	icon_state = "4-8"
	},
/obj/machinery/atmospherics/pipe/simple/hidden/fuel{
	dir = 8
	},
/obj/machinery/door/airlock/vault{
	name = "REACTOR ROOM";
	req_one_access = list(10)
	},
/turf/simulated/floor/tiled/techfloor/grid,
/area/engineering/engine_room)
"UK" = (
/obj/machinery/atmospherics/pipe/manifold/visible/green{
	dir = 1
	},
/obj/machinery/alarm{
	pixel_y = 24
	},
/turf/simulated/floor/tiled/techfloor/grid,
/area/engineering/engine_room)
"UP" = (
/obj/machinery/door/airlock/maintenance/engi,
/obj/machinery/door/firedoor,
/turf/simulated/floor/plating,
/area/engineering/engine_room)
"Vm" = (
/obj/machinery/atmospherics/unary/vent_scrubber/on{
	dir = 8
	},
/turf/simulated/floor/tiled/steel_grid,
/area/engineering/engine_room)
"Vt" = (
/obj/machinery/button/remote/blast_door{
	id = "EngineVent";
	name = "Right Chamber Vent";
	pixel_x = -26;
	pixel_y = 7;
	req_access = list(10)
	},
/obj/machinery/atmospherics/pipe/simple/hidden/supply{
	dir = 6
	},
/obj/machinery/atmospherics/pipe/simple/visible/black{
	dir = 5
	},
/obj/structure/cable/yellow{
	d1 = 2;
	d2 = 8;
	icon_state = "1-8";
	dir = 1
	},
/obj/machinery/atmospherics/pipe/simple/hidden/scrubbers{
	dir = 6
	},
/obj/machinery/atmospherics/pipe/simple/hidden/aux,
/turf/simulated/floor/tiled/steel_ridged,
/area/engineering/engine_room)
"VN" = (
/obj/effect/floor_decal/industrial/hatch,
/obj/machinery/atmospherics/pipe/manifold/visible/purple{
	dir = 1
	},
/turf/simulated/floor/tiled/techfloor/grid,
/area/engineering/engine_room)
"VO" = (
/obj/machinery/atmospherics/pipe/simple/heat_exchanging/junction{
	dir = 8
	},
/obj/machinery/atmospherics/unary/outlet_injector{
	dir = 1;
	frequency = 1445;
	id = "burn_chamber1_in";
	volume_rate = 700
	},
/turf/simulated/floor/reinforced/airless,
/area/engineering/engine_room)
"VQ" = (
/obj/machinery/atmospherics/pipe/simple/visible/black{
	dir = 8
	},
/obj/machinery/meter,
/turf/simulated/floor/tiled/steel_grid,
/area/engineering/engine_room)
"Wr" = (
/obj/machinery/atmospherics/pipe/simple/hidden/scrubbers,
/obj/machinery/atmospherics/pipe/simple/hidden/supply,
/obj/machinery/door/firedoor,
/obj/machinery/door/airlock/vault{
	name = "REACTOR ROOM";
	req_one_access = list(10)
	},
/turf/simulated/floor/tiled/techfloor/grid,
/area/engineering/engine_room)
"Ww" = (
/obj/machinery/atmospherics/pipe/manifold/visible/cyan,
/turf/simulated/floor/tiled/steel_grid,
/area/engineering/engine_room)
"WF" = (
/obj/machinery/atmospherics/pipe/simple/visible/purple{
	dir = 4
	},
/turf/simulated/floor/tiled/techfloor/grid,
/area/engineering/engine_room)
"WG" = (
/obj/structure/cable/yellow{
	d1 = 1;
	d2 = 2;
	icon_state = "1-2"
	},
/turf/simulated/floor/tiled/techfloor/grid,
/area/engineering/engine_room)
"WJ" = (
/obj/machinery/atmospherics/pipe/simple/hidden/supply,
/obj/machinery/atmospherics/pipe/simple/hidden/scrubbers,
/obj/structure/cable/yellow{
	d1 = 1;
	d2 = 2;
	icon_state = "1-2"
	},
/obj/machinery/atmospherics/pipe/simple/hidden/aux,
/turf/simulated/floor/tiled/steel_ridged,
/area/engineering/engine_room)
"WM" = (
/obj/machinery/atmospherics/unary/vent_scrubber/on{
	dir = 4;
	scrubbing_gas = list(/datum/gas/carbon_dioxide)
	},
/turf/simulated/floor/reinforced/airless,
/area/engineering/engine_room)
"Xs" = (
/obj/machinery/atmospherics/pipe/simple/visible/green{
	dir = 4
	},
/turf/simulated/floor/tiled/steel_grid,
/area/engineering/engine_room)
"XI" = (
/obj/machinery/atmospherics/pipe/simple/hidden/scrubbers{
	dir = 6
	},
/obj/machinery/atmospherics/pipe/simple/visible/purple{
	dir = 9
	},
/turf/simulated/floor/tiled/steel_ridged,
/area/engineering/engine_room)
"XO" = (
/obj/structure/cable/yellow{
	d1 = 1;
	d2 = 2;
	icon_state = "1-2"
	},
/obj/machinery/atmospherics/pipe/simple/visible/purple{
	dir = 4
	},
/turf/simulated/floor/tiled/steel_ridged,
/area/engineering/engine_room)
"Yi" = (
/obj/machinery/door/blast/regular{
	density = 0;
	icon_state = "pdoor0";
	id = "EngineRadiatorViewport";
	name = "Engine Radiator Viewport Shutter";
	opacity = 0
	},
/turf/simulated/floor/tiled/techfloor/grid,
/area/engineering/engine_room)
"YF" = (
/obj/machinery/atmospherics/pipe/simple/hidden/scrubbers,
/obj/machinery/atmospherics/pipe/simple/visible/red{
	dir = 10
	},
/turf/simulated/floor/tiled/steel_grid,
/area/engineering/engine_room)
"ZG" = (
/obj/machinery/atmospherics/pipe/simple/visible/red{
	dir = 4
	},
/turf/simulated/floor/reinforced/airless,
/area/engineering/engine_room)
"ZM" = (
/obj/machinery/atmospherics/pipe/simple/visible/black{
	dir = 10
	},
/turf/simulated/floor/tiled/steel_ridged,
/area/engineering/engine_room)

(1,1,1) = {"
Dq
Dq
Dq
Dq
Dq
ud
dn
dn
dn
JN
JN
JN
JN
ud
Dq
Dq
Dq
Dq
Dq
"}
(2,1,1) = {"
Dq
Dq
Dq
Dq
Dq
MD
AG
gd
gd
gd
gd
gd
OY
JN
Dq
Dq
Dq
Dq
Dq
"}
(3,1,1) = {"
Dq
Dq
Dq
Dq
Dq
MD
kL
Pv
AG
gd
gd
gd
qt
JN
Dq
oP
Dq
Dq
Dq
"}
(4,1,1) = {"
KZ
Yi
Yi
Yi
KZ
dn
kL
WM
eW
dn
dn
dn
dn
KZ
Yi
oY
Yi
KZ
KZ
"}
(5,1,1) = {"
KZ
es
eA
Ww
pT
HD
VO
ZG
Ul
dn
JD
JD
JD
JD
EJ
mZ
cj
pF
KZ
"}
(6,1,1) = {"
UP
Xs
JD
BC
VQ
KZ
rH
rH
rH
KZ
JD
JD
JD
JD
EJ
yk
RY
zD
Ol
"}
(7,1,1) = {"
KZ
Og
GS
iB
ZM
gt
pD
NJ
FP
Vt
WJ
WJ
WJ
WJ
zz
Gw
xU
nN
KZ
"}
(8,1,1) = {"
KZ
DU
mz
jC
mz
BT
Qx
JD
Mo
Fh
KZ
dn
dn
KZ
KZ
KZ
Tl
Uu
KZ
"}
(9,1,1) = {"
KZ
ey
mz
pL
cz
KN
Lp
JD
Mo
TW
dn
tL
jD
KZ
gV
gV
gV
gV
gV
"}
(10,1,1) = {"
KZ
UK
jc
ip
JQ
KN
Mo
JD
Mo
TW
dn
Aq
eu
KZ
gV
gV
gV
gV
gV
"}
(11,1,1) = {"
KZ
ey
mz
tJ
xY
Ok
ke
eh
ke
bR
KZ
rH
rH
KZ
gV
gV
gV
gV
gV
"}
(12,1,1) = {"
KZ
ey
PH
On
Ke
DJ
Oi
JD
Mo
to
RE
Qp
je
KZ
as
as
gV
gV
gV
"}
(13,1,1) = {"
KZ
bf
WF
mz
jC
KN
Mo
JD
Mo
KH
iV
qm
uF
KZ
as
as
gV
gV
gV
"}
(14,1,1) = {"
KZ
ey
WF
mz
jC
KN
Mo
JD
Mo
KH
KZ
rH
rH
KZ
gV
gV
gV
gV
gV
"}
(15,1,1) = {"
KZ
TK
zy
ip
RI
KN
Mo
JD
Mo
KH
dn
xl
rT
KZ
gV
gV
gV
gV
gV
"}
(16,1,1) = {"
KZ
mz
WF
tJ
WG
XO
ke
yg
ba
Qy
dn
rX
jO
KZ
gV
gV
gV
gV
gV
"}
(17,1,1) = {"
KZ
EA
VN
On
in
DJ
EU
ja
JD
Gn
KZ
dn
dn
KZ
gV
gV
gV
gV
gV
"}
(18,1,1) = {"
KZ
GS
LY
pO
pO
XI
YF
Ct
Gz
FI
GS
GS
GS
Qw
gV
gV
gV
gV
gV
"}
(19,1,1) = {"
KZ
GS
JD
JD
JD
Vm
JD
JD
JD
CF
JD
JD
GS
Wr
gV
gV
gV
gV
gV
"}
