"a" = (/turf/simulated/mineral/floor/virgo3b,/area/mine/explored/underdark)
"b" = (/turf/simulated/mineral/virgo3b/rich,/area/mine/explored/underdark)
"c" = (/obj/tether_away_spawner/underdark_boss,/turf/simulated/mineral/floor/virgo3b,/area/mine/explored/underdark)

(1,1,1) = {"
bbbaaaabbb
bbaaaaaabb
baaaaaaaab
aaaaaaaaaa
aaaaaaaaaa
aaaacaaaaa
aaaaaaaaaa
baaaaaaaab
bbaaaaaabb
bbbaaaabbb
"}
