//MAP CONVERTED BY dmm2tgm.py THIS HEADER COMMENT PREVENTS RECONVERSION, DO NOT REMOVE
"a" = (
/turf/template_noop,
/area/template_noop)
"e" = (
/obj/structure/lattice,
/turf/template_noop,
/area/submap/skyplanet/poi/ruins2)
"g" = (
/turf/simulated/floor/plating,
/area/submap/skyplanet/poi/ruins2)
"h" = (
/obj/random/multiple/corp_crate,
/turf/simulated/floor/tiled/steel_dirty,
/area/submap/skyplanet/poi/ruins2)
"i" = (
/turf/simulated/floor/tiled/steel_dirty,
/area/template_noop)
"l" = (
/obj/structure/lattice,
/turf/simulated/floor/outdoors/ash_sand,
/area/template_noop)
"p" = (
/obj/random/mob/robotic,
/turf/simulated/floor/tiled/steel_dirty,
/area/submap/skyplanet/poi/ruins2)
"r" = (
/obj/random/multiple/large_corp_crate,
/turf/simulated/floor/tiled/steel_dirty,
/area/submap/skyplanet/poi/ruins2)
"v" = (
/turf/simulated/floor/plating,
/area/template_noop)
"w" = (
/obj/random/firstaid,
/turf/simulated/floor/tiled/steel_dirty,
/area/submap/skyplanet/poi/ruins2)
"z" = (
/obj/random/medical/pillbottle,
/turf/simulated/floor/tiled/steel_dirty,
/area/submap/skyplanet/poi/ruins2)
"A" = (
/obj/structure/lattice,
/turf/template_noop,
/area/template_noop)
"B" = (
/obj/random/drinkbottle,
/turf/simulated/floor/tiled/steel_dirty,
/area/submap/skyplanet/poi/ruins2)
"D" = (
/obj/random/cutout,
/turf/simulated/floor/tiled/steel_dirty,
/area/submap/skyplanet/poi/ruins2)
"I" = (
/obj/structure/lattice,
/obj/structure/lattice,
/turf/template_noop,
/area/template_noop)
"K" = (
/obj/structure/lattice,
/turf/simulated/floor/outdoors/ash_sand,
/area/submap/skyplanet/poi/ruins2)
"Q" = (
/turf/simulated/floor/outdoors/ash_sand,
/area/template_noop)
"T" = (
/turf/simulated/floor/tiled/steel_dirty,
/area/submap/skyplanet/poi/ruins2)
"V" = (
/obj/random/mob/robotic,
/turf/simulated/floor/plating,
/area/submap/skyplanet/poi/ruins2)
"W" = (
/turf/simulated/wall/r_wall,
/area/submap/skyplanet/poi/ruins2)
"Y" = (
/turf/simulated/wall/r_wall,
/area/template_noop)
"Z" = (
/obj/spawner/window/low_wall/firelocks,
/turf/simulated/floor/plating,
/area/submap/skyplanet/poi/ruins2)

(1,1,1) = {"
a
a
a
a
a
a
a
a
a
a
a
a
a
a
a
a
a
a
a
a
"}
(2,1,1) = {"
a
a
a
a
A
l
W
Z
Z
W
W
W
a
a
a
a
a
a
a
a
"}
(3,1,1) = {"
a
a
a
a
A
i
W
g
w
T
B
W
a
a
a
a
a
a
a
a
"}
(4,1,1) = {"
a
a
a
A
l
v
W
r
T
T
T
W
Q
a
a
a
a
a
a
a
"}
(5,1,1) = {"
a
a
I
l
v
v
W
T
T
V
g
Z
Q
Q
a
a
a
a
a
a
"}
(6,1,1) = {"
a
a
A
i
v
i
W
h
z
T
g
W
Q
Q
a
a
a
a
a
a
"}
(7,1,1) = {"
a
a
W
W
W
T
W
W
W
W
g
W
Q
Q
Q
a
a
a
a
a
"}
(8,1,1) = {"
a
a
W
T
T
T
g
e
K
K
T
Z
Q
Q
Q
Q
a
a
a
a
"}
(9,1,1) = {"
a
a
W
D
V
T
e
K
K
g
p
W
Q
Q
Q
Q
Q
a
a
a
"}
(10,1,1) = {"
a
a
W
D
T
g
K
e
K
T
T
W
Y
Y
Q
Q
Q
a
a
a
"}
(11,1,1) = {"
a
a
W
W
W
Z
Z
Z
Z
W
W
W
Y
Y
Y
Q
Q
a
a
a
"}
(12,1,1) = {"
a
a
a
a
Q
Q
Q
Q
Q
Y
Y
Y
Y
Y
Y
Y
Q
Q
a
a
"}
(13,1,1) = {"
a
a
a
a
a
Q
Q
Q
Q
Y
Y
Y
Y
Y
Y
Y
Q
Q
a
a
"}
(14,1,1) = {"
a
a
a
a
a
a
Q
Q
Q
Y
Y
Y
Y
Y
Y
Y
Y
Q
a
a
"}
(15,1,1) = {"
a
a
a
a
a
a
a
Q
Q
Y
Y
Y
Y
Y
Y
Y
Y
Q
Q
a
"}
(16,1,1) = {"
a
a
a
a
a
a
a
a
Q
Q
Q
Y
Y
Y
Y
Y
Y
Q
Q
a
"}
(17,1,1) = {"
a
a
a
a
a
a
a
a
Q
Q
Q
Q
Y
Y
Y
Y
Q
Q
Q
a
"}
(18,1,1) = {"
a
a
a
a
a
a
a
a
a
Q
Q
Q
Q
Q
Q
Q
Q
Q
Q
a
"}
(19,1,1) = {"
a
a
a
a
a
a
a
a
a
a
a
a
Q
Q
Q
Q
Q
a
a
a
"}
(20,1,1) = {"
a
a
a
a
a
a
a
a
a
a
a
a
a
a
a
a
a
a
a
a
"}
