//MAP CONVERTED BY dmm2tgm.py THIS HEADER COMMENT PREVENTS RECONVERSION, DO NOT REMOVE
"a" = (
/turf/simulated/floor/outdoors/ash_sand/outdoors,
/area/template_noop)
"b" = (
/obj/effect/floor_decal/rust,
/turf/simulated/floor/tiled/techfloor/lythios43c,
/area/submap/skyplanet/poi/shuttlecrash2)
"c" = (
/obj/structure/bed/chair/shuttle{
	dir = 4
	},
/obj/item/clothing/mask/breath/emergency,
/obj/item/tank/emergency/oxygen,
/turf/simulated/floor/carpet,
/area/submap/skyplanet/poi/shuttlecrash2)
"d" = (
/obj/item/trash/liquidprotein,
/turf/simulated/floor/tiled/techfloor,
/area/submap/skyplanet/poi/shuttlecrash2)
"e" = (
/obj/structure/lattice,
/turf/simulated/floor/outdoors/ash_sand/outdoors,
/area/template_noop)
"i" = (
/turf/simulated/floor/tiled/techfloor,
/area/submap/skyplanet/poi/shuttlecrash2)
"k" = (
/obj/structure/bed/chair/shuttle{
	dir = 4
	},
/turf/simulated/floor/tiled/techfloor/lythios43c,
/area/template_noop)
"p" = (
/turf/simulated/floor/tiled/white,
/area/submap/skyplanet/poi/shuttlecrash2)
"q" = (
/obj/item/trash/chips,
/obj/effect/floor_decal/rust,
/turf/simulated/floor/tiled/techfloor/lythios43c,
/area/template_noop)
"s" = (
/obj/structure/table,
/turf/simulated/floor/tiled/techfloor/lythios43c,
/area/submap/skyplanet/poi/shuttlecrash2)
"u" = (
/obj/effect/floor_decal/rust,
/turf/simulated/floor/tiled/white,
/area/submap/skyplanet/poi/shuttlecrash2)
"v" = (
/turf/simulated/wall/prepainted/civilian,
/area/submap/skyplanet/poi/shuttlecrash2)
"x" = (
/obj/effect/floor_decal/rust,
/turf/simulated/floor/plating,
/area/submap/skyplanet/poi/shuttlecrash2)
"y" = (
/obj/effect/floor_decal/rust,
/turf/simulated/floor/tiled/techfloor,
/area/submap/skyplanet/poi/shuttlecrash2)
"z" = (
/obj/spawner/window/reinforced/full,
/turf/simulated/floor/tiled/techfloor,
/area/submap/skyplanet/poi/shuttlecrash2)
"C" = (
/obj/item/trash/chips,
/obj/effect/floor_decal/rust,
/turf/simulated/floor/tiled/techfloor,
/area/submap/skyplanet/poi/shuttlecrash2)
"E" = (
/obj/structure/lattice,
/turf/template_noop,
/area/template_noop)
"F" = (
/turf/template_noop,
/area/submap/skyplanet/poi/shuttlecrash2)
"G" = (
/turf/template_noop,
/area/template_noop)
"H" = (
/turf/simulated/floor/tiled/techfloor/lythios43c,
/area/template_noop)
"I" = (
/obj/structure/bed/chair/shuttle{
	dir = 4
	},
/obj/item/storage/secure/briefcase/trashmoney,
/turf/simulated/floor/carpet,
/area/submap/skyplanet/poi/shuttlecrash2)
"J" = (
/obj/item/trash/diggerstew,
/turf/simulated/floor/tiled/white,
/area/submap/skyplanet/poi/shuttlecrash2)
"K" = (
/obj/effect/floor_decal/rust,
/turf/simulated/floor/plating,
/area/template_noop)
"L" = (
/turf/simulated/wall/prepainted,
/area/submap/skyplanet/poi/shuttlecrash2)
"M" = (
/obj/effect/floor_decal/rust,
/turf/simulated/floor/tiled/techfloor/lythios43c,
/area/template_noop)
"N" = (
/obj/structure/bed/chair/shuttle{
	dir = 4
	},
/obj/item/trash/liquidprotein,
/turf/simulated/floor/carpet,
/area/submap/skyplanet/poi/shuttlecrash2)
"P" = (
/obj/structure/bed/chair/shuttle{
	dir = 4
	},
/turf/simulated/floor/carpet,
/area/submap/skyplanet/poi/shuttlecrash2)
"Q" = (
/obj/structure/bed/chair/shuttle{
	dir = 4
	},
/obj/item/clothing/mask/breath/emergency,
/turf/simulated/floor/carpet,
/area/submap/skyplanet/poi/shuttlecrash2)
"R" = (
/obj/structure/bed/chair/shuttle{
	dir = 4
	},
/obj/item/clothing/mask/breath/emergency,
/obj/item/clothing/mask/breath/emergency,
/obj/item/tank/emergency/oxygen,
/turf/simulated/floor/carpet,
/area/submap/skyplanet/poi/shuttlecrash2)
"T" = (
/obj/structure/table,
/turf/simulated/floor/tiled/techfloor,
/area/submap/skyplanet/poi/shuttlecrash2)
"U" = (
/obj/item/trash/semki,
/turf/simulated/floor/plating,
/area/submap/skyplanet/poi/shuttlecrash2)
"V" = (
/obj/machinery/atmospherics/component/unary/engine{
	dir = 4
	},
/turf/template_noop,
/area/template_noop)
"W" = (
/turf/simulated/floor/plating,
/area/template_noop)
"X" = (
/obj/structure/bed/chair/shuttle{
	dir = 4
	},
/obj/item/storage/secure/briefcase/rifle,
/turf/simulated/floor/tiled/techfloor/lythios43c,
/area/template_noop)
"Z" = (
/obj/structure/bed/chair/shuttle{
	dir = 4
	},
/obj/item/storage/secure/briefcase,
/turf/simulated/floor/carpet,
/area/submap/skyplanet/poi/shuttlecrash2)

(1,1,1) = {"
G
V
V
V
a
a
V
V
V
G
"}
(2,1,1) = {"
G
v
v
v
F
F
v
v
v
G
"}
(3,1,1) = {"
G
v
y
i
p
p
y
d
v
a
"}
(4,1,1) = {"
G
L
T
C
u
J
y
i
L
a
"}
(5,1,1) = {"
a
L
T
y
u
p
i
y
L
a
"}
(6,1,1) = {"
a
L
L
L
u
p
L
L
L
a
"}
(7,1,1) = {"
G
L
P
Z
u
p
P
Q
L
a
"}
(8,1,1) = {"
a
z
Q
P
u
p
P
R
z
a
"}
(9,1,1) = {"
a
v
N
P
u
u
N
P
v
a
"}
(10,1,1) = {"
a
z
P
P
p
x
Q
P
z
a
"}
(11,1,1) = {"
a
v
P
Q
p
u
P
I
v
a
"}
(12,1,1) = {"
a
z
P
P
U
u
P
c
z
a
"}
(13,1,1) = {"
a
L
c
P
u
x
Q
P
L
a
"}
(14,1,1) = {"
a
L
L
L
x
x
L
L
L
a
"}
(15,1,1) = {"
a
L
s
s
x
x
b
b
L
a
"}
(16,1,1) = {"
a
G
X
H
K
K
q
k
a
a
"}
(17,1,1) = {"
G
a
M
M
K
W
M
H
a
a
"}
(18,1,1) = {"
G
G
E
E
W
W
M
e
a
G
"}
(19,1,1) = {"
G
G
G
H
a
E
M
a
a
G
"}
(20,1,1) = {"
G
G
G
G
E
W
a
a
G
G
"}
