//MAP CONVERTED BY dmm2tgm.py THIS HEADER COMMENT PREVENTS RECONVERSION, DO NOT REMOVE
"a" = (
/turf/simulated/floor/outdoors/ash_sand,
/area/template_noop)
"c" = (
/obj/machinery/atmospherics/component/unary/engine/biggest{
	dir = 1
	},
/turf/simulated/floor/outdoors/ash_sand,
/area/template_noop)
"i" = (
/turf/simulated/floor/plating,
/area/submap/skyplanet/poi/shuttlecrash4)
"k" = (
/obj/structure/table/rack/shelf/steel,
/obj/structure/ship_munition/disperser_charge/explosive,
/turf/simulated/floor/tiled/techfloor/grid,
/area/submap/skyplanet/poi/shuttlecrash4)
"l" = (
/turf/simulated/floor/outdoors/ash_sand,
/area/submap/skyplanet/poi/shuttlecrash4)
"m" = (
/obj/machinery/conveyor{
	dir = 1;
	id = "courser_magazine_2"
	},
/turf/simulated/floor/tiled/techfloor/grid,
/area/submap/skyplanet/poi/shuttlecrash4)
"n" = (
/turf/simulated/wall/r_wall,
/area/submap/skyplanet/poi/shuttlecrash4)
"q" = (
/obj/spawner/window/low_wall/firelocks,
/turf/simulated/floor/tiled/techfloor/grid,
/area/submap/skyplanet/poi/shuttlecrash4)
"s" = (
/turf/simulated/floor/tiled/techfloor/monogrid,
/area/submap/skyplanet/poi/shuttlecrash4)
"x" = (
/turf/template_noop,
/area/template_noop)
"A" = (
/obj/structure/loot_pile/maint/junk,
/turf/simulated/floor/tiled/techfloor/grid,
/area/submap/skyplanet/poi/shuttlecrash4)
"D" = (
/obj/effect/floor_decal/rust,
/turf/simulated/floor/tiled/techfloor/grid/lythios43c,
/area/template_noop)
"F" = (
/obj/machinery/disperser/front{
	dir = 1
	},
/turf/simulated/floor/tiled/techfloor/grid,
/area/submap/skyplanet/poi/shuttlecrash4)
"G" = (
/obj/structure/table/rack/shelf/steel,
/obj/structure/ship_munition/disperser_charge/mining,
/turf/simulated/floor/plating,
/area/submap/skyplanet/poi/shuttlecrash4)
"H" = (
/turf/simulated/floor/tiled/steel_dirty/outdoors,
/area/template_noop)
"I" = (
/turf/simulated/floor/tiled/techfloor/grid/lythios43c,
/area/template_noop)
"Q" = (
/obj/effect/floor_decal/rust,
/turf/simulated/floor/tiled/steel_dirty/outdoors,
/area/template_noop)
"U" = (
/obj/effect/floor_decal/rust,
/turf/simulated/floor/plating,
/area/submap/skyplanet/poi/shuttlecrash4)
"V" = (
/obj/structure/salvageable/console_broken_os,
/turf/simulated/floor/tiled/techfloor/monogrid,
/area/submap/skyplanet/poi/shuttlecrash4)
"W" = (
/obj/machinery/computer/ship/disperser,
/turf/simulated/floor/tiled/techfloor/monogrid,
/area/submap/skyplanet/poi/shuttlecrash4)
"X" = (
/obj/machinery/conveyor{
	dir = 1;
	id = "courser_magazine_2"
	},
/obj/structure/loot_pile/maint/junk,
/turf/simulated/floor/tiled/techfloor/grid,
/area/submap/skyplanet/poi/shuttlecrash4)
"Z" = (
/obj/spawner/window/low_wall/firelocks,
/turf/template_noop,
/area/submap/skyplanet/poi/shuttlecrash4)

(1,1,1) = {"
x
x
x
x
x
x
x
x
x
x
x
x
x
x
x
x
x
x
x
x
x
x
x
x
x
"}
(2,1,1) = {"
x
x
x
x
x
a
a
a
a
a
a
x
x
x
x
x
x
a
x
x
x
x
x
x
x
"}
(3,1,1) = {"
x
x
x
x
a
a
Q
D
I
a
a
a
x
a
x
x
x
x
x
x
x
x
x
x
x
"}
(4,1,1) = {"
x
a
x
x
x
x
a
Q
D
I
a
a
x
a
a
x
x
x
x
a
x
x
x
x
x
"}
(5,1,1) = {"
x
x
x
x
x
a
a
x
Q
H
H
x
a
a
a
a
a
x
x
x
x
x
x
x
x
"}
(6,1,1) = {"
x
x
x
x
a
Z
q
n
n
s
n
n
a
a
a
a
x
x
x
a
x
x
x
x
x
"}
(7,1,1) = {"
x
x
x
a
a
q
W
U
U
U
k
n
n
l
l
c
a
a
a
x
x
x
a
x
x
"}
(8,1,1) = {"
x
x
x
a
n
n
n
U
V
U
G
n
n
l
l
a
a
a
x
x
x
x
x
x
x
"}
(9,1,1) = {"
x
x
a
a
F
A
X
m
V
i
G
n
n
l
l
a
a
x
x
a
x
x
x
x
x
"}
(10,1,1) = {"
a
x
x
a
n
n
n
n
n
n
n
n
a
a
a
a
a
x
x
x
x
x
x
x
x
"}
(11,1,1) = {"
x
x
x
x
a
a
a
a
H
H
H
a
a
x
x
x
x
x
a
a
x
a
a
x
x
"}
(12,1,1) = {"
x
x
x
x
x
a
a
H
I
D
a
a
a
a
a
a
a
a
x
x
x
x
x
x
x
"}
(13,1,1) = {"
x
x
x
x
a
a
H
I
D
x
a
a
a
a
x
x
x
x
x
a
x
x
x
x
x
"}
(14,1,1) = {"
x
x
x
x
x
x
a
a
a
x
x
x
x
x
x
x
x
x
x
x
x
x
x
x
x
"}
(15,1,1) = {"
x
x
x
x
x
x
x
x
x
x
x
x
x
x
x
x
x
x
x
x
x
x
x
x
x
"}
