"a" = (/turf/template_noop,/area/template_noop)
"c" = (/obj/machinery/seed_storage/xenobotany,/turf/simulated/floor/tiled,/area/lavaland/idleruins)
"f" = (/obj/effect/decal/remains,/obj/item/clothing/under/rank/hydroponics,/obj/item/clothing/suit/storage/toggle/labcoat/green,/obj/item/clothing/head/greenbandana,/turf/simulated/floor/tiled,/area/lavaland/idleruins)
"m" = (/obj/machinery/portable_atmospherics/hydroponics,/turf/simulated/floor/outdoors/grass,/area/lavaland/idleruins)
"n" = (/obj/machinery/vending/hydronutrients,/turf/simulated/floor/tiled,/area/lavaland/idleruins)
"q" = (/obj/structure/bed/roller,/turf/simulated/floor/tiled,/area/lavaland/idleruins)
"r" = (/obj/machinery/seed_extractor,/turf/simulated/floor/tiled,/area/lavaland/idleruins)
"A" = (/turf/simulated/floor/outdoors/lavaland,/area/lavaland/idleruins)
"B" = (/obj/machinery/botany/editor,/turf/simulated/floor/tiled,/area/lavaland/idleruins)
"F" = (/obj/structure/reagent_dispensers/watertank/high,/turf/simulated/floor/tiled,/area/lavaland/idleruins)
"H" = (/obj/item/reagent_containers/spray/chemsprayer,/turf/simulated/floor/tiled,/area/lavaland/idleruins)
"I" = (/turf/template_noop,/area/lavaland/idleruins)
"M" = (/turf/simulated/mineral/floor/cave,/area/lavaland/idleruins)
"N" = (/turf/simulated/wall/wood,/area/lavaland/idleruins)
"P" = (/obj/item/reagent_containers/spray/plantbgone,/turf/simulated/floor/tiled,/area/lavaland/idleruins)
"U" = (/obj/item/seeds/killertomatoseed,/turf/simulated/floor/tiled,/area/lavaland/idleruins)
"W" = (/turf/simulated/floor/tiled,/area/lavaland/idleruins)
"X" = (/obj/structure/table/rack,/obj/item/shovel/spade,/obj/item/shovel/spade,/obj/item/material/minihoe,/obj/item/material/minihoe,/obj/item/material/knife/machete/hatchet,/obj/item/material/knife/machete/hatchet,/obj/item/reagent_containers/glass/bucket,/obj/item/reagent_containers/glass/bucket,/obj/item/analyzer/plant_analyzer,/obj/item/analyzer/plant_analyzer,/turf/simulated/floor/tiled,/area/lavaland/idleruins)
"Y" = (/turf/simulated/floor/outdoors/lavaland,/area/template_noop)
"Z" = (/obj/machinery/botany/extractor,/turf/simulated/floor/tiled,/area/lavaland/idleruins)

(1,1,1) = {"
aaaaaaaaaaaaaaa
aaaaaaaaaaaaaaa
aAAAIIIIIIAAAAY
aANNNNNNNNNNNAY
aINmqBnrcZPmNAa
aINmUWWWWPHmNIa
aINmWWWFWWfmNIa
aINmWWWXWWWmNIa
aANmWWWWWWWmNAY
aANmWWWWWWUmNAY
aANNNNNWNNNNNAa
aAAAANWWWNAAAAa
aIAAAAAAAAAAAIa
aIAAAAAAAAAAMIa
aaaaaaaaaaaaaaa
"}
