"a" = (/turf/simulated/mineral/floor/cave,/area/template_noop)
"m" = (/obj/effect/decal/cleanable/blood,/turf/simulated/floor/outdoors/dirt/lavaland,/area/triumph_away/lavaland/horrors)
"o" = (/obj/structure/table/bench/sifwooden,/obj/effect/decal/cleanable/blood/gibs,/turf/simulated/floor/outdoors/dirt/lavaland,/area/triumph_away/lavaland/horrors)
"p" = (/obj/effect/decal/cleanable/blood,/obj/effect/decal/cleanable/blood,/turf/simulated/floor/outdoors/dirt/lavaland,/area/triumph_away/lavaland/horrors)
"u" = (/turf/template_noop,/area/template_noop)
"x" = (/obj/structure/statue/gold/rd,/turf/simulated/floor/outdoors/dirt/lavaland,/area/triumph_away/lavaland/horrors)
"M" = (/turf/simulated/floor/outdoors/dirt/lavaland,/area/template_noop)
"S" = (/obj/item/flame/candle/candelabra/everburn,/turf/simulated/floor/outdoors/dirt/lavaland,/area/triumph_away/lavaland/horrors)
"T" = (/turf/simulated/mineral/floor/cave,/area/triumph_away/lavaland/horrors)
"Y" = (/obj/structure/table/bench/sifwooden,/obj/effect/decal/cleanable/blood/gibs,/obj/effect/decal/cleanable/blood,/turf/simulated/floor/outdoors/dirt/lavaland,/area/triumph_away/lavaland/horrors)
"Z" = (/turf/simulated/floor/outdoors/dirt/lavaland,/area/triumph_away/lavaland/horrors)

(1,1,1) = {"
auuuuuuuuuuuuuu
TTZZZTaaaaaaauu
ZZZmZZZZZZZZZau
TZZZZZSxSZmZTau
TTTZZZZpZZZTTau
aTTTZYoZooZZTau
aMZTZZZZZZZZTau
uMZTTooZYoZZZau
uMZTZZZZZZZmZMu
uMZZZYoZooZZZau
uMmZZZZZZZZZTau
uMZZZZSZSTZZTau
uMZZZZTTTTTTTau
uuMMaaaaaaaaauu
uuuuuuuuuuuuuuu
"}
