"gJ" = (/turf/simulated/floor/plating,/area/triumph_away/lavaland/idleruins)
"hd" = (/obj/effect/decal/cleanable/blood/oil,/turf/simulated/shuttle/floor,/area/triumph_away/lavaland/idleruins)
"hv" = (/obj/structure/shuttle/window,/obj/structure/grille,/turf/simulated/floor/plating,/area/triumph_away/lavaland/idleruins)
"jd" = (/obj/effect/decal/cleanable/generic,/turf/simulated/mineral/floor/cave,/area/triumph_away/lavaland/idleruins)
"nr" = (/obj/structure/frame,/turf/simulated/shuttle/floor,/area/triumph_away/lavaland/idleruins)
"or" = (/turf/template_noop,/area/template_noop)
"oN" = (/obj/item/material/shard/shrapnel,/turf/simulated/mineral/floor/cave,/area/triumph_away/lavaland/idleruins)
"qO" = (/obj/structure/table/standard,/obj/random/unidentified_medicine/fresh_medicine,/obj/random/unidentified_medicine/fresh_medicine,/obj/random/unidentified_medicine/old_medicine,/turf/simulated/shuttle/floor,/area/triumph_away/lavaland/idleruins)
"ri" = (/obj/structure/table/rack,/turf/simulated/shuttle/floor,/area/triumph_away/lavaland/idleruins)
"rw" = (/obj/item/stack/material/steel,/turf/simulated/mineral/floor/cave,/area/triumph_away/lavaland/idleruins)
"sI" = (/obj/item/material/shard/shrapnel,/turf/simulated/shuttle/floor,/area/triumph_away/lavaland/idleruins)
"uc" = (/obj/effect/decal/cleanable/dirt,/obj/effect/decal/cleanable/generic,/turf/simulated/floor/plating,/area/triumph_away/lavaland/idleruins)
"uO" = (/obj/effect/decal/cleanable/dirt,/obj/random/firstaid,/turf/simulated/floor/plating,/area/triumph_away/lavaland/idleruins)
"wX" = (/obj/structure/dispenser/oxygen{oxygentanks = 7},/turf/simulated/shuttle/floor,/area/triumph_away/lavaland/idleruins)
"xU" = (/obj/effect/decal/cleanable/dirt,/turf/simulated/floor/plating,/area/triumph_away/lavaland/idleruins)
"yQ" = (/mob/living/bot/medbot{name = "Dr. Crusty"},/turf/simulated/shuttle/floor,/area/triumph_away/lavaland/idleruins)
"zE" = (/obj/effect/decal/cleanable/dirt,/obj/structure/frame,/turf/simulated/floor/plating,/area/triumph_away/lavaland/idleruins)
"DM" = (/obj/structure/table/standard,/obj/random/unidentified_medicine/fresh_medicine,/obj/random/unidentified_medicine/fresh_medicine,/obj/random/unidentified_medicine/viral,/turf/simulated/shuttle/floor,/area/triumph_away/lavaland/idleruins)
"EJ" = (/turf/simulated/mineral/floor/cave,/area/triumph_away/lavaland/idleruins)
"IO" = (/obj/structure/closet/secure_closet/medical3{name = "medical locker"; req_access = list()},/turf/simulated/shuttle/floor,/area/triumph_away/lavaland/idleruins)
"KO" = (/obj/structure/closet/secure_closet/sar{name = "sar locker"; req_access = list()},/turf/simulated/shuttle/floor,/area/triumph_away/lavaland/idleruins)
"Mo" = (/obj/structure/closet/emcloset,/turf/simulated/shuttle/floor,/area/triumph_away/lavaland/idleruins)
"Of" = (/obj/effect/decal/cleanable/dirt,/obj/item/material/shard/shrapnel,/turf/simulated/floor/plating,/area/triumph_away/lavaland/idleruins)
"Oo" = (/obj/item/stack/rods,/turf/simulated/mineral/floor/cave,/area/triumph_away/lavaland/idleruins)
"Qp" = (/obj/structure/frame/computer{dir = 1},/turf/simulated/shuttle/floor,/area/triumph_away/lavaland/idleruins)
"Qu" = (/obj/effect/decal/cleanable/dirt,/obj/effect/decal/cleanable/molten_item,/turf/simulated/floor/plating,/area/triumph_away/lavaland/idleruins)
"Re" = (/turf/template_noop,/area/triumph_away/lavaland/idleruins)
"Sk" = (/turf/simulated/shuttle/floor,/area/triumph_away/lavaland/idleruins)
"Uo" = (/obj/structure/shuttle/engine/propulsion{dir = 4},/turf/simulated/floor/plating,/area/triumph_away/lavaland/idleruins)
"VZ" = (/turf/simulated/shuttle/wall/hard_corner,/area/triumph_away/lavaland/idleruins)
"Wd" = (/obj/effect/decal/cleanable/dirt,/obj/item/stack/material/steel,/turf/simulated/floor/plating,/area/triumph_away/lavaland/idleruins)
"WH" = (/obj/effect/decal/cleanable/dirt,/obj/effect/decal/cleanable/blood/oil,/turf/simulated/floor/plating,/area/triumph_away/lavaland/idleruins)
"WM" = (/obj/effect/decal/cleanable/dirt,/obj/effect/decal/remains/posi,/turf/simulated/floor/plating,/area/triumph_away/lavaland/idleruins)
"Xu" = (/obj/machinery/door/unpowered/shuttle,/turf/simulated/floor/plating,/area/triumph_away/lavaland/idleruins)
"XA" = (/obj/effect/decal/cleanable/dirt,/obj/item/storage/firstaid/adv,/turf/simulated/floor/plating,/area/triumph_away/lavaland/idleruins)
"Yt" = (/obj/machinery/suit_cycler/medical,/turf/simulated/shuttle/floor,/area/triumph_away/lavaland/idleruins)
"YZ" = (/turf/simulated/shuttle/wall,/area/triumph_away/lavaland/idleruins)
"Zb" = (/obj/effect/decal/cleanable/generic,/turf/simulated/floor/plating,/area/triumph_away/lavaland/idleruins)
"ZP" = (/obj/effect/decal/cleanable/dirt,/obj/item/stack/rods,/turf/simulated/floor/plating,/area/triumph_away/lavaland/idleruins)

(1,1,1) = {"
ororororororororororororororor
ororororororororororororororor
ororororororororororororororor
orReReYZYZYZYZYZhvhvYZYZYZoror
orReRejdzEYZnrSkyQSkKOYZUooror
orReReoNxUYZqOSkgJSkKOYZUooror
orRerwucuOYZDMgJgJSkIOYZUooror
orReOoQuWdVZYZgJYZYZYZYZVZoror
orReoNWHWMgJgJgJgJgJXugJXuoror
orReoNWducgJgJgJgJgJYZYZVZoror
orReOoXAZPgJYZMogJSkriYZUooror
orReEJOfZbsIYZwXSkSkriYZUooror
orReRejdhdQpYZYtSkSkriYZUooror
orReReYZYZYZYZYZhvhvYZYZYZoror
ororororororororororororororor
"}
