//MAP CONVERTED BY dmm2tgm.py THIS HEADER COMMENT PREVENTS RECONVERSION, DO NOT REMOVE
"a" = (
/turf/simulated/wall/rshull,
/area/submap/debrisfield_vr/misc_debris)
"f" = (
/obj/structure/grille/broken,
/obj/structure/alien/weeds,
/obj/structure/alien/resin/membrane,
/turf/simulated/floor/airless,
/area/submap/debrisfield_vr/misc_debris)
"h" = (
/obj/structure/alien/resin/wall,
/obj/structure/alien/weeds,
/turf/space,
/area/submap/debrisfield_vr/misc_debris)
"k" = (
/obj/structure/alien/weeds,
/mob/living/simple_mob/animal/space/alien,
/turf/simulated/floor/airless,
/area/submap/debrisfield_vr/misc_debris)
"r" = (
/obj/structure/grille/broken,
/obj/structure/window/reinforced{
	dir = 4
	},
/obj/structure/alien/weeds,
/obj/structure/alien/resin/membrane,
/turf/simulated/floor/airless,
/area/submap/debrisfield_vr/misc_debris)
"t" = (
/obj/structure/alien/weeds,
/mob/living/simple_mob/animal/space/alien/sentinel,
/turf/simulated/floor/airless,
/area/submap/debrisfield_vr/misc_debris)
"v" = (
/obj/machinery/door/airlock/external{
	density = 0;
	icon_state = "door_open";
	name = "Escape Pod Door";
	opacity = 0
	},
/obj/structure/alien/weeds,
/turf/simulated/floor/airless,
/area/submap/debrisfield_vr/misc_debris)
"A" = (
/obj/structure/alien/weeds/node,
/turf/simulated/floor/airless,
/area/submap/debrisfield_vr/misc_debris)
"D" = (
/obj/structure/alien/weeds,
/obj/structure/alien/resin/wall,
/turf/simulated/wall/rshull,
/area/submap/debrisfield_vr/misc_debris)
"T" = (
/obj/structure/grille/broken,
/obj/structure/window/reinforced{
	dir = 8
	},
/obj/structure/alien/weeds,
/obj/structure/alien/resin/membrane,
/turf/simulated/floor/airless,
/area/submap/debrisfield_vr/misc_debris)
"U" = (
/obj/structure/alien/weeds,
/turf/simulated/floor/airless,
/area/submap/debrisfield_vr/misc_debris)
"W" = (
/obj/structure/alien/weeds,
/obj/structure/alien/egg,
/turf/simulated/floor/airless,
/area/submap/debrisfield_vr/misc_debris)
"X" = (
/obj/structure/alien/weeds,
/mob/living/simple_mob/animal/space/alien/drone,
/turf/simulated/floor/airless,
/area/submap/debrisfield_vr/misc_debris)

(1,1,1) = {"
a
T
f
r
a
"}
(2,1,1) = {"
h
X
U
W
D
"}
(3,1,1) = {"
a
k
A
t
D
"}
(4,1,1) = {"
a
U
U
U
a
"}
(5,1,1) = {"
h
W
U
X
a
"}
(6,1,1) = {"
a
a
v
a
a
"}
