//MAP CONVERTED BY dmm2tgm.py THIS HEADER COMMENT PREVENTS RECONVERSION, DO NOT REMOVE
"a" = (
/turf/template_noop,
/area/template_noop)
"b" = (
/obj/effect/alien/weeds,
/mob/living/simple_mob/animal/space/alien/sentinel,
/turf/simulated/mineral/floor/classd/indoors,
/area/class_d/explored)
"f" = (
/obj/effect/alien/weeds,
/mob/living/simple_mob/animal/space/alien/sentinel/praetorian,
/turf/simulated/mineral/floor/classd/indoors,
/area/class_d/explored)
"h" = (
/obj/effect/alien/weeds,
/obj/effect/alien/weeds,
/mob/living/simple_mob/animal/space/alien/queen/empress,
/turf/simulated/mineral/floor/classd/indoors,
/area/class_d/explored)
"i" = (
/obj/effect/alien/weeds,
/obj/random/multiple/minevault,
/turf/simulated/mineral/floor/classd/indoors,
/area/class_d/explored)
"j" = (
/obj/effect/alien/weeds,
/obj/random/multiple/voidsuit/mining,
/obj/random/humanoidremains,
/turf/simulated/mineral/floor/classd/indoors,
/area/class_d/explored)
"k" = (
/obj/effect/alien/weeds,
/obj/effect/alien/weeds/node,
/mob/living/simple_mob/animal/space/alien/drone,
/turf/simulated/mineral/floor/classd/indoors,
/area/class_d/explored)
"m" = (
/obj/effect/alien/resin/wall,
/obj/effect/alien/weeds,
/obj/effect/alien/weeds,
/turf/simulated/mineral/floor/classd/indoors,
/area/class_d/explored)
"n" = (
/obj/effect/alien/weeds,
/obj/random/tetheraid,
/obj/item/gun/energy/phasegun/pistol,
/turf/simulated/mineral/floor/classd/indoors,
/area/class_d/explored)
"p" = (
/turf/simulated/mineral/classd/indoors,
/area/class_d/explored)
"q" = (
/obj/effect/alien/weeds,
/obj/effect/alien/weeds,
/turf/simulated/mineral/floor/classd/indoors,
/area/class_d/explored)
"r" = (
/obj/effect/alien/weeds,
/obj/effect/alien/weeds,
/obj/effect/alien/weeds,
/turf/simulated/mineral/floor/classd/indoors,
/area/class_d/explored)
"s" = (
/obj/effect/alien/weeds,
/turf/simulated/mineral/floor/classd/indoors,
/area/class_d/explored)
"t" = (
/obj/structure/simple_door/resin,
/turf/simulated/mineral/floor/classd/indoors,
/area/class_d/explored)
"w" = (
/turf/simulated/mineral/floor/classd/indoors,
/area/class_d/explored)
"x" = (
/obj/effect/alien/weeds,
/obj/effect/alien/weeds,
/mob/living/simple_mob/animal/space/alien/sentinel,
/turf/simulated/mineral/floor/classd/indoors,
/area/class_d/explored)
"y" = (
/obj/effect/alien/weeds,
/obj/effect/alien/resin/wall,
/turf/simulated/mineral/floor/classd/indoors,
/area/class_d/explored)
"z" = (
/obj/effect/alien/weeds,
/mob/living/simple_mob/animal/space/alien,
/turf/simulated/mineral/floor/classd/indoors,
/area/class_d/explored)
"B" = (
/obj/effect/alien/weeds,
/obj/item/storage/secure/briefcase/money,
/turf/simulated/mineral/floor/classd/indoors,
/area/class_d/explored)
"D" = (
/obj/effect/alien/weeds,
/obj/effect/alien/weeds,
/obj/random/humanoidremains,
/turf/simulated/mineral/floor/classd/indoors,
/area/class_d/explored)
"E" = (
/obj/effect/alien/weeds,
/obj/effect/alien/weeds,
/obj/random/energy,
/turf/simulated/mineral/floor/classd/indoors,
/area/class_d/explored)
"H" = (
/obj/effect/alien/weeds,
/obj/random/trash_pile,
/turf/simulated/mineral/floor/classd/indoors,
/area/class_d/explored)
"K" = (
/obj/effect/alien/weeds,
/obj/random/medical/pillbottle,
/turf/simulated/mineral/floor/classd/indoors,
/area/class_d/explored)
"L" = (
/obj/effect/alien/weeds,
/obj/random/humanoidremains,
/turf/simulated/mineral/floor/classd/indoors,
/area/class_d/explored)
"M" = (
/obj/effect/alien/resin/wall,
/obj/effect/alien/weeds,
/turf/simulated/mineral/floor/classd/indoors,
/area/class_d/explored)
"O" = (
/obj/effect/alien/weeds,
/obj/effect/alien/weeds,
/obj/random/tetheraid,
/turf/simulated/mineral/floor/classd/indoors,
/area/class_d/explored)
"P" = (
/obj/effect/alien/weeds,
/obj/effect/alien/egg,
/turf/simulated/mineral/floor/classd/indoors,
/area/class_d/explored)
"R" = (
/obj/effect/alien/weeds,
/obj/random/energy,
/turf/simulated/mineral/floor/classd/indoors,
/area/class_d/explored)
"T" = (
/obj/effect/alien/resin/wall,
/turf/simulated/mineral/floor/classd/indoors,
/area/class_d/explored)
"U" = (
/obj/effect/alien/weeds,
/mob/living/simple_mob/animal/space/alien/drone,
/turf/simulated/mineral/floor/classd/indoors,
/area/class_d/explored)
"W" = (
/obj/effect/alien/weeds,
/obj/random/medical,
/turf/simulated/mineral/floor/classd/indoors,
/area/class_d/explored)
"X" = (
/obj/effect/alien/weeds,
/obj/effect/alien/weeds/node,
/turf/simulated/mineral/floor/classd/indoors,
/area/class_d/explored)
"Z" = (
/obj/effect/alien/weeds,
/obj/effect/alien/weeds,
/obj/structure/simple_door/resin,
/turf/simulated/mineral/floor/classd/indoors,
/area/class_d/explored)

(1,1,1) = {"
a
a
a
a
a
a
a
a
a
a
a
a
a
a
a
a
a
a
a
a
"}
(2,1,1) = {"
a
a
a
p
p
p
p
p
p
p
p
p
p
p
p
a
a
a
a
a
"}
(3,1,1) = {"
a
a
p
p
p
p
p
p
p
p
p
p
p
p
p
p
p
a
a
a
"}
(4,1,1) = {"
a
p
p
p
p
b
s
s
X
s
s
s
p
p
p
p
p
a
a
a
"}
(5,1,1) = {"
p
p
p
K
s
r
r
s
s
s
s
D
s
s
p
p
p
p
a
a
"}
(6,1,1) = {"
p
p
W
O
q
r
x
p
p
p
p
H
s
q
s
p
p
p
a
a
"}
(7,1,1) = {"
p
p
s
s
s
H
p
p
p
p
p
p
M
U
X
s
p
p
p
a
"}
(8,1,1) = {"
p
p
s
s
p
p
p
p
p
p
p
p
m
M
m
s
U
p
p
a
"}
(9,1,1) = {"
p
p
T
s
p
p
p
p
p
p
p
i
j
p
M
s
s
p
p
a
"}
(10,1,1) = {"
p
p
T
q
p
p
p
p
P
B
p
p
n
p
p
t
t
p
p
a
"}
(11,1,1) = {"
p
p
T
Z
p
p
p
P
s
U
p
p
p
p
p
s
s
p
p
a
"}
(12,1,1) = {"
p
p
s
s
p
p
i
R
f
s
P
p
p
p
T
s
z
p
p
a
"}
(13,1,1) = {"
p
p
X
s
p
p
P
L
s
s
s
P
p
p
T
s
w
p
p
a
"}
(14,1,1) = {"
p
p
s
s
p
p
y
y
s
h
q
E
p
p
p
s
w
p
p
a
"}
(15,1,1) = {"
p
p
s
s
p
s
b
y
q
q
L
U
p
p
p
w
w
p
p
a
"}
(16,1,1) = {"
p
p
p
b
s
q
q
Z
q
s
f
i
p
p
p
w
w
w
p
a
"}
(17,1,1) = {"
p
p
p
P
s
s
b
y
k
s
s
P
p
p
p
p
w
w
w
w
"}
(18,1,1) = {"
a
p
p
p
p
p
P
y
s
P
p
p
p
p
p
w
w
w
w
w
"}
(19,1,1) = {"
a
a
a
p
p
p
p
p
p
p
p
p
p
p
a
w
w
w
w
w
"}
(20,1,1) = {"
a
a
a
a
a
p
p
p
p
p
p
a
a
a
a
a
a
w
w
w
"}
