//MAP CONVERTED BY dmm2tgm.py THIS HEADER COMMENT PREVENTS RECONVERSION, DO NOT REMOVE
"a" = (
/obj/structure/lattice,
/turf/space,
/area/triumph_away/debrisfield/explored)
"b" = (
/turf/template_noop,
/area/triumph_away/debrisfield/explored)
"c" = (
/turf/simulated/floor/airless,
/area/triumph_away/debrisfield/explored)
"d" = (
/obj/structure/girder,
/turf/simulated/floor/airless,
/area/triumph_away/debrisfield/explored)
"w" = (
/obj/tether_away_spawner/debrisfield/carp,
/turf/simulated/floor/airless,
/area/triumph_away/debrisfield/explored)
"L" = (
/obj/tether_away_spawner/debrisfield/carp/hard,
/turf/template_noop,
/area/triumph_away/debrisfield/explored)

(1,1,1) = {"
a
a
c
b
d
c
"}
(2,1,1) = {"
a
a
w
c
c
b
"}
(3,1,1) = {"
a
a
c
c
L
b
"}
(4,1,1) = {"
b
a
d
d
c
b
"}
