//MAP CONVERTED BY dmm2tgm.py THIS HEADER COMMENT PREVENTS RECONVERSION, DO NOT REMOVE
"a" = (
/turf/space,
/area/triumph_away/debrisfield/explored)
"b" = (
/obj/structure/lattice,
/turf/space,
/area/triumph_away/debrisfield/explored)
"c" = (
/turf/simulated/floor/airless,
/area/triumph_away/debrisfield/explored)
"n" = (
/obj/tether_away_spawner/debrisfield/carp,
/turf/simulated/floor/airless,
/area/triumph_away/debrisfield/explored)

(1,1,1) = {"
a
b
c
"}
(2,1,1) = {"
a
b
c
"}
(3,1,1) = {"
a
c
a
"}
(4,1,1) = {"
b
n
a
"}
(5,1,1) = {"
a
c
b
"}
(6,1,1) = {"
c
b
b
"}
