"a" = (/turf/simulated/shuttle/floor/voidcraft,/area/survivalpod)

(1,1,1) = {"
aaaaaaa
aaaaaaa
aaaaaaa
aaaaaaa
aaaaaaa
aaaaaaa
aaaaaaa
"}
