//MAP CONVERTED BY dmm2tgm.py THIS HEADER COMMENT PREVENTS RECONVERSION, DO NOT REMOVE
"a" = (
/turf/template_noop,
/area/template_noop)
"b" = (
/turf/simulated/floor/outdoors/rocks/caves,
/area/template_noop)
"c" = (
/obj/random/turf/lava,
/turf/simulated/floor/outdoors/rocks/caves,
/area/template_noop)
"d" = (
/obj/random/outcrop,
/obj/random/turf/lava,
/turf/simulated/floor/outdoors/rocks/caves,
/area/template_noop)
"e" = (
/obj/random/outcrop,
/turf/simulated/floor/outdoors/rocks/caves,
/area/template_noop)
"f" = (
/obj/effect/map_effect/interval/effect_emitter/steam,
/obj/effect/map_effect/interval/effect_emitter/smoke/mist{
	interval_upper_bound = 600
	},
/obj/effect/map_effect/interval/effect_emitter/smoke/bad{
	interval_lower_bound = 100;
	interval_upper_bound = 3000
	},
/obj/effect/map_effect/interval/screen_shaker{
	interval_upper_bound = 600
	},
/turf/simulated/floor/water/deep{
	outdoors = 0
	},
/area/template_noop)
"g" = (
/obj/random/turf/lava,
/obj/random/outcrop,
/turf/simulated/floor/outdoors/rocks/caves,
/area/template_noop)

(1,1,1) = {"
a
c
c
e
c
c
a
"}
(2,1,1) = {"
c
c
c
b
c
c
c
"}
(3,1,1) = {"
c
c
e
b
b
g
c
"}
(4,1,1) = {"
b
b
b
f
b
b
b
"}
(5,1,1) = {"
d
c
b
b
e
c
c
"}
(6,1,1) = {"
c
c
c
b
c
c
c
"}
(7,1,1) = {"
a
c
c
b
d
c
a
"}
