//MAP CONVERTED BY dmm2tgm.py THIS HEADER COMMENT PREVENTS RECONVERSION, DO NOT REMOVE
"aG" = (
/obj/machinery/atmospherics/pipe/simple/hidden/fuel{
	dir = 1
	},
/turf/simulated/floor/tiled/techfloor/virgo2,
/area/submap/virgo2/CrashedSmuggler/ship)
"bR" = (
/obj/machinery/door/blast/regular{
	density = 0;
	icon_state = "pdoor0";
	name = "Jammed Crash Shutter";
	opacity = 0
	},
/obj/item/stack/rods,
/obj/item/material/shard,
/turf/simulated/floor/plating/virgo2,
/area/submap/virgo2/CrashedSmuggler/ship)
"cc" = (
/obj/machinery/power/apc/alarms_hidden{
	cell_type = /obj/item/cell/high/empty;
	pixel_x = 28
	},
/obj/structure/cable/cyan{
	dir = 4
	},
/turf/simulated/floor/plating/virgo2,
/area/submap/virgo2/CrashedSmuggler/ship)
"cI" = (
/obj/effect/decal/cleanable/blood/xeno,
/obj/effect/alien/egg,
/turf/simulated/floor/tiled/techfloor/virgo2,
/area/submap/virgo2/CrashedSmuggler/ship)
"dH" = (
/obj/machinery/computer/ship/helm{
	dir = 8
	},
/turf/simulated/floor/tiled/techfloor/virgo2,
/area/submap/virgo2/CrashedSmuggler/ship)
"ei" = (
/obj/structure/closet/crate,
/obj/machinery/light/small,
/turf/simulated/floor/tiled/techfloor/virgo2,
/area/submap/virgo2/CrashedSmuggler/ship)
"eO" = (
/obj/effect/alien/weeds/node,
/mob/living/simple_mob/animal/space/alien/drone,
/turf/simulated/mineral/floor/ignore_mapgen/virgo2,
/area/submap/virgo2/CrashedSmuggler)
"fa" = (
/obj/structure/cable/green{
	d1 = 4;
	d2 = 8;
	icon_state = "4-8"
	},
/obj/machinery/door/blast/regular{
	density = 0;
	icon_state = "pdoor0";
	name = "Jammed Blast Door";
	opacity = 0
	},
/obj/machinery/door/airlock/hatch{
	name = "Cargo Bay Hatch"
	},
/turf/simulated/floor/tiled/techfloor/virgo2,
/area/submap/virgo2/CrashedSmuggler/ship)
"fK" = (
/obj/structure/simple_door/resin,
/obj/effect/alien/weeds,
/obj/item/clothing/mask/facehugger,
/turf/simulated/mineral/floor/ignore_mapgen/virgo2,
/area/submap/virgo2/CrashedSmuggler)
"ge" = (
/obj/machinery/power/smes/buildable/point_of_interest{
	lastcharge = 0
	},
/obj/structure/cable/cyan{
	dir = 8
	},
/turf/simulated/floor/plating/virgo2,
/area/submap/virgo2/CrashedSmuggler/ship)
"gv" = (
/obj/structure/simple_door/resin,
/obj/effect/alien/weeds,
/turf/simulated/mineral/floor/ignore_mapgen/virgo2,
/area/submap/virgo2/CrashedSmuggler)
"gR" = (
/obj/effect/alien/weeds,
/mob/living/simple_mob/animal/space/alien/queen/empress,
/turf/simulated/mineral/floor/ignore_mapgen/virgo2,
/area/submap/virgo2/CrashedSmuggler)
"gX" = (
/turf/simulated/shuttle/wall/voidcraft/red,
/area/submap/virgo2/CrashedSmuggler/ship)
"hH" = (
/obj/machinery/atmospherics/pipe/simple/hidden/fuel{
	dir = 1
	},
/obj/machinery/door/airlock/hatch{
	name = "Maintenance Hatch"
	},
/turf/simulated/floor/plating/virgo2,
/area/submap/virgo2/CrashedSmuggler/ship)
"ie" = (
/obj/effect/alien/egg,
/obj/machinery/light{
	dir = 4
	},
/turf/simulated/floor/tiled/techfloor/virgo2,
/area/submap/virgo2/CrashedSmuggler/ship)
"iN" = (
/turf/simulated/floor/tiled/techfloor/virgo2,
/area/submap/virgo2/CrashedSmuggler/ship)
"jf" = (
/obj/effect/alien/weeds,
/obj/item/clothing/mask/facehugger,
/turf/simulated/mineral/floor/ignore_mapgen/virgo2,
/area/submap/virgo2/CrashedSmuggler)
"jq" = (
/turf/simulated/mineral/floor/ignore_mapgen/virgo2,
/area/submap/virgo2/CrashedSmuggler)
"mP" = (
/obj/effect/alien/weeds/node,
/obj/effect/alien/egg,
/turf/simulated/mineral/floor/ignore_mapgen/virgo2,
/area/submap/virgo2/CrashedSmuggler)
"np" = (
/obj/structure/shuttle/engine/heater{
	dir = 8
	},
/obj/machinery/atmospherics/pipe/simple/hidden/fuel{
	dir = 10
	},
/turf/simulated/shuttle/wall/voidcraft/red,
/area/submap/virgo2/CrashedSmuggler/ship)
"ok" = (
/obj/structure/bed/chair/bay/shuttle{
	dir = 8
	},
/obj/effect/decal/cleanable/blood,
/turf/simulated/floor/tiled/techfloor/virgo2,
/area/submap/virgo2/CrashedSmuggler/ship)
"oB" = (
/obj/machinery/atmospherics/pipe/simple/hidden/fuel{
	dir = 1
	},
/obj/structure/cable/green{
	d1 = 1;
	d2 = 2;
	icon_state = "1-2"
	},
/obj/machinery/door/airlock/hatch{
	name = "Maintenance Hatch"
	},
/turf/simulated/floor/plating/virgo2,
/area/submap/virgo2/CrashedSmuggler/ship)
"sT" = (
/obj/effect/alien/weeds,
/mob/living/simple_mob/animal/space/alien/sentinel/praetorian,
/turf/simulated/mineral/floor/ignore_mapgen/virgo2,
/area/submap/virgo2/CrashedSmuggler)
"uX" = (
/obj/structure/bed,
/obj/effect/decal/cleanable/blood,
/obj/item/bedsheet/brown,
/obj/item/digestion_remains/ribcage,
/turf/simulated/floor/tiled/techfloor/virgo2,
/area/submap/virgo2/CrashedSmuggler/ship)
"we" = (
/obj/machinery/door/airlock/hatch{
	name = "Cargo Bay Hatch"
	},
/turf/simulated/floor/tiled/techfloor/virgo2,
/area/submap/virgo2/CrashedSmuggler/ship)
"wQ" = (
/obj/structure/cable/green{
	d1 = 4;
	d2 = 8;
	icon_state = "4-8"
	},
/turf/simulated/floor/tiled/techfloor/virgo2,
/area/submap/virgo2/CrashedSmuggler/ship)
"xk" = (
/obj/machinery/computer/shuttle_control/explore/excursion{
	dir = 8
	},
/turf/simulated/floor/tiled/techfloor/virgo2,
/area/submap/virgo2/CrashedSmuggler/ship)
"xC" = (
/obj/effect/decal/remains/xeno,
/turf/simulated/floor/tiled/techfloor/virgo2,
/area/submap/virgo2/CrashedSmuggler/ship)
"ym" = (
/obj/machinery/door/blast/regular{
	name = "Crash Shutter"
	},
/turf/simulated/floor/plating/virgo2,
/area/submap/virgo2/CrashedSmuggler/ship)
"yA" = (
/obj/machinery/computer/ship/sensors{
	dir = 4
	},
/turf/simulated/floor/tiled/techfloor/virgo2,
/area/submap/virgo2/CrashedSmuggler/ship)
"zl" = (
/turf/simulated/mineral/ignore_mapgen/virgo2,
/area/submap/virgo2/CrashedSmuggler)
"zB" = (
/obj/structure/table/steel_reinforced,
/turf/simulated/floor/tiled/techfloor/virgo2,
/area/submap/virgo2/CrashedSmuggler/ship)
"zQ" = (
/obj/structure/bed/chair/bay/shuttle{
	dir = 4
	},
/obj/item/gun/projectile/revolver/mateba,
/turf/simulated/floor/tiled/techfloor/virgo2,
/area/submap/virgo2/CrashedSmuggler/ship)
"BR" = (
/obj/machinery/atmospherics/pipe/simple/hidden/fuel{
	dir = 10
	},
/obj/structure/fuel_port{
	dir = 4;
	pixel_x = 29
	},
/turf/simulated/floor/plating/virgo2,
/area/submap/virgo2/CrashedSmuggler/ship)
"Cr" = (
/obj/machinery/atmospherics/pipe/manifold/hidden/fuel,
/obj/machinery/light/small,
/turf/simulated/floor/plating/virgo2,
/area/submap/virgo2/CrashedSmuggler/ship)
"CE" = (
/obj/structure/shuttle/engine/propulsion{
	dir = 8
	},
/turf/simulated/floor/plating/virgo2,
/area/submap/virgo2/CrashedSmuggler/ship)
"CH" = (
/obj/machinery/door/airlock/hatch{
	name = "Bridge Hatch"
	},
/obj/machinery/door/blast/regular{
	density = 0;
	icon_state = "pdoor0";
	name = "Jammed Blast Door";
	opacity = 0
	},
/turf/simulated/floor/tiled/techfloor/virgo2,
/area/submap/virgo2/CrashedSmuggler/ship)
"CK" = (
/obj/structure/shuttle/engine/heater{
	dir = 8
	},
/obj/machinery/atmospherics/pipe/manifold/hidden/fuel,
/turf/simulated/shuttle/wall/voidcraft/red,
/area/submap/virgo2/CrashedSmuggler/ship)
"Dj" = (
/turf/template_noop,
/area/template_noop)
"EY" = (
/turf/simulated/wall/resin,
/area/submap/virgo2/CrashedSmuggler)
"Fu" = (
/obj/structure/table,
/obj/machinery/light,
/turf/simulated/floor/tiled/techfloor/virgo2,
/area/submap/virgo2/CrashedSmuggler/ship)
"FF" = (
/obj/item/ammo_casing/spent{
	dir = 4;
	pixel_x = -9
	},
/obj/item/ammo_casing/spent{
	dir = 10;
	pixel_x = 6;
	pixel_y = -8
	},
/obj/item/ammo_casing/spent{
	dir = 9;
	pixel_x = -8;
	pixel_y = 12
	},
/obj/item/ammo_casing/spent{
	dir = 4;
	pixel_x = -4;
	pixel_y = -6
	},
/obj/item/ammo_casing/spent{
	dir = 5;
	pixel_x = 8;
	pixel_y = 2
	},
/obj/item/ammo_casing/spent{
	dir = 8;
	pixel_x = 3;
	pixel_y = 8
	},
/turf/simulated/floor/tiled/techfloor/virgo2,
/area/submap/virgo2/CrashedSmuggler/ship)
"FV" = (
/obj/machinery/atmospherics/portables_connector/fuel,
/obj/machinery/portable_atmospherics/canister/phoron{
	start_pressure = 0
	},
/turf/simulated/floor/plating/virgo2,
/area/submap/virgo2/CrashedSmuggler/ship)
"Gf" = (
/obj/effect/alien/weeds/node,
/turf/simulated/mineral/floor/ignore_mapgen/virgo2,
/area/submap/virgo2/CrashedSmuggler)
"Gh" = (
/obj/effect/alien/weeds,
/turf/simulated/mineral/floor/ignore_mapgen/virgo2,
/area/submap/virgo2/CrashedSmuggler)
"Hx" = (
/obj/machinery/door/blast/regular{
	density = 0;
	icon_state = "pdoor0";
	name = "Jammed Crash Shutter";
	opacity = 0
	},
/obj/item/stack/rods,
/turf/simulated/floor/plating/virgo2,
/area/submap/virgo2/CrashedSmuggler/ship)
"HE" = (
/obj/structure/shuttle/engine/heater{
	dir = 8
	},
/obj/machinery/atmospherics/pipe/manifold/hidden/fuel{
	dir = 1
	},
/turf/simulated/shuttle/wall/voidcraft/red,
/area/submap/virgo2/CrashedSmuggler/ship)
"HR" = (
/obj/machinery/atmospherics/pipe/simple/hidden/fuel{
	dir = 1
	},
/obj/structure/cable/green{
	d1 = 2;
	d2 = 8;
	icon_state = "2-8"
	},
/turf/simulated/floor/tiled/techfloor/virgo2,
/area/submap/virgo2/CrashedSmuggler/ship)
"IB" = (
/obj/effect/alien/weeds/node,
/mob/living/simple_mob/animal/space/alien/sentinel,
/turf/simulated/mineral/floor/ignore_mapgen/virgo2,
/area/submap/virgo2/CrashedSmuggler)
"Kl" = (
/obj/machinery/door/blast/regular{
	density = 0;
	icon_state = "pdoor0";
	name = "Jammed Blast Door";
	opacity = 0
	},
/obj/machinery/door/airlock/hatch{
	name = "Commons Hatch"
	},
/turf/simulated/floor/tiled/techfloor/virgo2,
/area/submap/virgo2/CrashedSmuggler/ship)
"KS" = (
/obj/machinery/door/blast/regular{
	density = 0;
	icon_state = "pdoor0";
	name = "Jammed Crash Shutter";
	opacity = 0
	},
/obj/item/material/shard,
/turf/simulated/floor/plating/virgo2,
/area/submap/virgo2/CrashedSmuggler/ship)
"Lc" = (
/obj/effect/alien/weeds,
/obj/effect/alien/egg,
/obj/item/clothing/mask/facehugger,
/turf/simulated/mineral/floor/ignore_mapgen/virgo2,
/area/submap/virgo2/CrashedSmuggler)
"MM" = (
/obj/structure/table/steel_reinforced,
/obj/machinery/light{
	dir = 1
	},
/turf/simulated/floor/tiled/techfloor/virgo2,
/area/submap/virgo2/CrashedSmuggler/ship)
"MW" = (
/obj/structure/bed/chair/bay/chair{
	dir = 4
	},
/obj/machinery/light/small{
	dir = 1
	},
/turf/simulated/floor/tiled/techfloor/virgo2,
/area/submap/virgo2/CrashedSmuggler/ship)
"No" = (
/obj/effect/alien/weeds,
/mob/living/simple_mob/animal/space/alien/sentinel,
/turf/simulated/mineral/floor/ignore_mapgen/virgo2,
/area/submap/virgo2/CrashedSmuggler)
"OR" = (
/turf/simulated/shuttle/wall/voidcraft/hard_corner,
/area/submap/virgo2/CrashedSmuggler/ship)
"Ps" = (
/obj/structure/shuttle/engine/heater{
	dir = 8
	},
/obj/machinery/atmospherics/pipe/simple/hidden/fuel{
	dir = 9
	},
/turf/simulated/shuttle/wall/voidcraft/red,
/area/submap/virgo2/CrashedSmuggler/ship)
"Px" = (
/obj/effect/decal/cleanable/blood/xeno,
/obj/machinery/light{
	dir = 4
	},
/obj/effect/alien/egg,
/turf/simulated/floor/tiled/techfloor/virgo2,
/area/submap/virgo2/CrashedSmuggler/ship)
"PP" = (
/obj/machinery/door/airlock/hatch{
	name = "Commons Hatch"
	},
/obj/machinery/door/blast/regular{
	density = 0;
	icon_state = "pdoor0";
	name = "Jammed Blast Door";
	opacity = 0
	},
/turf/simulated/floor/tiled/techfloor/virgo2,
/area/submap/virgo2/CrashedSmuggler/ship)
"PY" = (
/obj/machinery/computer/ship/engines{
	dir = 4
	},
/turf/simulated/floor/tiled/techfloor/virgo2,
/area/submap/virgo2/CrashedSmuggler/ship)
"Qa" = (
/obj/machinery/atmospherics/pipe/simple/hidden/fuel{
	dir = 4
	},
/obj/machinery/power/terminal,
/obj/structure/cable/green{
	d2 = 4;
	icon_state = "0-4"
	},
/obj/machinery/light/small{
	dir = 1
	},
/turf/simulated/floor/plating/virgo2,
/area/submap/virgo2/CrashedSmuggler/ship)
"Qz" = (
/obj/machinery/door/blast/regular{
	density = 0;
	icon_state = "pdoor0";
	name = "Jammed Blast Door";
	opacity = 0
	},
/obj/machinery/door/airlock/hatch{
	name = "Cargo Bay Hatch"
	},
/turf/simulated/floor/tiled/techfloor/virgo2,
/area/submap/virgo2/CrashedSmuggler/ship)
"RJ" = (
/obj/effect/alien/weeds,
/obj/effect/alien/egg,
/turf/simulated/mineral/floor/ignore_mapgen/virgo2,
/area/submap/virgo2/CrashedSmuggler)
"UW" = (
/obj/effect/alien/egg,
/turf/simulated/floor/tiled/techfloor/virgo2,
/area/submap/virgo2/CrashedSmuggler/ship)
"VT" = (
/obj/effect/alien/weeds/node,
/obj/item/clothing/mask/facehugger,
/turf/simulated/mineral/floor/ignore_mapgen/virgo2,
/area/submap/virgo2/CrashedSmuggler)
"Xq" = (
/obj/machinery/atmospherics/pipe/simple/hidden/fuel{
	dir = 9
	},
/obj/structure/cable/green{
	d1 = 1;
	d2 = 8;
	icon_state = "1-8"
	},
/turf/simulated/floor/plating/virgo2,
/area/submap/virgo2/CrashedSmuggler/ship)
"Yj" = (
/obj/effect/decal/cleanable/blood,
/obj/item/clothing/mask/facehugger,
/turf/simulated/floor/tiled/techfloor/virgo2,
/area/submap/virgo2/CrashedSmuggler/ship)
"Zr" = (
/obj/machinery/door/blast/regular{
	density = 0;
	icon_state = "pdoor0";
	name = "Jammed Blast Door";
	opacity = 0
	},
/obj/effect/decal/cleanable/blood/xeno,
/obj/machinery/door/airlock/hatch{
	name = "Bridge Hatch"
	},
/turf/simulated/floor/tiled/techfloor/virgo2,
/area/submap/virgo2/CrashedSmuggler/ship)
"ZN" = (
/obj/effect/alien/weeds,
/mob/living/simple_mob/animal/space/alien/drone,
/turf/simulated/mineral/floor/ignore_mapgen/virgo2,
/area/submap/virgo2/CrashedSmuggler)

(1,1,1) = {"
Dj
Dj
Dj
Dj
Dj
Dj
Dj
Dj
Dj
Dj
Dj
Dj
Dj
Dj
Dj
Dj
Dj
Dj
Dj
Dj
Dj
Dj
Dj
Dj
"}
(2,1,1) = {"
Dj
jq
jq
jq
jq
jq
jq
jq
jq
jq
jq
jq
jq
jq
jq
jq
jq
jq
zl
zl
zl
zl
jq
Dj
"}
(3,1,1) = {"
Dj
jq
jq
jq
jq
jq
jq
gX
CE
CE
gX
jq
jq
gX
CE
CE
gX
zl
zl
zl
zl
zl
zl
Dj
"}
(4,1,1) = {"
Dj
jq
jq
jq
jq
jq
jq
gX
np
CK
gX
Qz
fa
gX
HE
Ps
gX
zl
Gf
ZN
zl
zl
zl
Dj
"}
(5,1,1) = {"
Dj
jq
jq
jq
jq
zl
zl
gX
FV
Cr
gX
iN
wQ
gX
Qa
ge
gX
zl
Gh
RJ
zl
zl
jq
Dj
"}
(6,1,1) = {"
Dj
jq
jq
zl
zl
zl
zl
gX
OR
BR
hH
aG
HR
oB
Xq
cc
gX
zl
gv
EY
zl
zl
zl
Dj
"}
(7,1,1) = {"
Dj
jq
zl
zl
zl
zl
zl
gX
gX
gX
gX
we
we
gX
gX
OR
gX
zl
Gh
No
VT
zl
zl
Dj
"}
(8,1,1) = {"
Dj
jq
zl
zl
RJ
RJ
zl
zl
gX
UW
UW
iN
iN
UW
cI
gX
zl
zl
EY
gv
EY
zl
zl
Dj
"}
(9,1,1) = {"
Dj
jq
zl
mP
Gh
gR
zl
zl
gX
iN
iN
iN
iN
iN
iN
gX
zl
zl
Gh
Gh
Gh
zl
zl
Dj
"}
(10,1,1) = {"
Dj
jq
zl
zl
RJ
Gh
RJ
zl
gX
UW
UW
iN
iN
UW
UW
gX
zl
EY
Gh
EY
gv
zl
zl
Dj
"}
(11,1,1) = {"
Dj
jq
zl
zl
RJ
Gh
RJ
zl
gX
iN
iN
iN
Yj
iN
iN
gX
zl
Gf
Gh
EY
VT
zl
zl
Dj
"}
(12,1,1) = {"
Dj
jq
zl
zl
zl
gv
EY
zl
gX
UW
Px
iN
iN
ie
UW
gX
zl
ZN
Gh
zl
zl
zl
zl
Dj
"}
(13,1,1) = {"
Dj
jq
jq
zl
zl
sT
Gf
zl
gX
gX
gX
Kl
PP
gX
gX
gX
zl
Gh
Gh
zl
zl
zl
jq
Dj
"}
(14,1,1) = {"
Dj
jq
jq
zl
zl
zl
Gh
zl
gX
MW
iN
iN
iN
iN
ei
gX
zl
fK
zl
zl
zl
jq
jq
Dj
"}
(15,1,1) = {"
Dj
jq
jq
jq
zl
zl
Gh
zl
gX
zB
iN
iN
iN
iN
uX
gX
zl
Gh
zl
zl
zl
jq
jq
Dj
"}
(16,1,1) = {"
Dj
jq
jq
jq
zl
zl
Gh
zl
gX
OR
Zr
gX
gX
CH
OR
gX
zl
Gh
zl
zl
zl
zl
jq
Dj
"}
(17,1,1) = {"
Dj
jq
jq
jq
zl
zl
Gh
zl
zl
gX
xC
yA
PY
iN
gX
zl
zl
Gh
No
zl
zl
zl
jq
Dj
"}
(18,1,1) = {"
Dj
jq
jq
zl
zl
zl
Gh
zl
zl
gX
FF
zQ
ok
iN
gX
zl
zl
Gh
Gh
Gf
zl
zl
jq
Dj
"}
(19,1,1) = {"
Dj
jq
jq
zl
zl
EY
fK
zl
zl
gX
MM
dH
xk
Fu
gX
zl
zl
gv
EY
gv
zl
zl
jq
Dj
"}
(20,1,1) = {"
Dj
jq
zl
zl
zl
Gf
Gh
Gh
zl
OR
ym
Hx
bR
KS
OR
Gh
Gh
ZN
Gh
Gh
zl
zl
jq
Dj
"}
(21,1,1) = {"
Dj
jq
zl
zl
Gh
sT
EY
Gh
Gh
Gh
EY
Gh
eO
EY
EY
Gh
EY
Gh
EY
Gh
zl
zl
zl
Dj
"}
(22,1,1) = {"
Dj
jq
zl
zl
Gh
EY
EY
EY
EY
Gh
EY
gv
EY
EY
No
Gh
Gf
Gh
Gh
Gh
RJ
zl
zl
Dj
"}
(23,1,1) = {"
Dj
jq
zl
IB
Gh
gv
jf
mP
EY
ZN
Gh
Gh
Gf
EY
EY
Gh
EY
Gh
EY
Gf
zl
zl
zl
Dj
"}
(24,1,1) = {"
Dj
jq
zl
zl
Gh
zl
zl
zl
EY
Gh
Gh
EY
Gh
gv
Gh
Gh
ZN
Gh
Gh
zl
zl
zl
jq
Dj
"}
(25,1,1) = {"
Dj
jq
zl
zl
zl
zl
zl
zl
zl
zl
gv
EY
Gh
EY
Gh
EY
Gh
EY
zl
zl
zl
jq
jq
Dj
"}
(26,1,1) = {"
Dj
jq
jq
zl
zl
zl
jq
zl
zl
zl
VT
zl
zl
zl
Gf
Gh
Gh
Lc
zl
zl
jq
jq
jq
Dj
"}
(27,1,1) = {"
Dj
jq
jq
zl
zl
jq
jq
jq
jq
zl
zl
zl
zl
zl
zl
zl
zl
zl
zl
jq
jq
jq
jq
Dj
"}
(28,1,1) = {"
Dj
jq
jq
jq
jq
jq
zl
zl
jq
jq
zl
zl
jq
jq
zl
zl
zl
zl
jq
jq
jq
jq
jq
Dj
"}
(29,1,1) = {"
Dj
jq
jq
jq
jq
jq
zl
zl
zl
jq
jq
jq
jq
jq
jq
jq
jq
jq
jq
jq
jq
jq
jq
Dj
"}
(30,1,1) = {"
Dj
Dj
Dj
Dj
Dj
Dj
Dj
Dj
Dj
Dj
Dj
Dj
Dj
Dj
Dj
Dj
Dj
Dj
Dj
Dj
Dj
Dj
Dj
Dj
"}
