//MAP CONVERTED BY dmm2tgm.py THIS HEADER COMMENT PREVENTS RECONVERSION, DO NOT REMOVE
"aj" = (
/obj/machinery/computer/shuttle_control/explore/excursion,
/turf/simulated/shuttle/floor/red/airless,
/area/space/debrisfield/explored)
"al" = (
/obj/machinery/atmospherics/unary/vent_scrubber/on{
	dir = 8
	},
/obj/machinery/light,
/obj/structure/table/bananium_reinforced,
/turf/simulated/shuttle/floor/yellow/airless,
/area/space/debrisfield/explored)
"am" = (
/obj/structure/table/rack/steel,
/obj/item/nullrod/clown,
/obj/item/nullrod/clown,
/turf/simulated/shuttle/floor/yellow/airless,
/area/space/debrisfield/explored)
"an" = (
/obj/item/bedsheet/clown,
/obj/structure/bed,
/turf/simulated/shuttle/floor/yellow/airless,
/area/space/debrisfield/explored)
"aP" = (
/obj/item/toy/figure/clown,
/obj/structure/table/bananium_reinforced,
/turf/simulated/shuttle/floor/yellow/airless,
/area/space/debrisfield/explored)
"aT" = (
/obj/structure/window/reinforced,
/turf/simulated/floor/bananium,
/area/space/debrisfield/explored)
"bw" = (
/turf/simulated/shuttle/wall,
/area/space/debrisfield/explored)
"ce" = (
/obj/machinery/atmospherics/pipe/simple/hidden/supply,
/obj/machinery/atmospherics/pipe/simple/hidden/scrubbers,
/turf/simulated/shuttle/floor/yellow/airless,
/area/space/debrisfield/explored)
"cK" = (
/obj/machinery/atmospherics/pipe/simple/hidden/supply,
/obj/machinery/atmospherics/pipe/simple/hidden/scrubbers,
/obj/machinery/door/airlock/hatch,
/obj/item/bananapeel,
/turf/simulated/shuttle/floor/yellow/airless,
/area/space/debrisfield/explored)
"db" = (
/obj/structure/table/rack/steel,
/obj/item/stamp/clown,
/obj/item/stamp/clown,
/turf/simulated/shuttle/floor/yellow/airless,
/area/space/debrisfield/explored)
"dd" = (
/mob/living/simple_mob/humanoid/clown/commando/ranged/space,
/turf/simulated/shuttle/floor/yellow/airless,
/area/space/debrisfield/explored)
"dK" = (
/obj/effect/floor_decal/industrial/outline,
/obj/structure/closet/crate/secure/loot,
/turf/simulated/shuttle/floor/yellow/airless,
/area/space/debrisfield/explored)
"dO" = (
/obj/structure/cable/green{
	d1 = 1;
	d2 = 2;
	icon_state = "1-2"
	},
/obj/machinery/door/airlock/external,
/turf/simulated/shuttle/floor/yellow/airless,
/area/space/debrisfield/explored)
"eF" = (
/obj/machinery/atmospherics/unary/vent_pump/on{
	dir = 4
	},
/obj/item/reagent_containers/food/snacks/clownburger,
/obj/item/reagent_containers/food/snacks/clownburger,
/obj/machinery/light,
/obj/structure/table/bananium_reinforced,
/turf/simulated/shuttle/floor/yellow/airless,
/area/space/debrisfield/explored)
"fp" = (
/obj/machinery/atmospherics/pipe/manifold4w/hidden/supply,
/obj/machinery/atmospherics/pipe/simple/hidden/scrubbers{
	dir = 4
	},
/turf/simulated/shuttle/floor/yellow/airless,
/area/space/debrisfield/explored)
"fw" = (
/obj/machinery/atmospherics/pipe/manifold/hidden/supply{
	dir = 8
	},
/obj/machinery/atmospherics/pipe/manifold/hidden/scrubbers{
	dir = 8
	},
/turf/simulated/shuttle/floor/yellow/airless,
/area/space/debrisfield/explored)
"ge" = (
/obj/machinery/atmospherics/pipe/simple/hidden/supply,
/obj/machinery/atmospherics/pipe/manifold/hidden/scrubbers,
/turf/simulated/shuttle/floor/yellow/airless,
/area/space/debrisfield/explored)
"gn" = (
/obj/machinery/light{
	dir = 8
	},
/turf/simulated/shuttle/floor/yellow/airless,
/area/space/debrisfield/explored)
"hc" = (
/obj/machinery/computer/ship/helm,
/turf/simulated/shuttle/floor/red/airless,
/area/space/debrisfield/explored)
"hF" = (
/obj/structure/table/bananium_reinforced,
/turf/simulated/shuttle/floor/yellow/airless,
/area/space/debrisfield/explored)
"it" = (
/obj/effect/floor_decal/industrial/outline,
/obj/structure/closet/crate/freezer/rations,
/turf/simulated/shuttle/floor/yellow/airless,
/area/space/debrisfield/explored)
"iz" = (
/obj/effect/floor_decal/industrial/outline,
/obj/structure/closet/crate/secure,
/obj/item/ore/vaudium,
/obj/item/ore/vaudium,
/obj/item/ore/vaudium,
/obj/item/ore/vaudium,
/obj/item/ore/vaudium,
/obj/item/ore/vaudium,
/obj/item/ore/vaudium,
/obj/item/ore/vaudium,
/obj/item/ore/vaudium,
/obj/item/ore/vaudium,
/obj/machinery/light{
	dir = 8
	},
/turf/simulated/shuttle/floor/yellow/airless,
/area/space/debrisfield/explored)
"jv" = (
/obj/structure/bed,
/obj/item/bedsheet/clown,
/turf/simulated/shuttle/floor/yellow/airless,
/area/space/debrisfield/explored)
"jF" = (
/obj/machinery/atmospherics/pipe/simple/hidden/fuel{
	dir = 10
	},
/turf/simulated/shuttle/floor/yellow/airless,
/area/space/debrisfield/explored)
"km" = (
/obj/structure/shuttle/engine/heater,
/obj/machinery/atmospherics/pipe/manifold/hidden/fuel{
	dir = 1
	},
/turf/simulated/shuttle/wall,
/area/space/debrisfield/explored)
"kw" = (
/obj/structure/cable/green{
	d1 = 1;
	d2 = 2;
	icon_state = "1-2"
	},
/obj/machinery/door/airlock/external,
/obj/item/bananapeel,
/turf/simulated/shuttle/floor/yellow/airless,
/area/space/debrisfield/explored)
"kH" = (
/obj/machinery/atmospherics/pipe/simple/hidden/supply{
	dir = 10
	},
/turf/simulated/shuttle/floor/red/airless,
/area/space/debrisfield/explored)
"kX" = (
/obj/machinery/light{
	dir = 1
	},
/mob/living/simple_mob/humanoid/clown/commando/melee/space/alt,
/turf/simulated/shuttle/floor/yellow/airless,
/area/space/debrisfield/explored)
"kY" = (
/obj/machinery/atmospherics/unary/vent_pump/on{
	dir = 8
	},
/obj/item/storage/toolbox/electrical,
/obj/structure/table/bananium_reinforced,
/turf/simulated/shuttle/floor/yellow/airless,
/area/space/debrisfield/explored)
"lD" = (
/obj/machinery/atmospherics/pipe/simple/hidden/scrubbers,
/obj/structure/cable/green{
	d1 = 1;
	d2 = 2;
	icon_state = "1-2"
	},
/mob/living/simple_mob/humanoid/clown/commando/melee/space,
/turf/simulated/shuttle/floor/yellow/airless,
/area/space/debrisfield/explored)
"lM" = (
/obj/machinery/atmospherics/pipe/simple/hidden/supply,
/obj/machinery/door/airlock/hatch,
/turf/simulated/shuttle/floor/yellow/airless,
/area/space/debrisfield/explored)
"mN" = (
/obj/machinery/atmospherics/unary/vent_pump/on{
	dir = 4
	},
/obj/structure/closet/syndicate/clownops/personal,
/turf/simulated/shuttle/floor/yellow/airless,
/area/space/debrisfield/explored)
"nA" = (
/obj/machinery/atmospherics/pipe/simple/hidden/supply,
/obj/machinery/atmospherics/pipe/simple/hidden/scrubbers,
/obj/structure/cable/green{
	d1 = 1;
	d2 = 2;
	icon_state = "1-2"
	},
/obj/machinery/door/airlock/hatch,
/obj/item/bananapeel,
/turf/simulated/shuttle/floor/yellow/airless,
/area/space/debrisfield/explored)
"nG" = (
/obj/machinery/vending/assist,
/turf/simulated/shuttle/floor/yellow/airless,
/area/space/debrisfield/explored)
"nK" = (
/mob/living/simple_mob/humanoid/clown/commando/ranged/space,
/turf/simulated/shuttle/floor/red/airless,
/area/space/debrisfield/explored)
"nW" = (
/obj/machinery/atmospherics/unary/vent_pump/high_volume{
	dir = 1
	},
/obj/structure/cable/green{
	d1 = 1;
	d2 = 2;
	icon_state = "1-2"
	},
/turf/simulated/shuttle/floor/yellow/airless,
/area/space/debrisfield/explored)
"oo" = (
/obj/structure/bed/chair/bay/shuttle{
	dir = 4
	},
/turf/simulated/shuttle/floor/yellow/airless,
/area/space/debrisfield/explored)
"ow" = (
/obj/machinery/atmospherics/pipe/simple/hidden/fuel{
	dir = 10
	},
/obj/machinery/light{
	dir = 4
	},
/turf/simulated/shuttle/floor/yellow/airless,
/area/space/debrisfield/explored)
"oX" = (
/obj/effect/floor_decal/industrial/outline,
/obj/structure/closet/crate/plastic,
/turf/simulated/shuttle/floor/yellow/airless,
/area/space/debrisfield/explored)
"pt" = (
/obj/effect/floor_decal/industrial/outline,
/obj/structure/closet/crate/medical/blood,
/turf/simulated/shuttle/floor/yellow/airless,
/area/space/debrisfield/explored)
"pJ" = (
/obj/structure/closet/emcloset/legacy,
/obj/item/clothing/mask/breath,
/obj/item/clothing/mask/breath,
/obj/item/clothing/mask/breath,
/obj/item/clothing/mask/breath,
/obj/item/tank/emergency/oxygen/engi,
/obj/item/tank/emergency/oxygen/engi,
/obj/item/tank/emergency/oxygen/engi,
/obj/item/tank/emergency/oxygen/engi,
/obj/item/clothing/suit/space/emergency,
/obj/item/clothing/suit/space/emergency,
/obj/item/clothing/suit/space/emergency,
/obj/item/clothing/suit/space/emergency,
/obj/item/clothing/head/helmet/space/emergency,
/obj/item/clothing/head/helmet/space/emergency,
/obj/item/clothing/head/helmet/space/emergency,
/obj/item/clothing/head/helmet/space/emergency,
/obj/item/storage/backpack/parachute,
/obj/item/storage/backpack/parachute,
/obj/item/storage/backpack/parachute,
/obj/item/storage/backpack/parachute,
/turf/simulated/shuttle/floor/yellow/airless,
/area/space/debrisfield/explored)
"pP" = (
/mob/living/simple_mob/humanoid/clown/commando/ranged/space/alt,
/turf/simulated/shuttle/floor/yellow/airless,
/area/space/debrisfield/explored)
"qb" = (
/obj/structure/table/rack/steel,
/obj/item/bikehorn,
/obj/item/bikehorn,
/obj/item/bikehorn,
/obj/item/bikehorn,
/turf/simulated/shuttle/floor/yellow/airless,
/area/space/debrisfield/explored)
"qr" = (
/obj/machinery/atmospherics/pipe/simple/hidden/fuel{
	dir = 6
	},
/obj/machinery/light{
	dir = 8
	},
/turf/simulated/shuttle/floor/yellow/airless,
/area/space/debrisfield/explored)
"qD" = (
/obj/machinery/atmospherics/unary/vent_scrubber/on{
	dir = 8
	},
/obj/item/reagent_containers/food/snacks/pie,
/obj/item/reagent_containers/food/snacks/pie,
/obj/item/reagent_containers/food/snacks/pie,
/obj/item/reagent_containers/food/snacks/pie,
/obj/item/reagent_containers/food/snacks/pie,
/obj/item/reagent_containers/food/snacks/pie,
/obj/item/reagent_containers/food/snacks/pie,
/obj/item/reagent_containers/food/snacks/pie,
/obj/machinery/light{
	dir = 1
	},
/obj/structure/table/bananium_reinforced,
/turf/simulated/shuttle/floor/yellow/airless,
/area/space/debrisfield/explored)
"ri" = (
/obj/machinery/atmospherics/unary/vent_scrubber/on{
	dir = 8
	},
/obj/item/storage/toolbox/emergency,
/obj/structure/table/bananium_reinforced,
/turf/simulated/shuttle/floor/yellow/airless,
/area/space/debrisfield/explored)
"rO" = (
/obj/machinery/atmospherics/pipe/simple/hidden/supply{
	dir = 9
	},
/turf/simulated/shuttle/floor/yellow/airless,
/area/space/debrisfield/explored)
"sB" = (
/obj/structure/grille,
/obj/structure/window/reinforced{
	dir = 1
	},
/obj/structure/window/reinforced/full,
/turf/simulated/shuttle/plating/airless,
/area/space/debrisfield/explored)
"sQ" = (
/obj/machinery/power/terminal{
	dir = 4
	},
/obj/structure/cable/green{
	d2 = 8;
	icon_state = "0-8"
	},
/turf/simulated/shuttle/floor/yellow/airless,
/area/space/debrisfield/explored)
"tN" = (
/obj/effect/floor_decal/industrial/outline,
/obj/structure/closet/crate/large,
/turf/simulated/shuttle/floor/yellow/airless,
/area/space/debrisfield/explored)
"tQ" = (
/obj/structure/shuttle/engine/propulsion,
/turf/simulated/shuttle/plating/airless,
/area/space/debrisfield/explored)
"uc" = (
/obj/structure/shuttle/engine/heater,
/obj/machinery/atmospherics/pipe/simple/hidden/fuel{
	dir = 6
	},
/turf/simulated/shuttle/wall,
/area/space/debrisfield/explored)
"un" = (
/obj/machinery/atmospherics/pipe/manifold/hidden/supply{
	dir = 8
	},
/turf/simulated/shuttle/floor/yellow/airless,
/area/space/debrisfield/explored)
"uA" = (
/obj/machinery/atmospherics/pipe/simple/hidden/scrubbers,
/obj/machinery/door/airlock/hatch,
/obj/item/assembly/mousetrap/armed,
/turf/simulated/shuttle/floor/yellow/airless,
/area/space/debrisfield/explored)
"vc" = (
/obj/machinery/atmospherics/unary/vent_scrubber/on{
	dir = 8
	},
/obj/structure/table/bananium_reinforced,
/turf/simulated/shuttle/floor/yellow/airless,
/area/space/debrisfield/explored)
"ve" = (
/obj/structure/closet/syndicate/clownops/personal,
/turf/simulated/shuttle/floor/yellow/airless,
/area/space/debrisfield/explored)
"vr" = (
/obj/machinery/door/airlock/external,
/turf/simulated/shuttle/floor/yellow/airless,
/area/space/debrisfield/explored)
"wi" = (
/obj/machinery/atmospherics/pipe/manifold4w/hidden/supply,
/turf/simulated/shuttle/floor/yellow/airless,
/area/space/debrisfield/explored)
"wn" = (
/obj/machinery/atmospherics/pipe/simple/hidden/fuel{
	dir = 6
	},
/turf/simulated/shuttle/floor/yellow/airless,
/area/space/debrisfield/explored)
"ww" = (
/obj/machinery/light{
	dir = 1
	},
/turf/simulated/shuttle/floor/yellow/airless,
/area/space/debrisfield/explored)
"wB" = (
/obj/machinery/atmospherics/unary/vent_pump/high_volume{
	dir = 1
	},
/turf/simulated/shuttle/floor/yellow/airless,
/area/space/debrisfield/explored)
"wV" = (
/obj/machinery/atmospherics/unary/vent_pump/on{
	dir = 4
	},
/obj/item/clothing/mask/gas/clown_hat,
/obj/item/clothing/mask/gas/clown_hat,
/obj/item/clothing/mask/gas/clown_hat,
/obj/item/clothing/mask/gas/clown_hat,
/obj/machinery/light{
	dir = 1
	},
/obj/structure/table/bananium_reinforced,
/turf/simulated/shuttle/floor/yellow/airless,
/area/space/debrisfield/explored)
"xC" = (
/obj/machinery/atmospherics/portables_connector{
	dir = 4
	},
/obj/effect/floor_decal/industrial/outline/yellow,
/obj/machinery/portable_atmospherics/canister/empty,
/turf/simulated/shuttle/floor/yellow/airless,
/area/space/debrisfield/explored)
"yI" = (
/obj/machinery/shipsensors{
	dir = 1
	},
/turf/simulated/shuttle/plating/airless,
/area/space/debrisfield/explored)
"yV" = (
/obj/machinery/atmospherics/pipe/simple/hidden/scrubbers{
	dir = 5
	},
/obj/structure/cable/green{
	d1 = 1;
	d2 = 2;
	icon_state = "1-2"
	},
/turf/simulated/shuttle/floor/yellow/airless,
/area/space/debrisfield/explored)
"zg" = (
/obj/machinery/atmospherics/pipe/simple/hidden/scrubbers{
	dir = 4
	},
/obj/machinery/atmospherics/pipe/simple/hidden/supply{
	dir = 8
	},
/obj/structure/cable/green{
	d1 = 4;
	d2 = 8;
	icon_state = "4-8"
	},
/turf/simulated/shuttle/floor/yellow/airless,
/area/space/debrisfield/explored)
"zj" = (
/obj/machinery/atmospherics/pipe/simple/hidden/supply,
/obj/machinery/atmospherics/pipe/simple/hidden/scrubbers,
/obj/structure/cable/green{
	d1 = 1;
	d2 = 2;
	icon_state = "1-2"
	},
/turf/simulated/shuttle/floor/yellow/airless,
/area/space/debrisfield/explored)
"zx" = (
/obj/machinery/atmospherics/pipe/simple/hidden/scrubbers{
	dir = 10
	},
/obj/machinery/atmospherics/pipe/simple/hidden/supply,
/turf/simulated/shuttle/floor/yellow/airless,
/area/space/debrisfield/explored)
"Ao" = (
/obj/machinery/atmospherics/pipe/simple/hidden/scrubbers,
/turf/simulated/shuttle/floor/yellow/airless,
/area/space/debrisfield/explored)
"Aq" = (
/turf/space,
/area/space/debrisfield/explored)
"Ay" = (
/obj/machinery/atmospherics/pipe/simple/hidden/supply{
	dir = 6
	},
/mob/living/simple_mob/humanoid/clown/commando/melee/space/alt,
/turf/simulated/shuttle/floor/yellow/airless,
/area/space/debrisfield/explored)
"AL" = (
/obj/structure/table/rack/steel,
/obj/item/storage/backpack/clown,
/turf/simulated/shuttle/floor/yellow/airless,
/area/space/debrisfield/explored)
"BG" = (
/obj/machinery/alarm/alarms_hidden{
	dir = 8;
	pixel_x = 28
	},
/turf/simulated/shuttle/floor/red/airless,
/area/space/debrisfield/explored)
"Cm" = (
/obj/machinery/atmospherics/portables_connector{
	dir = 4
	},
/obj/machinery/portable_atmospherics/canister/air,
/obj/effect/floor_decal/industrial/outline,
/turf/simulated/shuttle/floor/yellow/airless,
/area/space/debrisfield/explored)
"Cz" = (
/obj/machinery/computer/ship/sensors,
/turf/simulated/shuttle/floor/red/airless,
/area/space/debrisfield/explored)
"DC" = (
/obj/machinery/mech_recharger,
/turf/simulated/floor/bluegrid,
/area/space/debrisfield/explored)
"Ej" = (
/obj/structure/bed,
/obj/item/bedsheet/clown,
/obj/item/bananapeel,
/turf/simulated/shuttle/floor/yellow/airless,
/area/space/debrisfield/explored)
"Eo" = (
/obj/machinery/atmospherics/pipe/simple/hidden/supply{
	dir = 10
	},
/obj/structure/cable/green{
	d1 = 1;
	d2 = 2;
	icon_state = "1-2"
	},
/turf/simulated/shuttle/floor/yellow/airless,
/area/space/debrisfield/explored)
"EG" = (
/obj/machinery/atmospherics/unary/vent_pump/on{
	dir = 4
	},
/obj/item/toy/prize/honk,
/obj/machinery/light,
/obj/structure/table/bananium_reinforced,
/turf/simulated/shuttle/floor/red/airless,
/area/space/debrisfield/explored)
"Fs" = (
/obj/machinery/atmospherics/pipe/simple/hidden/scrubbers,
/obj/structure/cable/green{
	d1 = 1;
	d2 = 2;
	icon_state = "1-2"
	},
/turf/simulated/shuttle/floor/yellow/airless,
/area/space/debrisfield/explored)
"FY" = (
/obj/structure/bed/chair/bay/shuttle{
	dir = 8
	},
/turf/simulated/shuttle/floor/yellow/airless,
/area/space/debrisfield/explored)
"Gl" = (
/obj/structure/statue/bananium/clown{
	name = "Shrine to the Honkmother"
	},
/turf/simulated/floor/bananium,
/area/space/debrisfield/explored)
"Gm" = (
/obj/machinery/atmospherics/pipe/simple/hidden/scrubbers{
	dir = 4
	},
/obj/machinery/atmospherics/pipe/simple/hidden/supply{
	dir = 8
	},
/turf/simulated/shuttle/floor/yellow/airless,
/area/space/debrisfield/explored)
"GW" = (
/obj/machinery/atmospherics/pipe/manifold/hidden/supply{
	dir = 4
	},
/obj/machinery/atmospherics/pipe/manifold/hidden/scrubbers{
	dir = 4
	},
/obj/structure/cable/green{
	d1 = 2;
	d2 = 8;
	icon_state = "2-8"
	},
/turf/simulated/shuttle/floor/yellow/airless,
/area/space/debrisfield/explored)
"Hj" = (
/obj/structure/shuttle/engine/heater,
/obj/machinery/atmospherics/pipe/simple/hidden/fuel{
	dir = 10
	},
/turf/simulated/shuttle/wall,
/area/space/debrisfield/explored)
"Hu" = (
/obj/machinery/computer/ship/engines,
/turf/simulated/shuttle/floor/red/airless,
/area/space/debrisfield/explored)
"HK" = (
/obj/machinery/mech_recharger,
/obj/effect/decal/mecha_wreckage/honker/cluwne,
/turf/simulated/floor/bluegrid,
/area/space/debrisfield/explored)
"HT" = (
/obj/machinery/alarm/alarms_hidden{
	dir = 4;
	pixel_x = -28
	},
/obj/structure/closet/syndicate/clownops/personal,
/turf/simulated/shuttle/floor/yellow/airless,
/area/space/debrisfield/explored)
"Is" = (
/obj/structure/fuel_port{
	dir = 4;
	pixel_x = -29
	},
/obj/machinery/alarm/alarms_hidden{
	dir = 1;
	pixel_y = -28
	},
/turf/simulated/shuttle/floor/yellow/airless,
/area/space/debrisfield/explored)
"ID" = (
/obj/machinery/atmospherics/pipe/manifold/hidden/fuel,
/turf/simulated/shuttle/floor/yellow/airless,
/area/space/debrisfield/explored)
"IE" = (
/obj/machinery/atmospherics/unary/vent_scrubber/on{
	dir = 8
	},
/obj/machinery/light,
/obj/structure/table/bananium_reinforced,
/turf/simulated/shuttle/floor/red/airless,
/area/space/debrisfield/explored)
"IJ" = (
/obj/structure/shuttle/engine/heater,
/obj/machinery/atmospherics/pipe/manifold/hidden/fuel{
	dir = 4
	},
/turf/simulated/shuttle/wall,
/area/space/debrisfield/explored)
"JT" = (
/obj/machinery/atmospherics/pipe/simple/hidden/supply,
/obj/machinery/atmospherics/pipe/simple/hidden/scrubbers{
	dir = 9
	},
/obj/structure/cable/green{
	d1 = 1;
	d2 = 4;
	icon_state = "1-4"
	},
/turf/simulated/shuttle/floor/yellow/airless,
/area/space/debrisfield/explored)
"JU" = (
/obj/machinery/power/smes/buildable/point_of_interest,
/obj/structure/cable/cyan,
/turf/simulated/shuttle/floor/yellow/airless,
/area/space/debrisfield/explored)
"Kf" = (
/obj/machinery/light{
	dir = 4
	},
/turf/simulated/shuttle/floor/yellow/airless,
/area/space/debrisfield/explored)
"KZ" = (
/obj/machinery/atmospherics/pipe/simple/hidden/supply,
/obj/machinery/atmospherics/pipe/simple/hidden/scrubbers,
/obj/machinery/door/airlock/hatch,
/turf/simulated/shuttle/floor/yellow/airless,
/area/space/debrisfield/explored)
"MI" = (
/obj/structure/table/bananium_reinforced,
/obj/item/flame/candle/everburn,
/turf/simulated/floor/bananium,
/area/space/debrisfield/explored)
"Nd" = (
/obj/machinery/atmospherics/portables_connector/fuel{
	dir = 8
	},
/obj/effect/floor_decal/industrial/outline/red,
/obj/machinery/portable_atmospherics/canister/phoron{
	start_pressure = 0
	},
/turf/simulated/shuttle/floor/yellow/airless,
/area/space/debrisfield/explored)
"OO" = (
/obj/structure/bed/chair/bay/shuttle{
	dir = 1
	},
/turf/simulated/shuttle/floor/red/airless,
/area/space/debrisfield/explored)
"OS" = (
/obj/machinery/light{
	dir = 4
	},
/obj/structure/bed,
/obj/item/bedsheet/clown,
/turf/simulated/shuttle/floor/yellow/airless,
/area/space/debrisfield/explored)
"Pw" = (
/obj/machinery/atmospherics/unary/vent_scrubber/on{
	dir = 4
	},
/obj/structure/table/bananium_reinforced,
/turf/simulated/shuttle/floor/yellow/airless,
/area/space/debrisfield/explored)
"PL" = (
/obj/machinery/alarm/alarms_hidden{
	dir = 8;
	pixel_x = 28
	},
/obj/structure/table/bananium_reinforced,
/turf/simulated/shuttle/floor/yellow/airless,
/area/space/debrisfield/explored)
"QF" = (
/obj/structure/closet/emcloset/legacy,
/turf/simulated/shuttle/floor/yellow/airless,
/area/space/debrisfield/explored)
"QI" = (
/obj/machinery/atmospherics/pipe/simple/hidden/supply,
/obj/machinery/door/airlock/external,
/obj/item/bananapeel,
/turf/simulated/shuttle/floor/yellow/airless,
/area/space/debrisfield/explored)
"QR" = (
/obj/machinery/door/window/southleft,
/turf/simulated/floor/bananium,
/area/space/debrisfield/explored)
"RH" = (
/obj/machinery/atmospherics/pipe/simple/hidden/supply,
/obj/machinery/atmospherics/pipe/simple/hidden/scrubbers,
/obj/machinery/door/airlock/hatch,
/obj/item/assembly/mousetrap/armed,
/turf/simulated/shuttle/floor/yellow/airless,
/area/space/debrisfield/explored)
"RR" = (
/obj/machinery/alarm/alarms_hidden{
	dir = 8;
	pixel_x = 28
	},
/obj/structure/bed/chair/bay/shuttle{
	dir = 8
	},
/turf/simulated/shuttle/floor/yellow/airless,
/area/space/debrisfield/explored)
"RX" = (
/obj/machinery/atmospherics/pipe/simple/hidden/scrubbers{
	dir = 6
	},
/obj/machinery/atmospherics/pipe/simple/hidden/supply,
/turf/simulated/shuttle/floor/yellow/airless,
/area/space/debrisfield/explored)
"Sr" = (
/obj/machinery/atmospherics/pipe/manifold/hidden/scrubbers{
	dir = 8
	},
/turf/simulated/shuttle/floor/yellow/airless,
/area/space/debrisfield/explored)
"SE" = (
/obj/structure/cable/cyan{
	d2 = 2;
	icon_state = "0-2"
	},
/obj/machinery/power/apc/alarms_hidden{
	pixel_y = 28
	},
/obj/structure/table/bananium_reinforced,
/turf/simulated/shuttle/floor/yellow/airless,
/area/space/debrisfield/explored)
"Tc" = (
/obj/machinery/atmospherics/pipe/simple/hidden/supply,
/turf/simulated/shuttle/floor/yellow/airless,
/area/space/debrisfield/explored)
"Tq" = (
/obj/structure/shuttle/engine/heater,
/obj/machinery/atmospherics/pipe/manifold/hidden/fuel{
	dir = 8
	},
/turf/simulated/shuttle/wall,
/area/space/debrisfield/explored)
"Tz" = (
/obj/machinery/vending/tool,
/turf/simulated/shuttle/floor/yellow/airless,
/area/space/debrisfield/explored)
"Um" = (
/obj/machinery/atmospherics/pipe/simple/hidden/supply{
	dir = 10
	},
/turf/simulated/shuttle/floor/yellow/airless,
/area/space/debrisfield/explored)
"Vl" = (
/obj/machinery/atmospherics/unary/vent_scrubber/on{
	dir = 4
	},
/obj/structure/closet/syndicate/clownops/personal,
/turf/simulated/shuttle/floor/yellow/airless,
/area/space/debrisfield/explored)
"Wc" = (
/obj/structure/fuel_port{
	dir = 4;
	pixel_x = 29
	},
/obj/machinery/alarm/alarms_hidden{
	dir = 1;
	pixel_y = -28
	},
/mob/living/simple_mob/humanoid/clown/commando/melee/space,
/turf/simulated/shuttle/floor/yellow/airless,
/area/space/debrisfield/explored)
"Wf" = (
/obj/machinery/atmospherics/pipe/manifold/hidden/supply{
	dir = 4
	},
/turf/simulated/shuttle/floor/yellow/airless,
/area/space/debrisfield/explored)
"Wo" = (
/obj/effect/floor_decal/industrial/outline,
/obj/structure/closet/crate/internals,
/turf/simulated/shuttle/floor/yellow/airless,
/area/space/debrisfield/explored)
"XK" = (
/obj/machinery/atmospherics/unary/vent_pump/on{
	dir = 8
	},
/obj/structure/table/bananium_reinforced,
/turf/simulated/shuttle/floor/yellow/airless,
/area/space/debrisfield/explored)
"Yj" = (
/turf/simulated/shuttle/floor/yellow/airless,
/area/space/debrisfield/explored)
"Yn" = (
/obj/machinery/atmospherics/unary/vent_pump/on{
	dir = 4
	},
/obj/structure/table/bananium_reinforced,
/turf/simulated/shuttle/floor/yellow/airless,
/area/space/debrisfield/explored)
"Yp" = (
/obj/machinery/atmospherics/portables_connector/fuel{
	dir = 4
	},
/obj/effect/floor_decal/industrial/outline/red,
/obj/machinery/portable_atmospherics/canister/phoron{
	start_pressure = 0
	},
/turf/simulated/shuttle/floor/yellow/airless,
/area/space/debrisfield/explored)
"YO" = (
/obj/structure/window/reinforced,
/obj/structure/table/bananium_reinforced,
/obj/item/flame/candle/everburn,
/turf/simulated/floor/bananium,
/area/space/debrisfield/explored)
"Zb" = (
/obj/machinery/atmospherics/pipe/manifold4w/hidden/scrubbers,
/obj/machinery/atmospherics/pipe/simple/hidden/supply{
	dir = 8
	},
/obj/structure/cable/green{
	d1 = 2;
	d2 = 4;
	icon_state = "2-4"
	},
/turf/simulated/shuttle/floor/yellow/airless,
/area/space/debrisfield/explored)
"Zp" = (
/obj/machinery/atmospherics/pipe/simple/hidden/universal{
	dir = 4
	},
/turf/simulated/shuttle/floor/yellow/airless,
/area/space/debrisfield/explored)
"Zr" = (
/obj/machinery/atmospherics/pipe/simple/hidden/scrubbers{
	dir = 6
	},
/turf/simulated/shuttle/floor/red/airless,
/area/space/debrisfield/explored)

(1,1,1) = {"
Aq
Aq
Aq
Aq
Aq
Aq
Aq
Aq
Aq
Aq
Aq
Aq
Aq
Aq
Aq
Aq
Aq
Aq
Aq
Aq
Aq
Aq
"}
(2,1,1) = {"
Aq
bw
bw
bw
bw
bw
Aq
Aq
Aq
Aq
Aq
Aq
Aq
Aq
Aq
Aq
bw
bw
bw
bw
Aq
Aq
"}
(3,1,1) = {"
Aq
bw
it
Yj
pt
bw
bw
bw
bw
bw
Aq
Aq
bw
bw
bw
bw
bw
Yp
Yp
uc
tQ
Aq
"}
(4,1,1) = {"
Aq
bw
it
Yj
Yj
iz
dK
dK
tN
bw
bw
bw
bw
aP
xC
Cm
Cm
jF
ID
km
tQ
Aq
"}
(5,1,1) = {"
Aq
bw
bw
Wo
Yj
dd
Yj
Yj
Yj
bw
gn
pP
bw
ww
Zp
Zp
Zp
Yj
ow
IJ
tQ
Aq
"}
(6,1,1) = {"
Aq
Aq
bw
bw
oX
Yj
Ay
RX
ce
cK
ce
fw
RH
ce
ge
wi
rO
Wc
bw
bw
Aq
Aq
"}
(7,1,1) = {"
Aq
Aq
Aq
bw
bw
PL
XK
vc
Yj
bw
Yj
Gm
bw
nG
ri
kY
Tz
bw
bw
Aq
Aq
Aq
"}
(8,1,1) = {"
Aq
bw
bw
bw
bw
bw
bw
bw
bw
bw
Yj
Gm
bw
bw
bw
bw
bw
bw
Aq
Aq
Aq
Aq
"}
(9,1,1) = {"
Aq
bw
aj
nK
EG
bw
wV
qb
am
pJ
Yj
Gm
oo
oo
oo
oo
eF
bw
bw
bw
bw
Aq
"}
(10,1,1) = {"
Aq
sB
hc
OO
kH
lM
Wf
Tc
Tc
Tc
Tc
fp
Tc
Tc
Tc
Tc
Wf
QI
un
wB
vr
Aq
"}
(11,1,1) = {"
Aq
sB
Hu
OO
Zr
uA
Sr
Ao
Ao
Ao
Ao
Zb
Fs
Fs
Fs
lD
yV
kw
Eo
nW
dO
Aq
"}
(12,1,1) = {"
Aq
bw
Cz
BG
IE
bw
qD
db
AL
QF
Yj
zg
FY
FY
FY
RR
al
bw
bw
bw
bw
Aq
"}
(13,1,1) = {"
Aq
bw
bw
bw
bw
bw
bw
bw
bw
bw
Yj
zg
bw
bw
bw
bw
bw
bw
Aq
Aq
Aq
Aq
"}
(14,1,1) = {"
Aq
Aq
yI
bw
bw
HT
mN
Vl
ve
bw
Yj
zg
bw
hF
Pw
Yn
hF
bw
bw
Aq
Aq
Aq
"}
(15,1,1) = {"
Aq
Aq
bw
bw
ve
Yj
Um
zx
ce
KZ
ce
GW
nA
zj
JT
rO
Yj
Is
bw
bw
Aq
Aq
"}
(16,1,1) = {"
Aq
bw
bw
YO
Yj
Yj
Yj
Yj
Yj
bw
Kf
Yj
bw
kX
sQ
Yj
Yj
Yj
qr
Tq
tQ
Aq
"}
(17,1,1) = {"
Aq
bw
Gl
QR
pP
OS
jv
Ej
jv
bw
bw
bw
bw
SE
JU
HK
DC
wn
ID
km
tQ
Aq
"}
(18,1,1) = {"
Aq
bw
MI
aT
an
bw
bw
bw
bw
bw
Aq
Aq
bw
bw
bw
bw
bw
Nd
Nd
Hj
tQ
Aq
"}
(19,1,1) = {"
Aq
bw
bw
bw
bw
bw
Aq
Aq
Aq
Aq
Aq
Aq
Aq
Aq
Aq
Aq
bw
bw
bw
bw
Aq
Aq
"}
(20,1,1) = {"
Aq
Aq
Aq
Aq
Aq
Aq
Aq
Aq
Aq
Aq
Aq
Aq
Aq
Aq
Aq
Aq
Aq
Aq
Aq
Aq
Aq
Aq
"}
