//MAP CONVERTED BY dmm2tgm.py THIS HEADER COMMENT PREVENTS RECONVERSION, DO NOT REMOVE
"aj" = (
/obj/machinery/computer/shuttle_control/explore/excursion,
/turf/simulated/shuttle/floor/red/airless,
/area/space)
"al" = (
/obj/machinery/atmospherics/unary/vent_scrubber/on{
	dir = 8
	},
/obj/structure/table/steel_reinforced,
/obj/machinery/light,
/turf/simulated/shuttle/floor/yellow/airless,
/area/space)
"am" = (
/obj/structure/table/rack/steel,
/obj/item/nullrod/clown,
/obj/item/nullrod/clown,
/turf/simulated/shuttle/floor/yellow/airless,
/area/space)
"aP" = (
/obj/structure/table/steel_reinforced,
/obj/item/toy/figure/clown,
/turf/simulated/shuttle/floor/yellow/airless,
/area/space)
"bw" = (
/turf/simulated/shuttle/wall,
/area/space)
"ce" = (
/obj/machinery/atmospherics/pipe/simple/hidden/supply,
/obj/machinery/atmospherics/pipe/simple/hidden/scrubbers,
/turf/simulated/shuttle/floor/yellow/airless,
/area/space)
"cK" = (
/obj/machinery/atmospherics/pipe/simple/hidden/supply,
/obj/machinery/atmospherics/pipe/simple/hidden/scrubbers,
/obj/machinery/door/airlock/hatch,
/obj/item/bananapeel,
/turf/simulated/shuttle/floor/yellow/airless,
/area/space)
"db" = (
/obj/structure/table/rack/steel,
/obj/item/stamp/clown,
/obj/item/stamp/clown,
/turf/simulated/shuttle/floor/yellow/airless,
/area/space)
"dK" = (
/obj/effect/floor_decal/industrial/outline,
/obj/structure/closet/crate/secure/loot,
/turf/simulated/shuttle/floor/yellow/airless,
/area/space)
"dO" = (
/obj/structure/cable/green{
	d1 = 1;
	d2 = 2;
	icon_state = "1-2"
	},
/obj/machinery/door/airlock/external,
/turf/simulated/shuttle/floor/yellow/airless,
/area/space)
"eF" = (
/obj/machinery/atmospherics/unary/vent_pump/on{
	dir = 4
	},
/obj/structure/table/steel_reinforced,
/obj/item/reagent_containers/food/snacks/clownburger,
/obj/item/reagent_containers/food/snacks/clownburger,
/obj/machinery/light,
/turf/simulated/shuttle/floor/yellow/airless,
/area/space)
"fp" = (
/obj/machinery/atmospherics/pipe/manifold4w/hidden/supply,
/obj/machinery/atmospherics/pipe/simple/hidden/scrubbers{
	dir = 4
	},
/turf/simulated/shuttle/floor/yellow/airless,
/area/space)
"fw" = (
/obj/machinery/atmospherics/pipe/manifold/hidden/supply{
	dir = 8
	},
/obj/machinery/atmospherics/pipe/manifold/hidden/scrubbers{
	dir = 8
	},
/turf/simulated/shuttle/floor/yellow/airless,
/area/space)
"ge" = (
/obj/machinery/atmospherics/pipe/simple/hidden/supply,
/obj/machinery/atmospherics/pipe/manifold/hidden/scrubbers,
/turf/simulated/shuttle/floor/yellow/airless,
/area/space)
"gn" = (
/obj/machinery/light{
	dir = 8
	},
/turf/simulated/shuttle/floor/yellow/airless,
/area/space)
"hc" = (
/obj/machinery/computer/ship/helm,
/turf/simulated/shuttle/floor/red/airless,
/area/space)
"hF" = (
/obj/structure/table/steel_reinforced,
/turf/simulated/shuttle/floor/yellow/airless,
/area/space)
"it" = (
/obj/effect/floor_decal/industrial/outline,
/obj/structure/closet/crate/freezer/rations,
/turf/simulated/shuttle/floor/yellow/airless,
/area/space)
"iz" = (
/obj/effect/floor_decal/industrial/outline,
/obj/structure/closet/crate/secure,
/obj/item/ore/vaudium,
/obj/item/ore/vaudium,
/obj/item/ore/vaudium,
/obj/item/ore/vaudium,
/obj/item/ore/vaudium,
/obj/item/ore/vaudium,
/obj/item/ore/vaudium,
/obj/item/ore/vaudium,
/obj/item/ore/vaudium,
/obj/item/ore/vaudium,
/obj/machinery/light{
	dir = 8
	},
/turf/simulated/shuttle/floor/yellow/airless,
/area/space)
"jv" = (
/obj/structure/bed,
/obj/item/bedsheet/clown,
/turf/simulated/shuttle/floor/yellow/airless,
/area/space)
"jF" = (
/obj/machinery/atmospherics/pipe/simple/hidden/fuel{
	dir = 10
	},
/turf/simulated/shuttle/floor/yellow/airless,
/area/space)
"km" = (
/obj/structure/shuttle/engine/heater,
/obj/machinery/atmospherics/pipe/manifold/hidden/fuel{
	dir = 1
	},
/turf/simulated/shuttle/wall,
/area/space)
"kw" = (
/obj/structure/cable/green{
	d1 = 1;
	d2 = 2;
	icon_state = "1-2"
	},
/obj/machinery/door/airlock/external,
/obj/item/bananapeel,
/turf/simulated/shuttle/floor/yellow/airless,
/area/space)
"kH" = (
/obj/machinery/atmospherics/pipe/simple/hidden/supply{
	dir = 10
	},
/turf/simulated/shuttle/floor/red/airless,
/area/space)
"kY" = (
/obj/structure/table/steel_reinforced,
/obj/machinery/atmospherics/unary/vent_pump/on{
	dir = 8
	},
/obj/item/storage/toolbox/electrical,
/turf/simulated/shuttle/floor/yellow/airless,
/area/space)
"lM" = (
/obj/machinery/atmospherics/pipe/simple/hidden/supply,
/obj/machinery/door/airlock/hatch,
/turf/simulated/shuttle/floor/yellow/airless,
/area/space)
"mN" = (
/obj/machinery/atmospherics/unary/vent_pump/on{
	dir = 4
	},
/obj/structure/closet/syndicate/suit,
/turf/simulated/shuttle/floor/yellow/airless,
/area/space)
"nA" = (
/obj/machinery/atmospherics/pipe/simple/hidden/supply,
/obj/machinery/atmospherics/pipe/simple/hidden/scrubbers,
/obj/structure/cable/green{
	d1 = 1;
	d2 = 2;
	icon_state = "1-2"
	},
/obj/machinery/door/airlock/hatch,
/obj/item/bananapeel,
/turf/simulated/shuttle/floor/yellow/airless,
/area/space)
"nG" = (
/obj/machinery/vending/assist,
/turf/simulated/shuttle/floor/yellow/airless,
/area/space)
"nK" = (
/turf/simulated/shuttle/floor/red/airless,
/area/space)
"nW" = (
/obj/machinery/atmospherics/unary/vent_pump/high_volume{
	dir = 1
	},
/obj/structure/cable/green{
	d1 = 1;
	d2 = 2;
	icon_state = "1-2"
	},
/turf/simulated/shuttle/floor/yellow/airless,
/area/space)
"oo" = (
/obj/structure/bed/chair/bay/shuttle{
	dir = 4
	},
/turf/simulated/shuttle/floor/yellow/airless,
/area/space)
"ow" = (
/obj/machinery/atmospherics/pipe/simple/hidden/fuel{
	dir = 10
	},
/obj/machinery/light{
	dir = 4
	},
/turf/simulated/shuttle/floor/yellow/airless,
/area/space)
"oX" = (
/obj/effect/floor_decal/industrial/outline,
/obj/structure/closet/crate/plastic,
/turf/simulated/shuttle/floor/yellow/airless,
/area/space)
"pt" = (
/obj/effect/floor_decal/industrial/outline,
/obj/structure/closet/crate/medical/blood,
/turf/simulated/shuttle/floor/yellow/airless,
/area/space)
"pJ" = (
/obj/structure/closet/emcloset/legacy,
/obj/item/clothing/mask/breath,
/obj/item/clothing/mask/breath,
/obj/item/clothing/mask/breath,
/obj/item/clothing/mask/breath,
/obj/item/tank/emergency/oxygen/engi,
/obj/item/tank/emergency/oxygen/engi,
/obj/item/tank/emergency/oxygen/engi,
/obj/item/tank/emergency/oxygen/engi,
/obj/item/clothing/suit/space/emergency,
/obj/item/clothing/suit/space/emergency,
/obj/item/clothing/suit/space/emergency,
/obj/item/clothing/suit/space/emergency,
/obj/item/clothing/head/helmet/space/emergency,
/obj/item/clothing/head/helmet/space/emergency,
/obj/item/clothing/head/helmet/space/emergency,
/obj/item/clothing/head/helmet/space/emergency,
/obj/item/storage/backpack/parachute,
/obj/item/storage/backpack/parachute,
/obj/item/storage/backpack/parachute,
/obj/item/storage/backpack/parachute,
/turf/simulated/shuttle/floor/yellow/airless,
/area/space)
"qb" = (
/obj/structure/table/rack/steel,
/obj/item/bikehorn,
/obj/item/bikehorn,
/obj/item/bikehorn,
/obj/item/bikehorn,
/turf/simulated/shuttle/floor/yellow/airless,
/area/space)
"qr" = (
/obj/machinery/atmospherics/pipe/simple/hidden/fuel{
	dir = 6
	},
/obj/machinery/light{
	dir = 8
	},
/turf/simulated/shuttle/floor/yellow/airless,
/area/space)
"qD" = (
/obj/machinery/atmospherics/unary/vent_scrubber/on{
	dir = 8
	},
/obj/structure/table/steel_reinforced,
/obj/item/reagent_containers/food/snacks/pie,
/obj/item/reagent_containers/food/snacks/pie,
/obj/item/reagent_containers/food/snacks/pie,
/obj/item/reagent_containers/food/snacks/pie,
/obj/item/reagent_containers/food/snacks/pie,
/obj/item/reagent_containers/food/snacks/pie,
/obj/item/reagent_containers/food/snacks/pie,
/obj/item/reagent_containers/food/snacks/pie,
/obj/machinery/light{
	dir = 1
	},
/turf/simulated/shuttle/floor/yellow/airless,
/area/space)
"ri" = (
/obj/structure/table/steel_reinforced,
/obj/machinery/atmospherics/unary/vent_scrubber/on{
	dir = 8
	},
/obj/item/storage/toolbox/emergency,
/turf/simulated/shuttle/floor/yellow/airless,
/area/space)
"rO" = (
/obj/machinery/atmospherics/pipe/simple/hidden/supply{
	dir = 9
	},
/turf/simulated/shuttle/floor/yellow/airless,
/area/space)
"sB" = (
/turf/simulated/shuttle/plating/airless,
/area/space)
"sQ" = (
/obj/machinery/power/terminal{
	dir = 4
	},
/obj/structure/cable/green{
	d2 = 8;
	icon_state = "0-8"
	},
/turf/simulated/shuttle/floor/yellow/airless,
/area/space)
"tN" = (
/obj/effect/floor_decal/industrial/outline,
/obj/structure/closet/crate/large,
/turf/simulated/shuttle/floor/yellow/airless,
/area/space)
"tQ" = (
/obj/structure/shuttle/engine/propulsion,
/turf/simulated/shuttle/plating/airless,
/area/space)
"uc" = (
/obj/structure/shuttle/engine/heater,
/obj/machinery/atmospherics/pipe/simple/hidden/fuel{
	dir = 6
	},
/turf/simulated/shuttle/wall,
/area/space)
"un" = (
/obj/machinery/atmospherics/pipe/manifold/hidden/supply{
	dir = 8
	},
/turf/simulated/shuttle/floor/yellow/airless,
/area/space)
"uA" = (
/obj/machinery/atmospherics/pipe/simple/hidden/scrubbers,
/obj/machinery/door/airlock/hatch,
/obj/item/assembly/mousetrap/armed,
/turf/simulated/shuttle/floor/yellow/airless,
/area/space)
"vc" = (
/obj/machinery/atmospherics/unary/vent_scrubber/on{
	dir = 8
	},
/obj/structure/table/steel_reinforced,
/turf/simulated/shuttle/floor/yellow/airless,
/area/space)
"vr" = (
/obj/machinery/door/airlock/external,
/turf/simulated/shuttle/floor/yellow/airless,
/area/space)
"wi" = (
/obj/machinery/atmospherics/pipe/manifold4w/hidden/supply,
/turf/simulated/shuttle/floor/yellow/airless,
/area/space)
"wn" = (
/obj/machinery/atmospherics/pipe/simple/hidden/fuel{
	dir = 6
	},
/turf/simulated/shuttle/floor/yellow/airless,
/area/space)
"ww" = (
/obj/machinery/light{
	dir = 1
	},
/turf/simulated/shuttle/floor/yellow/airless,
/area/space)
"wB" = (
/obj/machinery/atmospherics/unary/vent_pump/high_volume{
	dir = 1
	},
/turf/simulated/shuttle/floor/yellow/airless,
/area/space)
"wV" = (
/obj/machinery/atmospherics/unary/vent_pump/on{
	dir = 4
	},
/obj/structure/table/steel_reinforced,
/obj/item/clothing/mask/gas/clown_hat,
/obj/item/clothing/mask/gas/clown_hat,
/obj/item/clothing/mask/gas/clown_hat,
/obj/item/clothing/mask/gas/clown_hat,
/obj/machinery/light{
	dir = 1
	},
/turf/simulated/shuttle/floor/yellow/airless,
/area/space)
"xC" = (
/obj/machinery/atmospherics/portables_connector{
	dir = 4
	},
/obj/effect/floor_decal/industrial/outline/yellow,
/obj/machinery/portable_atmospherics/canister/empty,
/turf/simulated/shuttle/floor/yellow/airless,
/area/space)
"yI" = (
/obj/machinery/shipsensors{
	dir = 1
	},
/turf/simulated/shuttle/plating/airless,
/area/space)
"yV" = (
/obj/machinery/atmospherics/pipe/simple/hidden/scrubbers{
	dir = 5
	},
/obj/structure/cable/green{
	d1 = 1;
	d2 = 2;
	icon_state = "1-2"
	},
/turf/simulated/shuttle/floor/yellow/airless,
/area/space)
"zg" = (
/obj/machinery/atmospherics/pipe/simple/hidden/scrubbers{
	dir = 4
	},
/obj/machinery/atmospherics/pipe/simple/hidden/supply{
	dir = 8
	},
/obj/structure/cable/green{
	d1 = 4;
	d2 = 8;
	icon_state = "4-8"
	},
/turf/simulated/shuttle/floor/yellow/airless,
/area/space)
"zj" = (
/obj/machinery/atmospherics/pipe/simple/hidden/supply,
/obj/machinery/atmospherics/pipe/simple/hidden/scrubbers,
/obj/structure/cable/green{
	d1 = 1;
	d2 = 2;
	icon_state = "1-2"
	},
/turf/simulated/shuttle/floor/yellow/airless,
/area/space)
"zx" = (
/obj/machinery/atmospherics/pipe/simple/hidden/scrubbers{
	dir = 10
	},
/obj/machinery/atmospherics/pipe/simple/hidden/supply,
/turf/simulated/shuttle/floor/yellow/airless,
/area/space)
"Ao" = (
/obj/machinery/atmospherics/pipe/simple/hidden/scrubbers,
/turf/simulated/shuttle/floor/yellow/airless,
/area/space)
"Aq" = (
/turf/space,
/area/space)
"Ay" = (
/obj/machinery/atmospherics/pipe/simple/hidden/supply{
	dir = 6
	},
/turf/simulated/shuttle/floor/yellow/airless,
/area/space)
"AL" = (
/obj/structure/table/rack/steel,
/obj/item/storage/backpack/clown,
/turf/simulated/shuttle/floor/yellow/airless,
/area/space)
"BG" = (
/obj/machinery/alarm/alarms_hidden{
	dir = 8;
	pixel_x = 28
	},
/turf/simulated/shuttle/floor/red/airless,
/area/space)
"Cm" = (
/obj/machinery/atmospherics/portables_connector{
	dir = 4
	},
/obj/machinery/portable_atmospherics/canister/air,
/obj/effect/floor_decal/industrial/outline,
/turf/simulated/shuttle/floor/yellow/airless,
/area/space)
"Cz" = (
/obj/machinery/computer/ship/sensors,
/turf/simulated/shuttle/floor/red/airless,
/area/space)
"DC" = (
/obj/machinery/mech_recharger,
/turf/simulated/floor/bluegrid,
/area/space)
"Ej" = (
/obj/structure/bed,
/obj/item/bedsheet/clown,
/obj/item/bananapeel,
/turf/simulated/shuttle/floor/yellow/airless,
/area/space)
"Eo" = (
/obj/machinery/atmospherics/pipe/simple/hidden/supply{
	dir = 10
	},
/obj/structure/cable/green{
	d1 = 1;
	d2 = 2;
	icon_state = "1-2"
	},
/turf/simulated/shuttle/floor/yellow/airless,
/area/space)
"EG" = (
/obj/machinery/atmospherics/unary/vent_pump/on{
	dir = 4
	},
/obj/structure/table/steel_reinforced,
/obj/item/toy/prize/honk,
/obj/machinery/light,
/turf/simulated/shuttle/floor/red/airless,
/area/space)
"Fs" = (
/obj/machinery/atmospherics/pipe/simple/hidden/scrubbers,
/obj/structure/cable/green{
	d1 = 1;
	d2 = 2;
	icon_state = "1-2"
	},
/turf/simulated/shuttle/floor/yellow/airless,
/area/space)
"FY" = (
/obj/structure/bed/chair/bay/shuttle{
	dir = 8
	},
/turf/simulated/shuttle/floor/yellow/airless,
/area/space)
"Gl" = (
/turf/simulated/shuttle/floor/yellow/airless,
/area/space)
"Gm" = (
/obj/machinery/atmospherics/pipe/simple/hidden/scrubbers{
	dir = 4
	},
/obj/machinery/atmospherics/pipe/simple/hidden/supply{
	dir = 8
	},
/turf/simulated/shuttle/floor/yellow/airless,
/area/space)
"GW" = (
/obj/machinery/atmospherics/pipe/manifold/hidden/supply{
	dir = 4
	},
/obj/machinery/atmospherics/pipe/manifold/hidden/scrubbers{
	dir = 4
	},
/obj/structure/cable/green{
	d1 = 2;
	d2 = 8;
	icon_state = "2-8"
	},
/turf/simulated/shuttle/floor/yellow/airless,
/area/space)
"Hj" = (
/obj/structure/shuttle/engine/heater,
/obj/machinery/atmospherics/pipe/simple/hidden/fuel{
	dir = 10
	},
/turf/simulated/shuttle/wall,
/area/space)
"Hu" = (
/obj/machinery/computer/ship/engines,
/turf/simulated/shuttle/floor/red/airless,
/area/space)
"HK" = (
/obj/machinery/mech_recharger,
/obj/effect/decal/mecha_wreckage/honker/cluwne,
/turf/simulated/floor/bluegrid,
/area/space)
"HT" = (
/obj/structure/closet/syndicate/suit,
/obj/machinery/alarm/alarms_hidden{
	dir = 4;
	pixel_x = -28
	},
/turf/simulated/shuttle/floor/yellow/airless,
/area/space)
"Is" = (
/obj/structure/fuel_port{
	dir = 4;
	pixel_x = -29
	},
/obj/machinery/alarm/alarms_hidden{
	dir = 1;
	pixel_y = -28
	},
/turf/simulated/shuttle/floor/yellow/airless,
/area/space)
"ID" = (
/obj/machinery/atmospherics/pipe/manifold/hidden/fuel,
/turf/simulated/shuttle/floor/yellow/airless,
/area/space)
"IE" = (
/obj/machinery/atmospherics/unary/vent_scrubber/on{
	dir = 8
	},
/obj/structure/table/steel_reinforced,
/obj/machinery/light,
/turf/simulated/shuttle/floor/red/airless,
/area/space)
"IJ" = (
/obj/structure/shuttle/engine/heater,
/obj/machinery/atmospherics/pipe/manifold/hidden/fuel{
	dir = 4
	},
/turf/simulated/shuttle/wall,
/area/space)
"JT" = (
/obj/machinery/atmospherics/pipe/simple/hidden/supply,
/obj/machinery/atmospherics/pipe/simple/hidden/scrubbers{
	dir = 9
	},
/obj/structure/cable/green{
	d1 = 1;
	d2 = 4;
	icon_state = "1-4"
	},
/turf/simulated/shuttle/floor/yellow/airless,
/area/space)
"JU" = (
/obj/machinery/power/smes/buildable/point_of_interest,
/obj/structure/cable/cyan,
/turf/simulated/shuttle/floor/yellow/airless,
/area/space)
"KZ" = (
/obj/machinery/atmospherics/pipe/simple/hidden/supply,
/obj/machinery/atmospherics/pipe/simple/hidden/scrubbers,
/obj/machinery/door/airlock/hatch,
/turf/simulated/shuttle/floor/yellow/airless,
/area/space)
"MI" = (
/obj/item/bedsheet/clown,
/obj/structure/bed,
/turf/simulated/shuttle/floor/yellow/airless,
/area/space)
"Nd" = (
/obj/machinery/atmospherics/portables_connector/fuel{
	dir = 8
	},
/obj/effect/floor_decal/industrial/outline/red,
/obj/machinery/portable_atmospherics/canister/phoron{
	start_pressure = 0
	},
/turf/simulated/shuttle/floor/yellow/airless,
/area/space)
"OO" = (
/obj/structure/bed/chair/bay/shuttle{
	dir = 1
	},
/turf/simulated/shuttle/floor/red/airless,
/area/space)
"OS" = (
/obj/machinery/light{
	dir = 4
	},
/turf/simulated/shuttle/floor/yellow/airless,
/area/space)
"Pw" = (
/obj/machinery/atmospherics/unary/vent_scrubber/on{
	dir = 4
	},
/obj/structure/table/steel_reinforced,
/turf/simulated/shuttle/floor/yellow/airless,
/area/space)
"PL" = (
/obj/structure/table/steel_reinforced,
/obj/machinery/alarm/alarms_hidden{
	dir = 8;
	pixel_x = 28
	},
/turf/simulated/shuttle/floor/yellow/airless,
/area/space)
"QF" = (
/obj/structure/closet/emcloset/legacy,
/turf/simulated/shuttle/floor/yellow/airless,
/area/space)
"QI" = (
/obj/machinery/atmospherics/pipe/simple/hidden/supply,
/obj/machinery/door/airlock/external,
/obj/item/bananapeel,
/turf/simulated/shuttle/floor/yellow/airless,
/area/space)
"RH" = (
/obj/machinery/atmospherics/pipe/simple/hidden/supply,
/obj/machinery/atmospherics/pipe/simple/hidden/scrubbers,
/obj/machinery/door/airlock/hatch,
/obj/item/assembly/mousetrap/armed,
/turf/simulated/shuttle/floor/yellow/airless,
/area/space)
"RR" = (
/obj/machinery/alarm/alarms_hidden{
	dir = 8;
	pixel_x = 28
	},
/obj/structure/bed/chair/bay/shuttle{
	dir = 8
	},
/turf/simulated/shuttle/floor/yellow/airless,
/area/space)
"RX" = (
/obj/machinery/atmospherics/pipe/simple/hidden/scrubbers{
	dir = 6
	},
/obj/machinery/atmospherics/pipe/simple/hidden/supply,
/turf/simulated/shuttle/floor/yellow/airless,
/area/space)
"Sr" = (
/obj/machinery/atmospherics/pipe/manifold/hidden/scrubbers{
	dir = 8
	},
/turf/simulated/shuttle/floor/yellow/airless,
/area/space)
"SE" = (
/obj/structure/cable/cyan{
	d2 = 2;
	icon_state = "0-2"
	},
/obj/machinery/power/apc/alarms_hidden{
	pixel_y = 28
	},
/obj/structure/table/steel_reinforced,
/turf/simulated/shuttle/floor/yellow/airless,
/area/space)
"Tc" = (
/obj/machinery/atmospherics/pipe/simple/hidden/supply,
/turf/simulated/shuttle/floor/yellow/airless,
/area/space)
"Tq" = (
/obj/structure/shuttle/engine/heater,
/obj/machinery/atmospherics/pipe/manifold/hidden/fuel{
	dir = 8
	},
/turf/simulated/shuttle/wall,
/area/space)
"Tz" = (
/obj/machinery/vending/tool,
/turf/simulated/shuttle/floor/yellow/airless,
/area/space)
"Um" = (
/obj/machinery/atmospherics/pipe/simple/hidden/supply{
	dir = 10
	},
/turf/simulated/shuttle/floor/yellow/airless,
/area/space)
"Vl" = (
/obj/machinery/atmospherics/unary/vent_scrubber/on{
	dir = 4
	},
/obj/structure/closet/syndicate/suit,
/turf/simulated/shuttle/floor/yellow/airless,
/area/space)
"Wc" = (
/obj/structure/fuel_port{
	dir = 4;
	pixel_x = 29
	},
/obj/machinery/alarm/alarms_hidden{
	dir = 1;
	pixel_y = -28
	},
/turf/simulated/shuttle/floor/yellow/airless,
/area/space)
"Wf" = (
/obj/machinery/atmospherics/pipe/manifold/hidden/supply{
	dir = 4
	},
/turf/simulated/shuttle/floor/yellow/airless,
/area/space)
"Wo" = (
/obj/effect/floor_decal/industrial/outline,
/obj/structure/closet/crate/internals,
/turf/simulated/shuttle/floor/yellow/airless,
/area/space)
"XK" = (
/obj/machinery/atmospherics/unary/vent_pump/on{
	dir = 8
	},
/obj/structure/table/steel_reinforced,
/turf/simulated/shuttle/floor/yellow/airless,
/area/space)
"Yj" = (
/obj/structure/statue/bananium/clown,
/turf/simulated/shuttle/floor/yellow/airless,
/area/space)
"Yn" = (
/obj/machinery/atmospherics/unary/vent_pump/on{
	dir = 4
	},
/obj/structure/table/steel_reinforced,
/turf/simulated/shuttle/floor/yellow/airless,
/area/space)
"Yp" = (
/obj/machinery/atmospherics/portables_connector/fuel{
	dir = 4
	},
/obj/effect/floor_decal/industrial/outline/red,
/obj/machinery/portable_atmospherics/canister/phoron{
	start_pressure = 0
	},
/turf/simulated/shuttle/floor/yellow/airless,
/area/space)
"YO" = (
/obj/structure/closet/syndicate/suit,
/turf/simulated/shuttle/floor/yellow/airless,
/area/space)
"Zb" = (
/obj/machinery/atmospherics/pipe/manifold4w/hidden/scrubbers,
/obj/machinery/atmospherics/pipe/simple/hidden/supply{
	dir = 8
	},
/obj/structure/cable/green{
	d1 = 2;
	d2 = 4;
	icon_state = "2-4"
	},
/turf/simulated/shuttle/floor/yellow/airless,
/area/space)
"Zp" = (
/obj/machinery/atmospherics/pipe/simple/hidden/universal{
	dir = 4
	},
/turf/simulated/shuttle/floor/yellow/airless,
/area/space)
"Zr" = (
/obj/machinery/atmospherics/pipe/simple/hidden/scrubbers{
	dir = 6
	},
/turf/simulated/shuttle/floor/red/airless,
/area/space)

(1,1,1) = {"
Aq
Aq
Aq
Aq
Aq
Aq
Aq
Aq
Aq
Aq
Aq
Aq
Aq
Aq
Aq
Aq
Aq
Aq
Aq
Aq
Aq
Aq
"}
(2,1,1) = {"
Aq
bw
bw
bw
bw
bw
Aq
Aq
Aq
Aq
Aq
Aq
Aq
Aq
Aq
Aq
bw
bw
bw
bw
Aq
Aq
"}
(3,1,1) = {"
Aq
bw
it
Gl
pt
bw
bw
bw
bw
bw
Aq
Aq
bw
bw
bw
bw
bw
Yp
Yp
uc
tQ
Aq
"}
(4,1,1) = {"
Aq
bw
it
Gl
Gl
iz
dK
dK
tN
bw
bw
bw
bw
aP
xC
Cm
Cm
jF
ID
km
tQ
Aq
"}
(5,1,1) = {"
Aq
bw
bw
Wo
Gl
Gl
Gl
Gl
Gl
bw
gn
Gl
bw
ww
Zp
Zp
Zp
Gl
ow
IJ
tQ
Aq
"}
(6,1,1) = {"
Aq
Aq
bw
bw
oX
Gl
Ay
RX
ce
cK
ce
fw
RH
ce
ge
wi
rO
Wc
bw
bw
Aq
Aq
"}
(7,1,1) = {"
Aq
Aq
Aq
bw
bw
PL
XK
vc
Yj
bw
Gl
Gm
bw
nG
ri
kY
Tz
bw
bw
Aq
Aq
Aq
"}
(8,1,1) = {"
Aq
bw
bw
bw
bw
bw
bw
bw
bw
bw
Gl
Gm
bw
bw
bw
bw
bw
bw
Aq
Aq
Aq
Aq
"}
(9,1,1) = {"
Aq
bw
aj
nK
EG
bw
wV
qb
am
pJ
Gl
Gm
oo
oo
oo
oo
eF
bw
bw
bw
bw
Aq
"}
(10,1,1) = {"
Aq
sB
hc
OO
kH
lM
Wf
Tc
Tc
Tc
Tc
fp
Tc
Tc
Tc
Tc
Wf
QI
un
wB
vr
Aq
"}
(11,1,1) = {"
Aq
sB
Hu
OO
Zr
uA
Sr
Ao
Ao
Ao
Ao
Zb
Fs
Fs
Fs
Fs
yV
kw
Eo
nW
dO
Aq
"}
(12,1,1) = {"
Aq
bw
Cz
BG
IE
bw
qD
db
AL
QF
Gl
zg
FY
FY
FY
RR
al
bw
bw
bw
bw
Aq
"}
(13,1,1) = {"
Aq
bw
bw
bw
bw
bw
bw
bw
bw
bw
Gl
zg
bw
bw
bw
bw
bw
bw
Aq
Aq
Aq
Aq
"}
(14,1,1) = {"
Aq
Aq
yI
bw
bw
HT
mN
Vl
YO
bw
Gl
zg
bw
hF
Pw
Yn
hF
bw
bw
Aq
Aq
Aq
"}
(15,1,1) = {"
Aq
Aq
bw
bw
YO
Gl
Um
zx
ce
KZ
ce
GW
nA
zj
JT
rO
Gl
Is
bw
bw
Aq
Aq
"}
(16,1,1) = {"
Aq
bw
bw
YO
Gl
Gl
Gl
Gl
Gl
bw
OS
Gl
bw
ww
sQ
Gl
Gl
Gl
qr
Tq
tQ
Aq
"}
(17,1,1) = {"
Aq
bw
Gl
Gl
Gl
OS
jv
Ej
jv
bw
bw
bw
bw
SE
JU
HK
DC
wn
ID
km
tQ
Aq
"}
(18,1,1) = {"
Aq
bw
MI
MI
MI
bw
bw
bw
bw
bw
Aq
Aq
bw
bw
bw
bw
bw
Nd
Nd
Hj
tQ
Aq
"}
(19,1,1) = {"
Aq
bw
bw
bw
bw
bw
Aq
Aq
Aq
Aq
Aq
Aq
Aq
Aq
Aq
Aq
bw
bw
bw
bw
Aq
Aq
"}
(20,1,1) = {"
Aq
Aq
Aq
Aq
Aq
Aq
Aq
Aq
Aq
Aq
Aq
Aq
Aq
Aq
Aq
Aq
Aq
Aq
Aq
Aq
Aq
Aq
"}
