//MAP CONVERTED BY dmm2tgm.py THIS HEADER COMMENT PREVENTS RECONVERSION, DO NOT REMOVE
"a" = (
/turf/space,
/area/space/debrisfield/misc_debris)
"b" = (
/obj/structure/lattice,
/turf/space,
/area/space/debrisfield/misc_debris)
"c" = (
/turf/simulated/floor/airless,
/area/space/debrisfield/misc_debris)
"n" = (
/obj/mob_spawner/carp,
/turf/simulated/floor/airless,
/area/space/debrisfield/misc_debris)
"p" = (
/obj/random/maintenance/security,
/turf/simulated/floor/airless,
/area/space/debrisfield/misc_debris)

(1,1,1) = {"
a
b
p
"}
(2,1,1) = {"
a
b
c
"}
(3,1,1) = {"
a
c
a
"}
(4,1,1) = {"
b
n
a
"}
(5,1,1) = {"
a
c
b
"}
(6,1,1) = {"
p
b
b
"}
