//MAP CONVERTED BY dmm2tgm.py THIS HEADER COMMENT PREVENTS RECONVERSION, DO NOT REMOVE
"a" = (
/turf/space,
/area/space/debrisfield/misc_debris)
"b" = (
/obj/structure/lattice,
/turf/space,
/area/space/debrisfield/misc_debris)
"c" = (
/obj/random/gun/random,
/turf/simulated/floor/airless,
/area/space/debrisfield/misc_debris)
"d" = (
/turf/simulated/shuttle/wall/voidcraft,
/area/space/debrisfield/misc_debris)
"m" = (
/obj/random/ammo,
/turf/simulated/floor/airless,
/area/space/debrisfield/misc_debris)

(1,1,1) = {"
a
b
a
b
"}
(2,1,1) = {"
b
c
m
d
"}
(3,1,1) = {"
b
d
d
b
"}
(4,1,1) = {"
d
a
a
b
"}
