//MAP CONVERTED BY dmm2tgm.py THIS HEADER COMMENT PREVENTS RECONVERSION, DO NOT REMOVE
"aa" = (
/turf/space,
/area/space/debrisfield/explored)
"af" = (
/obj/structure/door_assembly/door_assembly_alien,
/turf/simulated/floor/plating/external,
/area/debrisfield/derelict)
"ag" = (
/obj/machinery/door/airlock/alien,
/turf/simulated/floor/plating/external,
/area/debrisfield/derelict)
"al" = (
/obj/structure/shuttle/engine/propulsion{
	dir = 8;
	icon_state = "burst_l"
	},
/turf/space,
/area/debrisfield/derelict)
"am" = (
/obj/structure/shuttle/engine/propulsion{
	dir = 4;
	icon_state = "burst_l"
	},
/turf/space,
/area/debrisfield/derelict)
"an" = (
/obj/structure/prop/alien/computer,
/turf/simulated/floor/tiled/asteroid_steel/airless,
/area/debrisfield/derelict)
"ao" = (
/turf/simulated/wall/r_wall,
/area/debrisfield/derelict)
"ap" = (
/mob/living/simple_mob/mechanical/infectionbot{
	faction = "derelict"
	},
/turf/simulated/floor/tiled/asteroid_steel/airless,
/area/debrisfield/derelict)
"aq" = (
/turf/simulated/wall,
/area/debrisfield/derelict)
"ar" = (
/obj/structure/cable{
	icon_state = "1-2"
	},
/turf/simulated/wall,
/area/debrisfield/derelict)
"as" = (
/obj/structure/prop/alien/dispenser,
/turf/simulated/floor/tiled/asteroid_steel/airless,
/area/debrisfield/derelict)
"at" = (
/obj/random/humanoidremains,
/obj/item/gun/energy/ionrifle,
/turf/simulated/floor/tiled/airless,
/area/debrisfield/derelict)
"au" = (
/turf/simulated/floor/tiled/steel/airless,
/area/debrisfield/derelict)
"av" = (
/obj/machinery/bomb_tester,
/turf/simulated/floor/tiled/airless,
/area/debrisfield/derelict)
"aw" = (
/obj/structure/prop/alien/power,
/obj/structure/cable{
	icon_state = "0-4"
	},
/obj/machinery/power/fractal_reactor{
	alpha = 0;
	invisibility = 101
	},
/turf/simulated/floor/reinforced/airless,
/area/debrisfield/derelict)
"ax" = (
/obj/structure/prop/alien/computer/camera/flipped,
/obj/structure/cable{
	icon_state = "2-8"
	},
/turf/simulated/floor/reinforced/airless,
/area/debrisfield/derelict)
"ay" = (
/obj/machinery/transhuman/resleever,
/turf/simulated/floor/tiled/airless,
/area/debrisfield/derelict)
"az" = (
/obj/machinery/artifact,
/turf/simulated/floor/tiled/asteroid_steel/airless,
/area/debrisfield/derelict)
"aA" = (
/mob/living/simple_mob/mechanical/infectionbot{
	faction = "derelict"
	},
/turf/simulated/floor/tiled/airless,
/area/debrisfield/derelict)
"aE" = (
/obj/structure/cable{
	icon_state = "2-4"
	},
/obj/structure/cable{
	icon_state = "4-8"
	},
/obj/structure/cable{
	icon_state = "1-4"
	},
/turf/simulated/floor/tiled/steel/airless,
/area/debrisfield/derelict)
"aF" = (
/obj/machinery/porta_turret/alien{
	faction = "derelict";
	use_power = 0
	},
/turf/simulated/floor/plating/external,
/area/debrisfield/derelict)
"aH" = (
/obj/structure/cable{
	icon_state = "2-4"
	},
/turf/simulated/floor/reinforced/airless,
/area/debrisfield/derelict)
"aI" = (
/obj/structure/cable{
	icon_state = "1-8"
	},
/turf/simulated/floor/reinforced/airless,
/area/debrisfield/derelict)
"aJ" = (
/obj/machinery/drone_fabricator/derelict,
/turf/simulated/floor/tiled/asteroid_steel/airless,
/area/debrisfield/derelict)
"aL" = (
/obj/structure/cable{
	icon_state = "1-2"
	},
/obj/structure/cable{
	icon_state = "1-2"
	},
/turf/simulated/floor/tiled/steel/airless,
/area/debrisfield/derelict)
"aM" = (
/obj/structure/catwalk,
/turf/simulated/floor/plating/external,
/area/debrisfield/derelict)
"aN" = (
/obj/machinery/transhuman/synthprinter,
/turf/simulated/floor/tiled/airless,
/area/debrisfield/derelict)
"aO" = (
/obj/mob_spawner/derelict/mech_wizard,
/turf/simulated/floor/tiled/airless,
/area/debrisfield/derelict)
"aQ" = (
/obj/machinery/vr_sleeper/alien,
/obj/item/grenade/empgrenade,
/turf/simulated/floor/tiled/asteroid_steel/airless,
/area/debrisfield/derelict)
"aR" = (
/obj/mob_spawner/derelict/corrupt_maint_swarm,
/mob/living/simple_mob/mechanical/corrupt_maint_drone{
	faction = "derelict"
	},
/turf/simulated/floor/tiled/airless,
/area/debrisfield/derelict)
"aS" = (
/obj/effect/decal/remains/human,
/turf/simulated/floor/tiled/airless,
/area/debrisfield/derelict)
"aT" = (
/obj/structure/cable{
	icon_state = "1-4"
	},
/turf/simulated/floor/reinforced/airless,
/area/debrisfield/derelict)
"aU" = (
/obj/random/energy,
/turf/simulated/floor/tiled/asteroid_steel/airless,
/area/debrisfield/derelict)
"aV" = (
/obj/structure/cable{
	icon_state = "2-8"
	},
/turf/simulated/floor/reinforced/airless,
/area/debrisfield/derelict)
"aX" = (
/obj/random/tool/alien,
/turf/simulated/floor/tiled/asteroid_steel/airless,
/area/debrisfield/derelict)
"aY" = (
/obj/mob_spawner/derelict,
/turf/simulated/floor/tiled/airless,
/area/debrisfield/derelict)
"aZ" = (
/obj/machinery/door/airlock/alien,
/obj/structure/cable{
	icon_state = "1-2"
	},
/turf/simulated/floor/tiled/asteroid_steel/airless,
/area/debrisfield/derelict)
"ba" = (
/obj/machinery/auto_cloner,
/turf/simulated/floor/tiled/airless,
/area/debrisfield/derelict)
"bb" = (
/obj/structure/shuttle/engine/propulsion{
	dir = 1;
	icon_state = "burst_l"
	},
/turf/space,
/area/debrisfield/derelict)
"bc" = (
/obj/structure/prop/alien/computer/camera,
/turf/simulated/floor/reinforced/airless,
/area/debrisfield/derelict)
"bd" = (
/obj/structure/prop/alien/power,
/obj/structure/cable{
	icon_state = "0-2"
	},
/obj/machinery/power/fractal_reactor{
	alpha = 0;
	invisibility = 101
	},
/turf/simulated/floor/reinforced/airless,
/area/debrisfield/derelict)
"bf" = (
/obj/structure/cable{
	icon_state = "2-8"
	},
/obj/structure/cable{
	icon_state = "4-8"
	},
/obj/structure/cable{
	icon_state = "1-8"
	},
/turf/simulated/floor/tiled/steel/airless,
/area/debrisfield/derelict)
"bh" = (
/obj/structure/cable{
	icon_state = "1-2"
	},
/turf/simulated/floor/reinforced/airless,
/area/debrisfield/derelict)
"bj" = (
/obj/random/humanoidremains,
/obj/structure/cable{
	icon_state = "4-8"
	},
/turf/simulated/floor/tiled/steel/airless,
/area/debrisfield/derelict)
"bk" = (
/obj/machinery/door/airlock/alien,
/obj/structure/cable{
	icon_state = "4-8"
	},
/turf/simulated/floor/tiled/steel/airless,
/area/debrisfield/derelict)
"bm" = (
/obj/item/xenos_claw,
/obj/structure/cable{
	icon_state = "1-2"
	},
/turf/simulated/floor/tiled/steel/airless,
/area/debrisfield/derelict)
"bn" = (
/obj/machinery/door/airlock/alien,
/obj/structure/cable{
	icon_state = "4-8"
	},
/turf/simulated/floor/reinforced/airless,
/area/debrisfield/derelict)
"bo" = (
/obj/mob_spawner/derelict/corrupt_maint_swarm,
/mob/living/simple_mob/mechanical/corrupt_maint_drone{
	faction = "derelict"
	},
/turf/simulated/floor/tiled/asteroid_steel/airless,
/area/debrisfield/derelict)
"bp" = (
/obj/mob_spawner/derelict,
/turf/simulated/floor/reinforced/airless,
/area/debrisfield/derelict)
"bq" = (
/obj/structure/cable{
	icon_state = "1-2"
	},
/obj/structure/cable{
	icon_state = "1-8"
	},
/turf/simulated/floor/tiled/steel/airless,
/area/debrisfield/derelict)
"br" = (
/obj/machinery/implantchair,
/turf/simulated/floor/tiled/white/airless,
/area/debrisfield/derelict)
"bs" = (
/obj/machinery/door/airlock/alien,
/obj/structure/cable{
	icon_state = "4-8"
	},
/turf/simulated/floor/tiled/asteroid_steel/airless,
/area/debrisfield/derelict)
"bt" = (
/obj/structure/cable{
	icon_state = "1-2"
	},
/obj/mob_spawner/derelict,
/turf/simulated/floor/tiled/steel/airless,
/area/debrisfield/derelict)
"bu" = (
/mob/living/simple_mob/mechanical/infectionbot{
	faction = "derelict"
	},
/turf/simulated/floor/tiled/white/airless,
/area/debrisfield/derelict)
"bv" = (
/obj/structure/cable{
	icon_state = "1-4"
	},
/turf/simulated/floor/tiled/asteroid_steel/airless,
/area/debrisfield/derelict)
"bw" = (
/obj/structure/cable{
	icon_state = "1-2"
	},
/turf/simulated/floor/tiled/white/airless,
/area/debrisfield/derelict)
"bx" = (
/obj/random/firstaid,
/turf/simulated/floor/tiled/white/airless,
/area/debrisfield/derelict)
"bA" = (
/obj/machinery/door/airlock/alien,
/obj/structure/cable{
	icon_state = "1-2"
	},
/turf/simulated/floor/tiled/steel/airless,
/area/debrisfield/derelict)
"bB" = (
/turf/simulated/floor/reinforced/airless,
/area/debrisfield/derelict)
"bC" = (
/obj/mob_spawner/derelict/corrupt_maint_swarm,
/obj/structure/cable{
	icon_state = "1-4"
	},
/turf/simulated/floor/reinforced/airless,
/area/debrisfield/derelict)
"bD" = (
/obj/structure/cable{
	icon_state = "4-8"
	},
/turf/simulated/floor/reinforced/airless,
/area/debrisfield/derelict)
"bE" = (
/obj/machinery/door/airlock/alien,
/obj/structure/cable{
	icon_state = "4-8"
	},
/turf/simulated/floor/reinforced/airless,
/area/debrisfield/derelict)
"bF" = (
/obj/random/humanoidremains,
/turf/simulated/floor/tiled/white/airless,
/area/debrisfield/derelict)
"bG" = (
/obj/structure/cable{
	icon_state = "4-8"
	},
/turf/simulated/floor/tiled/steel/airless,
/area/debrisfield/derelict)
"bH" = (
/obj/structure/door_assembly/door_assembly_alien,
/obj/structure/cable{
	icon_state = "4-8"
	},
/turf/simulated/floor/tiled/steel/airless,
/area/debrisfield/derelict)
"bI" = (
/obj/structure/prop/prism,
/turf/simulated/floor/tiled/asteroid_steel/airless,
/area/debrisfield/derelict)
"bJ" = (
/obj/structure/cable,
/obj/machinery/power/apc{
	alarms_hidden = 1;
	name = "south bump";
	pixel_y = -24
	},
/turf/simulated/floor/tiled/asteroid_steel/airless,
/area/debrisfield/derelict)
"bK" = (
/obj/structure/cable{
	icon_state = "4-8"
	},
/turf/simulated/floor/tiled/steel/airless,
/area/debrisfield/derelict)
"bL" = (
/obj/structure/cable{
	icon_state = "1-8"
	},
/turf/simulated/floor/tiled/asteroid_steel/airless,
/area/debrisfield/derelict)
"bM" = (
/obj/structure/cable{
	icon_state = "4-8"
	},
/turf/simulated/floor/reinforced/airless,
/area/debrisfield/derelict)
"bN" = (
/obj/machinery/replicator,
/turf/simulated/floor/tiled/white/airless,
/area/debrisfield/derelict)
"bP" = (
/obj/mob_spawner/derelict/corrupt_maint_swarm,
/turf/simulated/floor/reinforced/airless,
/area/debrisfield/derelict)
"bQ" = (
/obj/machinery/door/airlock/alien,
/turf/simulated/floor/reinforced/airless,
/area/debrisfield/derelict)
"bS" = (
/obj/machinery/door/airlock/alien,
/turf/simulated/floor/tiled/steel/airless,
/area/debrisfield/derelict)
"bT" = (
/turf/simulated/floor/tiled/asteroid_steel/airless,
/area/debrisfield/derelict)
"bU" = (
/obj/structure/cable{
	icon_state = "2-4"
	},
/turf/simulated/floor/tiled/white/airless,
/area/debrisfield/derelict)
"bV" = (
/obj/structure/cable{
	icon_state = "1-2"
	},
/obj/structure/cable{
	icon_state = "1-4"
	},
/turf/simulated/floor/tiled/steel/airless,
/area/debrisfield/derelict)
"bW" = (
/obj/mob_spawner/derelict/corrupt_maint_swarm,
/turf/simulated/floor/tiled/airless,
/area/debrisfield/derelict)
"bX" = (
/obj/machinery/porta_turret/alien{
	faction = "derelict";
	use_power = 0
	},
/turf/simulated/floor/tiled/asteroid_steel/airless,
/area/debrisfield/derelict)
"bY" = (
/turf/simulated/floor/tiled/white/airless,
/area/debrisfield/derelict)
"bZ" = (
/obj/structure/cable{
	icon_state = "4-8"
	},
/turf/simulated/floor/tiled/asteroid_steel/airless,
/area/debrisfield/derelict)
"ca" = (
/obj/structure/cable{
	icon_state = "2-8"
	},
/turf/simulated/floor/tiled/asteroid_steel/airless,
/area/debrisfield/derelict)
"cb" = (
/obj/random/humanoidremains,
/obj/structure/cable{
	icon_state = "2-8"
	},
/turf/simulated/floor/tiled/asteroid_steel/airless,
/area/debrisfield/derelict)
"cd" = (
/obj/structure/cable{
	icon_state = "2-8"
	},
/turf/simulated/floor/tiled/white/airless,
/area/debrisfield/derelict)
"ce" = (
/obj/effect/alien/egg,
/obj/effect/alien/weeds,
/turf/simulated/floor/tiled/asteroid_steel/airless,
/area/debrisfield/derelict)
"cf" = (
/obj/machinery/dna_scannernew,
/turf/simulated/floor/tiled/white/airless,
/area/debrisfield/derelict)
"cg" = (
/obj/item/gun/energy/ionrifle,
/turf/simulated/floor/plating/external,
/area/debrisfield/derelict)
"ch" = (
/obj/structure/cable{
	icon_state = "1-2"
	},
/turf/simulated/floor/tiled/asteroid_steel/airless,
/area/debrisfield/derelict)
"ci" = (
/obj/structure/cable{
	icon_state = "1-2"
	},
/obj/structure/cable{
	icon_state = "1-8"
	},
/turf/simulated/floor/tiled/asteroid_steel/airless,
/area/debrisfield/derelict)
"cj" = (
/obj/machinery/optable,
/obj/random/humanoidremains,
/turf/simulated/floor/tiled/white/airless,
/area/debrisfield/derelict)
"ck" = (
/obj/structure/prop/alien/pod,
/turf/simulated/floor/tiled/asteroid_steel/airless,
/area/debrisfield/derelict)
"cl" = (
/obj/structure/ghost_pod/manual/lost_drone,
/turf/simulated/floor/tiled/asteroid_steel/airless,
/area/debrisfield/derelict)
"cm" = (
/obj/item/grenade/empgrenade,
/obj/item/grenade/empgrenade,
/obj/item/grenade/empgrenade,
/turf/simulated/floor/plating/external,
/area/debrisfield/derelict)
"co" = (
/obj/random/humanoidremains,
/turf/simulated/floor/tiled/asteroid_steel/airless,
/area/debrisfield/derelict)
"cp" = (
/obj/structure/cable{
	icon_state = "4-8"
	},
/turf/simulated/floor/tiled/asteroid_steel/airless,
/area/debrisfield/derelict)
"cq" = (
/obj/structure/ghost_pod/manual/lost_drone/dogborg,
/turf/simulated/floor/tiled/asteroid_steel/airless,
/area/debrisfield/derelict)
"cr" = (
/obj/machinery/door/airlock/alien/locked,
/turf/simulated/floor/plating/external,
/area/debrisfield/derelict)
"ct" = (
/obj/random/humanoidremains,
/obj/structure/cable{
	icon_state = "1-2"
	},
/turf/simulated/floor/tiled/asteroid_steel/airless,
/area/debrisfield/derelict)
"cu" = (
/obj/structure/cable{
	icon_state = "4-8"
	},
/turf/simulated/floor/tiled/white/airless,
/area/debrisfield/derelict)
"cv" = (
/obj/structure/cable{
	icon_state = "1-8"
	},
/turf/simulated/floor/tiled/white/airless,
/area/debrisfield/derelict)
"cy" = (
/obj/structure/cable{
	icon_state = "1-2"
	},
/turf/simulated/floor/plating/external,
/area/debrisfield/derelict)
"cz" = (
/obj/structure/cable{
	icon_state = "0-8"
	},
/obj/machinery/power/apc{
	alarms_hidden = 1;
	dir = 4;
	name = "east bump";
	pixel_x = 28
	},
/turf/simulated/floor/tiled/asteroid_steel/airless,
/area/debrisfield/derelict)
"cA" = (
/turf/simulated/floor/tiled/airless,
/area/debrisfield/derelict)
"cB" = (
/obj/structure/cable{
	icon_state = "1-2"
	},
/obj/structure/cable{
	icon_state = "1-4"
	},
/turf/simulated/floor/plating/external,
/area/debrisfield/derelict)
"cC" = (
/obj/structure/cable{
	icon_state = "4-8"
	},
/turf/simulated/floor/plating/external,
/area/debrisfield/derelict)
"cE" = (
/obj/mob_spawner/derelict/corrupt_maint_swarm,
/turf/simulated/floor/tiled/asteroid_steel/airless,
/area/debrisfield/derelict)
"cF" = (
/obj/structure/ghost_pod/manual/lost_drone/dogborg,
/turf/simulated/floor/plating/external,
/area/debrisfield/derelict)
"cG" = (
/obj/machinery/door/airlock/hatch{
	icon_state = "door_locked";
	id_tag = null;
	locked = 1;
	name = "AI Core";
	req_access = list(16)
	},
/turf/simulated/floor/plating/external,
/area/debrisfield/derelict)
"cH" = (
/obj/machinery/door/airlock/hatch{
	icon_state = "door_locked";
	id_tag = null;
	locked = 1;
	name = "AI Core";
	req_access = list(16)
	},
/obj/structure/cable{
	icon_state = "1-2"
	},
/turf/simulated/floor/plating/external,
/area/debrisfield/derelict)
"cI" = (
/obj/structure/shuttle/engine/propulsion,
/turf/space,
/area/debrisfield/derelict)
"cJ" = (
/obj/structure/cable{
	icon_state = "0-4"
	},
/obj/machinery/power/apc{
	alarms_hidden = 1;
	dir = 1;
	name = "north bump";
	pixel_y = 24
	},
/turf/simulated/floor/greengrid/airless,
/area/debrisfield/derelict)
"cK" = (
/obj/structure/cable{
	icon_state = "4-8"
	},
/obj/machinery/power/fractal_reactor{
	alpha = 0;
	invisibility = 101
	},
/turf/simulated/floor/plating/external,
/area/debrisfield/derelict)
"cL" = (
/obj/mob_spawner/derelict/mech_wizard,
/turf/simulated/floor/plating/external,
/area/debrisfield/derelict)
"cM" = (
/obj/structure/prop/alien/computer,
/turf/simulated/floor/greengrid/airless,
/area/debrisfield/derelict)
"cN" = (
/obj/structure/cable{
	icon_state = "0-8"
	},
/obj/machinery/power/apc{
	alarms_hidden = 1;
	dir = 4;
	name = "east bump";
	pixel_x = 28
	},
/turf/simulated/floor/plating/external,
/area/debrisfield/derelict)
"cO" = (
/obj/structure/prop/fake_ai,
/turf/simulated/floor/greengrid/airless,
/area/debrisfield/derelict)
"cR" = (
/obj/structure/catwalk,
/obj/machinery/porta_turret/alien{
	faction = "derelict";
	use_power = 0
	},
/turf/simulated/floor/plating/external,
/area/debrisfield/derelict)
"cV" = (
/turf/simulated/floor/greengrid/airless,
/area/debrisfield/derelict)
"cW" = (
/obj/structure/cable{
	icon_state = "4-8"
	},
/turf/simulated/floor/plating/external,
/area/debrisfield/derelict)
"cX" = (
/obj/structure/cable{
	icon_state = "1-8"
	},
/turf/simulated/floor/plating/external,
/area/debrisfield/derelict)
"cZ" = (
/obj/structure/cable{
	icon_state = "1-2"
	},
/turf/simulated/floor/tiled/steel/airless,
/area/debrisfield/derelict)
"da" = (
/obj/structure/prop/blackbox/xenofrigate,
/turf/simulated/floor/greengrid/airless,
/area/debrisfield/derelict)
"dc" = (
/obj/machinery/porta_turret/alien{
	faction = "derelict";
	use_power = 0
	},
/turf/simulated/floor/greengrid/airless,
/area/debrisfield/derelict)
"dd" = (
/obj/structure/prop/prism,
/turf/simulated/floor/greengrid/airless,
/area/debrisfield/derelict)
"dZ" = (
/obj/effect/decal/mecha_wreckage/gygax/adv,
/turf/simulated/floor/plating/external,
/area/debrisfield/derelict)
"fl" = (
/obj/machinery/door/airlock/alien,
/turf/simulated/floor/tiled/asteroid_steel/airless,
/area/debrisfield/derelict)
"mG" = (
/turf/space,
/area/debrisfield/derelict)
"vL" = (
/obj/structure/cable{
	icon_state = "2-4"
	},
/turf/simulated/floor/tiled/asteroid_steel/airless,
/area/debrisfield/derelict)
"yZ" = (
/obj/machinery/door/airlock/alien,
/obj/structure/cable{
	icon_state = "1-2"
	},
/turf/simulated/floor/tiled/white/airless,
/area/debrisfield/derelict)
"JC" = (
/turf/simulated/floor/plating/external,
/area/debrisfield/derelict)
"LM" = (
/obj/structure/shuttle/engine/heater,
/turf/simulated/wall,
/area/debrisfield/derelict)
"TG" = (
/obj/machinery/door/airlock/alien,
/turf/simulated/floor/tiled/white/airless,
/area/debrisfield/derelict)

(1,1,1) = {"
aa
aa
aa
aa
aa
aa
aa
aa
aa
aa
aa
aa
aa
aa
aa
aa
aa
aa
aa
aa
aa
aa
aa
aa
aa
aa
aa
aa
aa
aa
aa
aa
aa
aa
aa
aa
aa
aa
aa
aa
aa
aa
aa
aa
aa
aa
aa
aa
aa
aa
aa
aa
"}
(2,1,1) = {"
aa
aa
aa
aa
aa
aa
aa
aa
aa
bb
ao
ao
ao
ao
ao
ao
ao
ao
ao
ao
ao
ao
ao
ao
ao
ao
ao
ao
ao
ao
ao
ao
ao
ao
ao
ao
ao
ao
ao
ao
aa
aa
aa
aa
aa
aa
aa
aa
aa
aa
aa
aa
"}
(3,1,1) = {"
aa
aa
aa
aa
aa
aa
aa
aa
ao
ao
ao
bB
bB
bB
aq
bB
bB
bB
bp
aq
bB
bB
aq
bp
bB
bB
bB
bB
aq
bB
bB
bB
bB
bB
bB
bB
bB
LM
cI
mG
aa
aa
aa
aa
aa
aa
aa
aa
aa
aa
aa
aa
"}
(4,1,1) = {"
aa
aa
aa
aa
aa
aa
ao
ao
ao
bc
bB
bB
aq
bB
aq
bB
bB
aq
aq
aq
bB
bB
aq
aq
aq
bB
bB
bB
aq
bB
bB
aq
aq
aq
aq
bB
bB
bB
LM
cI
aa
aa
aa
aa
aa
aa
aa
aa
aa
aa
aa
aa
"}
(5,1,1) = {"
aa
aa
aa
aa
aa
aa
ao
ao
ao
bd
bh
bh
ar
bh
bh
bh
bh
ar
bh
bh
bC
bP
bB
bB
bB
bB
aq
bB
bB
bB
bB
aq
bp
bB
aq
bB
bB
bB
LM
cI
aa
aa
aa
aa
aa
aa
aa
aa
aa
aa
aa
aa
"}
(6,1,1) = {"
aa
aa
aa
aa
aa
aa
aa
aa
ao
ao
ao
aq
aq
bB
bB
bB
bB
bB
bB
aq
bD
bB
aq
bB
bB
aq
aq
bB
bB
bB
bB
aq
bB
bB
bB
bB
bB
LM
cI
mG
aa
aa
aa
aa
aa
aa
aa
aa
aa
aa
aa
aa
"}
(7,1,1) = {"
aa
aa
aa
aa
aa
aa
aa
aa
aa
bb
ao
ao
ao
ao
ao
ao
ao
ao
ao
ao
bE
bQ
ao
ao
ao
ao
ao
ao
ao
ao
ao
ao
ao
ao
ao
ao
ao
ao
ao
ao
aa
aa
aa
aa
aa
aa
aa
aa
aa
aa
aa
aa
"}
(8,1,1) = {"
aa
aa
aa
aa
aa
aa
aa
aa
aa
aa
aa
aa
aa
aa
aa
aa
aa
aa
ao
ao
bD
bB
ao
ao
aa
aa
aa
aa
aa
aa
aa
aa
aa
aa
aa
aa
aa
aa
aa
aa
aa
aa
aa
aa
aa
aa
aa
aa
aa
aa
aa
aa
"}
(9,1,1) = {"
aa
aa
aa
aa
aa
aa
aa
aa
aa
aa
aa
aa
aa
aa
aa
aa
aa
ao
ao
ao
bD
bB
ao
ao
ao
aa
aa
aa
aa
aa
aa
aa
aa
aa
aa
aa
aa
aa
aa
aa
aa
aa
aa
aa
aa
aa
aa
aa
aa
aa
aa
aa
"}
(10,1,1) = {"
aa
aa
aa
aa
aa
aa
aa
ao
ao
ao
ao
ao
ao
ao
ao
ao
ao
ao
ao
ao
bE
bQ
ao
ao
ao
ao
ao
ao
ao
ao
ao
ao
ao
ao
ao
ao
ao
ao
ao
ao
ao
ao
ao
aa
aa
aa
aa
aa
aa
aa
aa
aa
"}
(11,1,1) = {"
aa
aa
aa
aa
aa
aa
ao
ao
at
cA
bT
bT
bT
aJ
aq
bT
bT
bT
cA
aq
bG
au
aq
bT
bT
bT
bT
bT
aJ
aq
bN
bY
cA
cA
bW
aq
ck
bT
bT
bT
bT
cE
ao
ao
aa
aa
aa
aa
aa
aa
aa
aa
"}
(12,1,1) = {"
aa
aa
aa
aa
aa
aa
ao
ao
cA
aq
bT
aq
co
bT
aq
bT
aQ
aq
cA
aq
bG
au
aq
bT
bT
bT
bT
aq
bT
aq
bY
bY
aq
aq
aq
aq
aq
bT
aq
bT
bT
aq
ao
ao
ao
aa
aa
aa
aa
aa
aa
aa
"}
(13,1,1) = {"
aa
aa
aa
aa
aa
aa
ao
an
bT
bT
bT
aq
bT
bT
bT
bT
bT
bT
cA
aq
bG
au
aq
bo
bT
aq
bT
bT
bT
aq
bY
bU
aZ
ch
ch
aZ
ch
ch
ch
ct
bv
JC
cG
JC
ao
ao
aa
aa
aa
aa
aa
aa
"}
(14,1,1) = {"
aa
aa
aa
aa
aa
aa
ao
bT
aq
bT
bT
bT
bT
bT
co
aq
aq
aq
cA
aq
bG
au
aq
aq
bT
aq
aq
bT
bT
aq
bY
cu
aq
bT
co
fl
bT
bT
bT
bT
cz
JC
ao
JC
JC
ao
ao
aa
aa
aa
aa
aa
"}
(15,1,1) = {"
aa
aa
aq
ag
aq
aa
ao
bT
bT
bT
aq
aq
aq
bT
bT
bT
bT
bT
cA
aq
bG
au
aq
bT
bT
bT
bT
bT
bT
fl
bY
cu
aq
cA
cA
aq
bT
aq
JC
JC
aq
JC
ao
JC
JC
aF
ao
ao
aa
aa
aa
aa
"}
(16,1,1) = {"
aa
al
aq
JC
aq
al
ao
aX
bT
bT
aq
az
bT
bT
aq
bT
bT
bT
cA
aq
bG
au
aq
bT
vL
ch
ch
ch
ch
aZ
bw
cv
aq
bW
cA
aq
cl
aq
JC
JC
aq
cF
ao
cV
cV
cV
dc
ao
ao
aa
aa
aa
"}
(17,1,1) = {"
aa
aq
aq
af
aq
aq
ao
aq
aq
fl
aq
bT
bT
bT
bT
bT
aq
bT
cA
aq
bG
au
aq
fl
bs
aq
aq
aq
aq
aq
ao
ao
ao
ao
ao
ao
ao
ao
cr
cr
ao
ao
ao
cV
cV
cV
cV
dc
ao
ao
aa
aa
"}
(18,1,1) = {"
aa
aq
JC
JC
JC
aq
ao
aU
bT
bT
aq
aq
aq
aq
bT
bT
az
aq
aY
aq
bG
au
aq
bT
ca
bv
bT
bT
bI
bX
ao
cR
aM
aM
aM
aM
aM
aM
aM
aM
aM
cR
ao
cV
cV
cV
cV
cV
dc
ao
ao
aa
"}
(19,1,1) = {"
aa
aq
dZ
JC
JC
aq
ao
co
bT
bT
aq
aA
cA
cA
cA
cA
cA
aY
aq
aq
bG
au
aq
bX
bT
ca
ch
ch
bv
bT
ao
aM
JC
JC
JC
JC
JC
JC
JC
JC
JC
aM
ao
cV
cV
cV
cV
cV
cV
dc
ao
aa
"}
(20,1,1) = {"
ao
aq
aq
ag
aq
aq
ao
aq
fl
fl
aq
aq
aq
aq
aq
aq
aq
aq
aq
aq
bS
bS
aq
aq
aq
aq
aq
aq
cp
bT
ao
aM
JC
JC
JC
JC
JC
JC
JC
JC
JC
aM
ao
cV
cV
dd
dd
cV
cV
cV
ao
aa
"}
(21,1,1) = {"
ao
cZ
cZ
cZ
cZ
cZ
cZ
cZ
cZ
cZ
cZ
cZ
cZ
cZ
cZ
cZ
cZ
cZ
cZ
cZ
bf
bm
cZ
bV
cZ
cZ
cZ
bA
ci
bJ
ao
aM
JC
JC
JC
cg
cm
cm
JC
JC
JC
aM
ao
cV
cM
da
cO
cV
cV
dc
ao
aa
"}
(22,1,1) = {"
ao
cZ
cZ
cZ
cZ
cZ
cZ
cZ
cZ
cZ
cZ
cZ
cZ
aL
cZ
cZ
cZ
cZ
cZ
cZ
aE
cZ
cZ
bq
bt
cZ
cZ
bA
ch
bv
ao
aM
JC
JC
JC
JC
cm
cm
JC
JC
JC
aM
ao
cV
cM
da
cO
cV
cV
dc
ao
aa
"}
(23,1,1) = {"
ao
aq
aq
ag
aq
aq
ao
aq
fl
fl
aq
aq
aq
aq
aq
aq
aq
aq
aq
aq
bH
bS
aq
aq
aq
aq
aq
aq
co
cp
ao
aM
JC
JC
JC
JC
JC
JC
JC
JC
JC
aM
ao
cV
cV
dd
dd
cV
cV
cV
ao
aa
"}
(24,1,1) = {"
aa
aq
dZ
JC
JC
aq
ao
ap
bT
co
bT
bT
bT
bT
aX
aq
aR
cA
cA
aq
bK
au
aq
bX
vL
ch
ch
ch
ch
bL
ao
aM
JC
JC
JC
JC
JC
JC
JC
JC
JC
aM
ao
cV
cV
cV
cV
cV
cV
dc
ao
aa
"}
(25,1,1) = {"
aa
aq
JC
JC
JC
aq
ao
ap
bT
bT
bT
bT
bT
bT
bT
aq
aS
cA
cA
aq
bK
au
aq
bT
cp
bT
bT
bT
bI
bX
ao
cR
aM
aM
aM
aM
aM
aM
aM
aM
aM
cR
ao
cV
cV
cV
cV
cV
dc
ao
ao
aa
"}
(26,1,1) = {"
aa
aq
aq
ag
aq
aq
ao
aq
aq
aq
aq
aq
aq
bT
bT
bT
cA
aR
aR
aq
bK
au
aq
fl
bs
aq
aq
aq
aq
aq
ao
ao
ao
ao
ao
ao
ao
ao
cr
cr
ao
ao
ao
cV
cV
cV
cV
dc
ao
ao
aa
aa
"}
(27,1,1) = {"
aa
am
aq
JC
aq
am
ao
aX
bT
bT
bT
aX
aq
bT
bT
aq
aq
aq
aq
aq
bK
au
aq
bY
cd
bw
bw
bw
bw
yZ
bw
bw
ch
bv
ce
aq
bT
bT
bT
bT
bT
az
ao
cJ
cV
cV
dc
ao
ao
aa
aa
aa
"}
(28,1,1) = {"
aa
aa
aq
ag
aq
aa
ao
an
bT
aq
bT
bT
bT
co
bT
bT
bT
bT
bT
aq
bK
au
aq
bY
bY
bY
bY
bY
bY
TG
bY
bY
bT
bZ
bT
aq
bT
co
bT
bT
bT
bT
ao
cK
JC
aF
ao
ao
aa
aa
aa
aa
"}
(29,1,1) = {"
aa
aa
aa
aa
aa
aa
ao
as
bT
bT
bT
bT
bT
bT
bT
bT
bT
bT
bT
aq
bj
au
aq
bY
aq
cj
aq
bF
bY
aq
bY
bY
aq
cb
ch
aZ
ch
bv
aq
aq
aq
aq
ao
cW
JC
ao
ao
aa
aa
aa
aa
aa
"}
(30,1,1) = {"
aa
aa
aa
aa
aa
aa
ao
as
bT
aq
bT
bT
aq
aq
aq
aq
aq
bT
aq
aq
bK
au
aq
bY
bu
aq
bu
bY
bY
aq
bY
bY
aq
aq
aq
aq
bT
ca
aZ
cy
cB
cy
cH
cX
ao
ao
aa
aa
aa
aa
aa
aa
"}
(31,1,1) = {"
aa
aa
aa
aa
aa
aa
ao
ao
cA
aq
cA
cA
cA
cA
cA
aN
aq
cA
cA
aq
bK
au
aq
bY
bY
bY
bY
aq
bY
aq
bY
bY
cA
cA
bW
aq
bT
bT
aq
JC
cC
JC
ao
ao
ao
aa
aa
aa
aa
aa
aa
aa
"}
(32,1,1) = {"
aa
aa
aa
aa
aa
aa
ao
ao
av
aq
ay
cA
cA
cA
cA
aO
aq
cA
ba
aq
bK
au
aq
br
cf
bx
bY
bY
bu
aq
bN
bY
cA
cA
bW
aq
cq
bT
aq
JC
cN
cL
ao
ao
aa
aa
aa
aa
aa
aa
aa
aa
"}
(33,1,1) = {"
aa
aa
aa
aa
aa
aa
aa
ao
ao
ao
ao
ao
ao
ao
ao
ao
ao
ao
ao
ao
bk
bS
ao
ao
ao
ao
ao
ao
ao
ao
ao
ao
ao
ao
ao
ao
ao
ao
ao
ao
ao
ao
ao
aa
aa
aa
aa
aa
aa
aa
aa
aa
"}
(34,1,1) = {"
aa
aa
aa
aa
aa
aa
aa
aa
aa
aa
aa
aa
aa
aa
aa
aa
aa
ao
ao
ao
bM
bB
ao
ao
ao
aa
aa
aa
aa
aa
aa
aa
aa
aa
aa
aa
aa
aa
aa
aa
aa
aa
aa
aa
aa
aa
aa
aa
aa
aa
aa
aa
"}
(35,1,1) = {"
aa
aa
aa
aa
aa
aa
aa
aa
aa
aa
aa
aa
aa
aa
aa
aa
aa
aa
ao
ao
bM
bB
ao
ao
aa
aa
aa
aa
aa
aa
aa
aa
aa
aa
aa
aa
aa
aa
aa
aa
aa
aa
aa
aa
aa
aa
aa
aa
aa
aa
aa
aa
"}
(36,1,1) = {"
aa
aa
aa
aa
aa
aa
aa
aa
aa
bb
ao
ao
ao
ao
ao
ao
ao
ao
ao
ao
bn
bQ
ao
ao
ao
ao
ao
ao
ao
ao
ao
ao
ao
ao
ao
ao
ao
ao
ao
ao
aa
aa
aa
aa
aa
aa
aa
aa
aa
aa
aa
aa
"}
(37,1,1) = {"
aa
aa
aa
aa
aa
aa
aa
aa
ao
ao
ao
aH
bh
bh
bh
bh
aT
aq
aH
bh
aI
bB
bB
bB
aq
bp
bB
bB
bB
bB
bB
bp
aq
bB
bB
bB
bB
LM
cI
mG
aa
aa
aa
aa
aa
aa
aa
aa
aa
aa
aa
aa
"}
(38,1,1) = {"
aa
aa
aa
aa
aa
aa
ao
ao
ao
aw
bB
bM
bB
bB
aq
bB
bM
aq
bM
aq
bB
bB
aq
bB
aq
aq
aq
bB
bB
bB
aq
aq
aq
bB
aq
bB
bB
bB
LM
cI
aa
aa
aa
aa
aa
aa
aa
aa
aa
aa
aa
aa
"}
(39,1,1) = {"
aa
aa
aa
aa
aa
aa
ao
ao
ao
ax
bh
aI
aq
bB
aq
bB
bM
aq
bM
aq
bB
bB
aq
bB
bB
bB
bB
bB
aq
bB
bB
bB
bB
bB
aq
bB
bB
bB
LM
cI
aa
aa
aa
aa
aa
aa
aa
aa
aa
aa
aa
aa
"}
(40,1,1) = {"
aa
aa
aa
aa
aa
aa
aa
aa
ao
ao
ao
bp
aq
bB
bB
bB
aV
bh
aI
aq
bP
bP
aq
bB
bB
bB
bB
bB
aq
bB
bB
bB
bB
bB
aq
bB
bB
LM
cI
mG
aa
aa
aa
aa
aa
aa
aa
aa
aa
aa
aa
aa
"}
(41,1,1) = {"
aa
aa
aa
aa
aa
aa
aa
aa
aa
bb
ao
ao
ao
ao
ao
ao
ao
ao
ao
ao
ao
ao
ao
ao
ao
ao
ao
ao
ao
ao
ao
ao
ao
ao
ao
ao
ao
ao
ao
ao
aa
aa
aa
aa
aa
aa
aa
aa
aa
aa
aa
aa
"}
