"aa" = (/turf/space,/area/debrisfield/explored)
"ab" = (/obj/item/material/twohanded/spear,/turf/space,/area/debrisfield/explored)
"ac" = (/turf/simulated/shuttle/wall/voidcraft,/area/debrisfield/explored)
"ad" = (/turf/simulated/shuttle/floor/black/airless,/area/debrisfield/explored)
"ae" = (/obj/structure/table/steel,/obj/item/clothing/head/pilot,/turf/simulated/shuttle/floor/black/airless,/area/debrisfield/explored)
"af" = (/turf/simulated/shuttle/wall/voidcraft/hard_corner,/area/debrisfield/explored)
"ag" = (/obj/structure/frame/computer,/turf/simulated/shuttle/floor/black/airless,/area/debrisfield/explored)
"ah" = (/obj/structure/bed/chair/comfy/blue{dir = 1},/turf/simulated/shuttle/floor/black/airless,/area/debrisfield/explored)
"ai" = (/obj/structure/grille,/obj/structure/window/reinforced/full,/obj/structure/window/reinforced{dir = 1},/turf/simulated/shuttle/plating/airless,/area/debrisfield/explored)
"aj" = (/obj/item/material/shard,/obj/item/material/shard,/obj/structure/grille/broken,/turf/simulated/shuttle/plating/airless,/area/debrisfield/explored)
"ak" = (/obj/machinery/light{dir = 1},/obj/structure/table/rack/shelf,/obj/item/suit_cooling_unit,/turf/simulated/shuttle/floor/black/airless,/area/debrisfield/explored)
"al" = (/obj/structure/lattice,/turf/space,/area/debrisfield/explored)
"am" = (/obj/machinery/light{dir = 1},/obj/structure/table/rack/shelf,/obj/item/tank/oxygen,/obj/item/suit_cooling_unit,/obj/item/clothing/head/helmet/space/void/pilot,/obj/item/clothing/shoes/magboots,/obj/item/clothing/suit/space/void/pilot,/obj/item/clothing/head/helmet/space/void/pilot,/turf/simulated/shuttle/floor/black/airless,/area/debrisfield/explored)
"an" = (/obj/machinery/door/airlock/voidcraft,/turf/simulated/shuttle/floor/black/airless,/area/debrisfield/explored)
"ao" = (/obj/effect/floor_decal/industrial/outline/blue,/turf/simulated/shuttle/floor/darkred/airless,/area/debrisfield/explored)
"ap" = (/obj/structure/table/rack/shelf,/obj/item/clothing/mask/breath,/obj/item/clothing/mask/breath,/obj/item/clothing/mask/breath,/obj/item/clothing/mask/breath,/obj/item/tank/emergency/oxygen/engi,/obj/item/tank/emergency/oxygen/engi,/obj/item/tank/emergency/oxygen/engi,/obj/item/tank/emergency/oxygen/engi,/turf/simulated/shuttle/floor/black/airless,/area/debrisfield/explored)
"aq" = (/obj/structure/bed/chair/shuttle,/turf/simulated/shuttle/floor/black/airless,/area/debrisfield/explored)
"ar" = (/obj/machinery/light{dir = 8},/obj/structure/closet/walllocker/emerglocker{pixel_x = -32},/turf/simulated/shuttle/floor/black/airless,/area/debrisfield/explored)
"as" = (/obj/machinery/light{dir = 4},/obj/structure/closet/walllocker/emerglocker{pixel_x = 32},/turf/simulated/shuttle/floor/black/airless,/area/debrisfield/explored)
"at" = (/obj/machinery/sleeper{dir = 8},/turf/simulated/shuttle/floor/black/airless,/area/debrisfield/explored)
"au" = (/obj/machinery/sleep_console,/turf/simulated/shuttle/floor/black/airless,/area/debrisfield/explored)
"av" = (/obj/structure/bed/chair/shuttle{dir = 1},/turf/simulated/shuttle/floor/black/airless,/area/debrisfield/explored)
"aw" = (/obj/effect/floor_decal/industrial/outline/red,/obj/structure/closet/crate/secure/weapon,/obj/item/mecha_parts/mecha_equipment/weapon/energy/phase,/obj/item/mecha_parts/mecha_equipment/weapon/energy/phase,/obj/random/ammo_all,/obj/random/ammo_all,/obj/random/janusmodule,/obj/random/multiple/gun/projectile/shotgun,/turf/simulated/shuttle/floor/darkred/airless,/area/debrisfield/explored)
"ax" = (/obj/effect/floor_decal/industrial/outline/yellow,/obj/machinery/space_heater,/turf/simulated/shuttle/floor/darkred/airless,/area/debrisfield/explored)
"ay" = (/obj/structure/table/steel,/obj/item/clothing/head/pilot,/obj/random/unidentified_medicine/drug_den,/obj/random/toolbox,/turf/simulated/shuttle/floor/black/airless,/area/debrisfield/explored)
"az" = (/obj/structure/closet/crate/medical,/obj/random/unidentified_medicine/old_medicine,/obj/random/unidentified_medicine/old_medicine,/obj/random/unidentified_medicine/old_medicine,/obj/random/unidentified_medicine/fresh_medicine,/obj/random/unidentified_medicine/fresh_medicine,/obj/random/unidentified_medicine/combat_medicine,/turf/simulated/shuttle/floor/darkred/airless,/area/debrisfield/explored)
"aA" = (/obj/effect/floor_decal/industrial/warning{dir = 9},/obj/machinery/atmospherics/unary/vent_pump/high_volume{dir = 8; frequency = 1380; id_tag = "expshuttle_docker_pump_out_internal"},/turf/simulated/shuttle/floor/black/airless,/area/debrisfield/explored)
"aB" = (/obj/effect/floor_decal/industrial/warning{dir = 1},/turf/simulated/shuttle/floor/black/airless,/area/debrisfield/explored)
"aC" = (/obj/machinery/atmospherics/pipe/simple/visible/cyan{dir = 10},/turf/simulated/shuttle/wall/voidcraft,/area/debrisfield/explored)
"aD" = (/obj/effect/floor_decal/industrial/warning{dir = 5},/obj/machinery/atmospherics/unary/vent_pump/high_volume{dir = 4; frequency = 1380; id_tag = "expshuttle_vent"},/turf/simulated/shuttle/floor/black/airless,/area/debrisfield/explored)
"aE" = (/obj/machinery/atmospherics/pipe/manifold/visible/yellow{dir = 8},/obj/machinery/door/airlock/voidcraft/vertical,/turf/simulated/shuttle/floor/black/airless,/area/debrisfield/explored)
"aF" = (/obj/effect/floor_decal/industrial/warning{dir = 8},/obj/machinery/atmospherics/unary/vent_pump/high_volume{dir = 8; frequency = 1380; id_tag = "expshuttle_docker_pump_out_internal"},/turf/simulated/shuttle/floor/black/airless,/area/debrisfield/explored)
"aG" = (/obj/effect/floor_decal/industrial/warning{dir = 4},/obj/machinery/atmospherics/unary/vent_pump/high_volume{dir = 4; frequency = 1380; id_tag = "expshuttle_vent"},/obj/effect/gibspawner/human,/turf/simulated/shuttle/floor/black/airless,/area/debrisfield/explored)
"aH" = (/obj/machinery/atmospherics/pipe/manifold/visible/cyan{dir = 4},/obj/machinery/door/airlock/voidcraft/vertical,/turf/simulated/shuttle/floor/black/airless,/area/debrisfield/explored)
"aI" = (/obj/machinery/atmospherics/pipe/manifold/visible/yellow{dir = 8},/turf/simulated/shuttle/wall/voidcraft,/area/debrisfield/explored)
"aJ" = (/obj/effect/floor_decal/industrial/warning{dir = 8},/turf/simulated/shuttle/floor/black/airless,/area/debrisfield/explored)
"aK" = (/obj/effect/floor_decal/industrial/warning{dir = 10},/obj/machinery/atmospherics/unary/vent_pump/high_volume{dir = 8; frequency = 1380; id_tag = "expshuttle_docker_pump_out_internal"},/turf/simulated/shuttle/floor/black/airless,/area/debrisfield/explored)
"aL" = (/obj/effect/floor_decal/industrial/warning,/turf/simulated/shuttle/floor/black/airless,/area/debrisfield/explored)
"aM" = (/obj/machinery/atmospherics/pipe/manifold/visible/cyan{dir = 4},/turf/simulated/shuttle/wall/voidcraft,/area/debrisfield/explored)
"aN" = (/obj/machinery/door/airlock/voidcraft/vertical,/turf/simulated/shuttle/floor/black,/area/debrisfield/explored)
"aO" = (/obj/effect/floor_decal/industrial/warning{dir = 6},/obj/machinery/light{dir = 4},/obj/machinery/atmospherics/unary/vent_pump/high_volume{dir = 4; frequency = 1380; id_tag = "expshuttle_vent"},/turf/simulated/shuttle/floor/black/airless,/area/debrisfield/explored)
"aP" = (/obj/machinery/atmospherics/pipe/simple/visible/yellow{dir = 10},/turf/simulated/shuttle/wall/voidcraft/hard_corner,/area/debrisfield/explored)
"aQ" = (/obj/effect/floor_decal/industrial/warning/corner{dir = 1},/turf/simulated/shuttle/floor/black/airless,/area/debrisfield/explored)
"aR" = (/obj/machinery/atmospherics/pipe/tank/air{dir = 4},/turf/simulated/shuttle/floor/darkred/airless,/area/debrisfield/explored)
"aS" = (/obj/machinery/atmospherics/pipe/simple/visible/cyan{dir = 9},/turf/simulated/shuttle/wall/voidcraft,/area/debrisfield/explored)
"aT" = (/obj/machinery/atmospherics/pipe/simple/visible/cyan{dir = 4},/turf/simulated/shuttle/floor/darkred/airless,/area/debrisfield/explored)
"aU" = (/obj/machinery/atmospherics/unary/vent_pump/high_volume/wall_mounted{dir = 1; frequency = 1380; id_tag = "expshuttle_docker_pump_out_external"; power_rating = 20000},/turf/simulated/shuttle/wall/voidcraft,/area/debrisfield/explored)
"aV" = (/obj/machinery/light,/obj/effect/floor_decal/industrial/warning/corner,/obj/effect/floor_decal/industrial/warning/corner{dir = 8},/obj/effect/decal/cleanable/blood/gibs/xeno/body,/turf/simulated/shuttle/floor/black/airless,/area/debrisfield/explored)
"aW" = (/obj/mob_spawner/carp/hard,/turf/space,/area/debrisfield/explored)
"aX" = (/obj/structure/shuttle/engine/propulsion,/turf/simulated/shuttle/plating/airless,/area/debrisfield/explored)
"aY" = (/obj/machinery/door/airlock/multi_tile/metal,/turf/simulated/shuttle/floor/black/airless,/area/debrisfield/explored)
"aZ" = (/turf/simulated/mineral/floor/vacuum,/area/debrisfield/explored)
"ba" = (/obj/effect/immovablerod,/turf/simulated/mineral/floor/vacuum,/area/debrisfield/explored)
"bb" = (/obj/structure/grille,/obj/structure/window/reinforced/full,/obj/structure/window/reinforced{dir = 4},/turf/simulated/shuttle/plating/airless,/area/debrisfield/explored)
"bc" = (/obj/structure/grille,/obj/structure/window/reinforced/full,/obj/structure/window/reinforced{dir = 8},/turf/simulated/shuttle/plating/airless,/area/debrisfield/explored)
"bd" = (/obj/structure/grille,/obj/structure/window/reinforced/full,/turf/simulated/shuttle/plating/airless,/area/debrisfield/explored)
"be" = (/obj/structure/grille,/obj/structure/window/reinforced/full,/obj/machinery/atmospherics/pipe/simple/visible/yellow{dir = 6},/turf/simulated/shuttle/plating/airless,/area/debrisfield/explored)
"bf" = (/turf/space,/area/debrisfield/unexplored)
"bg" = (/obj/item/storage/mre/random,/obj/item/storage/mre/random,/obj/item/storage/mre/random,/obj/item/storage/mre/random,/obj/item/storage/mre/random,/obj/item/storage/mre/random,/obj/structure/closet/crate,/turf/simulated/shuttle/floor/darkred/airless,/area/debrisfield/explored)
"bh" = (/obj/mob_spawner/carp,/turf/space,/area/debrisfield/explored)
"bi" = (/obj/structure/loot_pile/mecha/durand,/turf/simulated/mineral/floor/vacuum,/area/debrisfield/explored)
"bv" = (/obj/effect/decal/cleanable/blood/gibs/xeno/limb,/turf/simulated/shuttle/floor/black/airless,/area/debrisfield/explored)
"oX" = (/obj/effect/decal/cleanable/blood/gibs/xeno/core,/turf/simulated/shuttle/floor/black/airless,/area/debrisfield/explored)
"pq" = (/obj/mob_spawner/derelict,/turf/simulated/shuttle/floor/black/airless,/area/debrisfield/explored)
"Iv" = (/obj/effect/floor_decal/industrial/warning{dir = 1},/obj/effect/decal/cleanable/blood/gibs/xeno/body,/turf/simulated/shuttle/floor/black/airless,/area/debrisfield/explored)
"Vl" = (/obj/effect/floor_decal/industrial/warning,/obj/effect/gibspawner/human,/turf/simulated/shuttle/floor/black/airless,/area/debrisfield/explored)
"Xk" = (/obj/structure/bed/chair/shuttle{dir = 1},/obj/effect/decal/cleanable/blood/gibs/xeno/limb,/turf/simulated/shuttle/floor/black/airless,/area/debrisfield/explored)

(1,1,1) = {"
bfaaaaaaaaaaaaaaaaaaaaaaaaaaaabfbfbfbfbf
aaaaabaaaaaaaaaaaaaaaaaiaiacaaaabfbfbfbf
aaaaaaacaiaiajalaaaaaladayafacaaaabfbfbf
aaaaacafaeagoXaaaWaaalahbvakbbaaaaaabfbf
aaaabcamadahadaaaaaaaabdacacacaaaaaaaabf
aaaaacacacbdanalaaaaaaaaaaaaaaaaaaaaaaaa
aaaabcadapaqadaaaaaaaaadaqalaaaqbbaaaaaa
aaaaacarpqoXadalaaaaaaadalaladasacaaaaaa
aaaaacatauavadalaabhaaaaalavXkavacaaaaaa
aaacacacacaaaaaaaaaaaaaaalacacacacacaaaa
aaacawaxaoaaaaaaaaaaaaaaaabeaAIvaDaCaaaa
aaaaaaaaalalbdanaaaaaaaaalaEaFoXaGaHaaaa
aaaaalaaalaaaJadalaaaaalalaIaKaLaOaMaaaa
aaaaaNaBaBaBaQbvaaaaaaaaaaaIaPaRaTaSaaaa
aaaaacVlaLaVaLaLaaaaaaaaalaUaUacacafaaaa
aaaaacazbgafaYadalalaaaaaaaaaaaXaXaXaaaa
aaaaafacacacaaaaaaaaaaaaaaaabhaaaaaaaabf
aaaaaXaXaXaaaaaaaaaaaaaaaaaaaaaaaaaabfbf
bfaaaaaaaaaabhaaaaaaaZaaaaaaaaaaaabfbfbf
bfbfaaaaaaaaaaaaaaaababiaaaaaaaabfbfbfbf
bfbfbfaaaaaaaaaaaaaaaaaaaaaaaabfbfbfbfbf
bfbfbfbfbfaaaaaaaaaaaaaaaabfbfbfbfbfbfbf
"}
