//MAP CONVERTED BY dmm2tgm.py THIS HEADER COMMENT PREVENTS RECONVERSION, DO NOT REMOVE
"aa" = (
/obj/structure/mirror{
	pixel_x = 26
	},
/obj/structure/sink{
	dir = 4;
	pixel_x = 11
	},
/obj/machinery/light/small{
	dir = 4
	},
/turf/simulated/floor/tiled/white,
/area/debrisfield/pirate_oupost)
"ab" = (
/obj/structure/sink{
	dir = 8;
	pixel_x = -12;
	pixel_y = 2
	},
/obj/structure/mirror{
	pixel_x = -26
	},
/obj/structure/loot_pile/surface/medicine_cabinet/fresh{
	pixel_x = 28
	},
/obj/machinery/light/small{
	dir = 8
	},
/turf/simulated/floor/tiled/white,
/area/debrisfield/pirate_oupost)
"ac" = (
/obj/structure/flora/pottedplant/flower,
/mob/living/simple_mob/humanoid/pirate/las,
/turf/simulated/floor/wood,
/area/debrisfield/pirate_oupost)
"ad" = (
/obj/item/stool/padded,
/obj/effect/floor_decal/borderfloorblack{
	dir = 4
	},
/mob/living/simple_mob/humanoid/pirate/ranged,
/turf/simulated/floor/tiled,
/area/debrisfield/pirate_oupost)
"ae" = (
/obj/item/stool/padded,
/obj/effect/floor_decal/borderfloorblack{
	dir = 1
	},
/mob/living/simple_mob/humanoid/pirate/ranged/handcannon,
/turf/simulated/floor/tiled,
/area/debrisfield/pirate_oupost)
"aw" = (
/obj/structure/dispenser{
	phorontanks = 0
	},
/turf/simulated/floor/tiled/techfloor/grid,
/area/debrisfield/pirate_oupost)
"bm" = (
/obj/machinery/door/blast/shutters{
	dir = 4
	},
/turf/simulated/floor/tiled/techfloor/grid,
/area/debrisfield/pirate_oupost)
"by" = (
/obj/structure/table/marble,
/obj/item/material/knife/butch,
/turf/simulated/floor/tiled/dark,
/area/debrisfield/pirate_oupost)
"bH" = (
/obj/machinery/vending/dinnerware,
/turf/simulated/floor/tiled/dark,
/area/debrisfield/pirate_oupost)
"bZ" = (
/obj/machinery/light{
	dir = 1
	},
/turf/simulated/floor/tiled/techfloor/grid,
/area/debrisfield/pirate_oupost)
"ca" = (
/obj/machinery/light/small{
	dir = 4
	},
/turf/simulated/floor/tiled,
/area/debrisfield/pirate_oupost)
"cc" = (
/turf/simulated/mineral/vacuum,
/area/debrisfield/pirate_oupost)
"cC" = (
/turf/simulated/floor/airless,
/area/debrisfield/explored)
"cD" = (
/obj/structure/closet/emcloset,
/turf/simulated/floor/tiled,
/area/debrisfield/pirate_oupost)
"de" = (
/obj/structure/bed/chair{
	dir = 4
	},
/turf/simulated/floor/tiled,
/area/debrisfield/pirate_oupost)
"dk" = (
/obj/effect/floor_decal/borderfloorblack{
	dir = 1
	},
/turf/simulated/floor/tiled,
/area/debrisfield/pirate_oupost)
"dr" = (
/obj/structure/closet/secure_closet/freezer/meat{
	anchored = 1
	},
/turf/simulated/floor/tiled/freezer,
/area/debrisfield/pirate_oupost)
"dY" = (
/obj/structure/table/woodentable,
/obj/item/flashlight/lamp/green,
/turf/simulated/floor/wood,
/area/debrisfield/pirate_oupost)
"eH" = (
/obj/machinery/light,
/turf/simulated/floor/tiled,
/area/debrisfield/pirate_oupost)
"fx" = (
/obj/effect/floor_decal/borderfloorblack/corner{
	dir = 4
	},
/turf/simulated/floor/tiled,
/area/debrisfield/pirate_oupost)
"fC" = (
/obj/machinery/light/small/flicker{
	dir = 8
	},
/turf/simulated/floor,
/area/debrisfield/pirate_oupost)
"fI" = (
/obj/structure/closet/crate/bin{
	anchored = 1
	},
/turf/simulated/floor/wood,
/area/debrisfield/pirate_oupost)
"gb" = (
/obj/structure/table/rack/shelf/steel,
/obj/fiftyspawner/uranium,
/obj/fiftyspawner/uranium,
/turf/simulated/floor/tiled,
/area/debrisfield/pirate_oupost)
"gc" = (
/obj/structure/closet/emcloset,
/turf/simulated/floor/wood,
/area/debrisfield/pirate_oupost)
"gp" = (
/obj/machinery/atmospherics/unary/vent_scrubber/on{
	dir = 1
	},
/obj/structure/table/marble,
/obj/item/reagent_containers/food/condiment/small/saltshaker{
	pixel_x = -3
	},
/obj/item/reagent_containers/food/condiment/small/saltshaker{
	pixel_x = -9
	},
/obj/item/reagent_containers/food/condiment/small/peppermill{
	pixel_x = 3
	},
/obj/item/reagent_containers/food/condiment/small/peppermill{
	pixel_x = 9
	},
/obj/item/reagent_containers/food/condiment/spacespice{
	pixel_x = -8;
	pixel_y = 13
	},
/obj/item/reagent_containers/food/condiment/enzyme{
	layer = 5;
	pixel_y = 16
	},
/obj/item/reagent_containers/food/condiment/soysauce{
	pixel_x = 8;
	pixel_y = 16
	},
/turf/simulated/floor/tiled/dark,
/area/debrisfield/pirate_oupost)
"gq" = (
/obj/structure/reagent_dispensers/fueltank,
/turf/simulated/floor/tiled,
/area/debrisfield/pirate_oupost)
"gA" = (
/obj/machinery/light{
	dir = 4
	},
/turf/simulated/floor/tiled,
/area/debrisfield/pirate_oupost)
"hf" = (
/obj/structure/bed,
/obj/item/bedsheet/orange,
/turf/simulated/floor/tiled,
/area/debrisfield/pirate_oupost)
"hn" = (
/obj/structure/table/woodentable,
/turf/simulated/floor/tiled/dark,
/area/debrisfield/pirate_oupost)
"hq" = (
/obj/machinery/door/airlock/freezer,
/turf/simulated/floor/tiled/freezer,
/area/debrisfield/pirate_oupost)
"ij" = (
/turf/simulated/wall,
/area/debrisfield/pirate_oupost)
"jc" = (
/turf/simulated/wall/r_wall,
/area/debrisfield/pirate_oupost)
"jh" = (
/obj/machinery/microwave,
/obj/structure/table/marble,
/obj/machinery/light{
	dir = 4
	},
/turf/simulated/floor/tiled/dark,
/area/debrisfield/pirate_oupost)
"jv" = (
/obj/structure/table/standard,
/obj/random/tool/powermaint,
/obj/random/tool/powermaint,
/obj/random/tool/powermaint,
/turf/simulated/floor/tiled,
/area/debrisfield/pirate_oupost)
"jC" = (
/obj/structure/bed/double,
/obj/item/bedsheet/browndouble,
/turf/simulated/floor/wood,
/area/debrisfield/pirate_oupost)
"ko" = (
/turf/simulated/floor/carpet,
/area/debrisfield/pirate_oupost)
"lQ" = (
/obj/structure/table/marble,
/obj/machinery/reagentgrinder,
/turf/simulated/floor/tiled/dark,
/area/debrisfield/pirate_oupost)
"ma" = (
/obj/machinery/door/airlock/glass_external,
/turf/simulated/floor/tiled,
/area/debrisfield/pirate_oupost)
"mc" = (
/obj/machinery/door/airlock/engineering,
/turf/simulated/floor/tiled,
/area/debrisfield/pirate_oupost)
"mP" = (
/turf/simulated/floor/tiled/freezer,
/area/debrisfield/pirate_oupost)
"nz" = (
/obj/structure/loot_pile/surface/medicine_cabinet/fresh{
	pixel_x = -28
	},
/turf/simulated/floor/tiled/white,
/area/debrisfield/pirate_oupost)
"nY" = (
/obj/structure/bed/chair,
/turf/simulated/floor/tiled,
/area/debrisfield/pirate_oupost)
"oh" = (
/mob/living/simple_mob/humanoid/pirate/ranged/handcannon/armored,
/turf/simulated/floor/tiled,
/area/debrisfield/pirate_oupost)
"oi" = (
/obj/machinery/light/small,
/turf/simulated/floor/tiled/freezer,
/area/debrisfield/pirate_oupost)
"or" = (
/obj/machinery/appliance/cooker/oven,
/turf/simulated/floor/tiled/dark,
/area/debrisfield/pirate_oupost)
"pF" = (
/obj/machinery/power/port_gen/pacman/super,
/turf/simulated/floor/tiled,
/area/debrisfield/pirate_oupost)
"pT" = (
/turf/simulated/shuttle/wall/voidcraft/hard_corner,
/area/debrisfield/pirate_oupost)
"qd" = (
/obj/structure/fitness/punchingbag,
/turf/simulated/floor/carpet,
/area/debrisfield/pirate_oupost)
"qw" = (
/obj/structure/fitness/weightlifter,
/turf/simulated/floor/wood,
/area/debrisfield/pirate_oupost)
"qV" = (
/obj/structure/closet/crate/trashcart,
/obj/random/trash,
/obj/random/trash,
/obj/random/trash,
/obj/random/trash,
/obj/random/trash,
/obj/random/trash,
/obj/random/trash,
/obj/random/trash,
/obj/random/trash,
/turf/simulated/floor,
/area/debrisfield/pirate_oupost)
"qW" = (
/turf/simulated/floor/tiled/techfloor/grid,
/area/debrisfield/pirate_oupost)
"qZ" = (
/turf/simulated/wall/solidrock,
/area/debrisfield/pirate_oupost)
"rA" = (
/obj/structure/table/woodentable,
/turf/simulated/floor/tiled,
/area/debrisfield/pirate_oupost)
"rN" = (
/obj/structure/bed/chair{
	dir = 8
	},
/turf/simulated/floor/wood,
/area/debrisfield/pirate_oupost)
"tf" = (
/obj/structure/table/rack/shelf/steel,
/obj/random/toolbox,
/obj/random/toolbox,
/obj/random/toolbox,
/obj/random/toolbox,
/turf/simulated/floor/tiled,
/area/debrisfield/pirate_oupost)
"tl" = (
/obj/machinery/shower{
	pixel_y = 18
	},
/obj/structure/curtain/open/shower,
/turf/simulated/floor/tiled,
/area/debrisfield/pirate_oupost)
"tp" = (
/obj/structure/closet/firecloset,
/turf/simulated/floor/tiled,
/area/debrisfield/pirate_oupost)
"tv" = (
/obj/machinery/door/airlock{
	name = "Restroom"
	},
/turf/simulated/floor/tiled/white,
/area/debrisfield/pirate_oupost)
"tN" = (
/turf/simulated/mineral/floor/vacuum,
/area/debrisfield/explored)
"tZ" = (
/obj/structure/table/woodentable,
/obj/item/reagent_containers/food/drinks/bottle/cola,
/turf/simulated/floor/tiled/dark,
/area/debrisfield/pirate_oupost)
"uj" = (
/obj/structure/bed/chair/comfy/black{
	dir = 8
	},
/turf/simulated/floor/wood,
/area/debrisfield/pirate_oupost)
"uk" = (
/mob/living/simple_mob/humanoid/pirate/ranged,
/turf/simulated/floor/tiled,
/area/debrisfield/pirate_oupost)
"uq" = (
/obj/machinery/portable_atmospherics/canister/empty/phoron,
/turf/simulated/floor/tiled/techfloor/grid,
/area/debrisfield/pirate_oupost)
"ur" = (
/obj/machinery/door/window/northright{
	dir = 8
	},
/turf/simulated/floor/tiled/dark,
/area/debrisfield/pirate_oupost)
"uG" = (
/obj/structure/closet/cabinet,
/obj/item/reagent_containers/food/drinks/bottle/specialwhiskey,
/obj/item/reagent_containers/food/drinks/bottle/specialwhiskey,
/obj/item/reagent_containers/food/drinks/bottle/specialwhiskey,
/turf/simulated/floor/wood,
/area/debrisfield/pirate_oupost)
"uJ" = (
/obj/structure/table/woodentable,
/obj/item/reagent_containers/food/drinks/bottle/rum,
/turf/simulated/floor/tiled/dark,
/area/debrisfield/pirate_oupost)
"va" = (
/obj/structure/closet{
	anchored = 1
	},
/obj/item/clothing/under/pirate,
/obj/random/mre,
/obj/item/gun/projectile/shotgun/doublebarrel/sawn/alt,
/turf/simulated/floor/tiled,
/area/debrisfield/pirate_oupost)
"vw" = (
/obj/structure/closet/secure_closet/engineering_electrical,
/turf/simulated/floor/tiled/techfloor/grid,
/area/debrisfield/pirate_oupost)
"vx" = (
/obj/machinery/vending/fitness,
/turf/simulated/floor/wood,
/area/debrisfield/pirate_oupost)
"vy" = (
/turf/simulated/shuttle/wall/voidcraft/green,
/area/debrisfield/pirate_oupost)
"vE" = (
/mob/living/simple_mob/humanoid/pirate/mate/ranged/shotgun,
/turf/simulated/floor/wood,
/area/debrisfield/pirate_oupost)
"vQ" = (
/turf/simulated/wall/solidrock,
/area/debrisfield/explored)
"wC" = (
/obj/machinery/door/blast/regular,
/turf/simulated/floor/tiled/techfloor/grid,
/area/debrisfield/pirate_oupost)
"wG" = (
/obj/structure/table/gamblingtable,
/obj/item/storage/dicecup/loaded{
	pixel_x = 6
	},
/obj/item/deck/cards{
	pixel_x = -6;
	pixel_y = 8
	},
/turf/simulated/floor/tiled,
/area/debrisfield/pirate_oupost)
"xe" = (
/obj/machinery/fitness/punching_bag,
/turf/simulated/floor/wood,
/area/debrisfield/pirate_oupost)
"xs" = (
/obj/machinery/suit_storage_unit/standard_unit,
/turf/simulated/floor/tiled/techfloor/grid,
/area/debrisfield/pirate_oupost)
"xO" = (
/obj/structure/dispenser,
/turf/simulated/floor/tiled,
/area/debrisfield/pirate_oupost)
"xQ" = (
/turf/simulated/floor/wood,
/area/debrisfield/pirate_oupost)
"xZ" = (
/obj/machinery/fitness/heavy/lifter,
/turf/simulated/floor/wood,
/area/debrisfield/pirate_oupost)
"yJ" = (
/obj/structure/bed/chair{
	dir = 1
	},
/turf/simulated/floor/tiled,
/area/debrisfield/pirate_oupost)
"yK" = (
/turf/simulated/floor/airless,
/area/debrisfield/pirate_oupost)
"zf" = (
/obj/machinery/door/airlock/command,
/turf/simulated/floor/wood,
/area/debrisfield/pirate_oupost)
"zk" = (
/obj/machinery/light,
/turf/simulated/floor/wood,
/area/debrisfield/pirate_oupost)
"zm" = (
/obj/machinery/portable_atmospherics/canister/oxygen,
/turf/simulated/floor/tiled/techfloor/grid,
/area/debrisfield/pirate_oupost)
"zx" = (
/obj/structure/closet{
	anchored = 1
	},
/obj/item/clothing/under/pirate,
/obj/random/mre,
/obj/item/gun/energy/zip,
/turf/simulated/floor/tiled,
/area/debrisfield/pirate_oupost)
"zS" = (
/obj/structure/bed,
/obj/item/bedsheet/green,
/turf/simulated/floor/tiled,
/area/debrisfield/pirate_oupost)
"Al" = (
/obj/machinery/door/airlock,
/turf/simulated/floor/tiled,
/area/debrisfield/pirate_oupost)
"Aq" = (
/obj/machinery/vending/boozeomat,
/turf/simulated/wall,
/area/debrisfield/pirate_oupost)
"AC" = (
/obj/structure/closet/secure_closet/engineering_welding,
/turf/simulated/floor/tiled/techfloor/grid,
/area/debrisfield/pirate_oupost)
"AX" = (
/mob/living/simple_mob/humanoid/pirate/ranged/shotgun/armored,
/turf/simulated/floor/wood,
/area/debrisfield/pirate_oupost)
"Bd" = (
/obj/machinery/light{
	dir = 4;
	use_power = 0
	},
/turf/simulated/floor/tiled,
/area/debrisfield/pirate_oupost)
"Bx" = (
/obj/structure/bed,
/obj/item/bedsheet/rainbow,
/turf/simulated/floor/tiled,
/area/debrisfield/pirate_oupost)
"Bz" = (
/obj/machinery/light,
/turf/simulated/floor/tiled/techfloor/grid,
/area/debrisfield/pirate_oupost)
"Ci" = (
/mob/living/simple_mob/humanoid/pirate/ranged/shotgun/armored,
/turf/simulated/floor/tiled/dark,
/area/debrisfield/pirate_oupost)
"CG" = (
/obj/effect/floor_decal/borderfloorblack{
	dir = 4
	},
/turf/simulated/floor/tiled,
/area/debrisfield/pirate_oupost)
"CI" = (
/obj/structure/table/woodentable,
/obj/machinery/light{
	dir = 8
	},
/obj/item/reagent_containers/food/drinks/drinkingglass/shotglass{
	pixel_x = -4;
	pixel_y = 8
	},
/obj/item/reagent_containers/food/drinks/drinkingglass/shotglass{
	pixel_x = -4
	},
/obj/item/reagent_containers/food/drinks/bottle/vodka{
	pixel_x = 6;
	pixel_y = 4
	},
/turf/simulated/floor/tiled,
/area/debrisfield/pirate_oupost)
"DC" = (
/obj/machinery/door/airlock/maintenance/common,
/turf/simulated/floor/tiled/techfloor/grid,
/area/debrisfield/pirate_oupost)
"DM" = (
/turf/simulated/floor/tiled/dark,
/area/debrisfield/pirate_oupost)
"HU" = (
/obj/structure/bed/chair{
	dir = 8
	},
/turf/simulated/floor/tiled,
/area/debrisfield/pirate_oupost)
"IH" = (
/obj/machinery/light{
	dir = 8
	},
/turf/simulated/floor/tiled,
/area/debrisfield/pirate_oupost)
"Js" = (
/obj/machinery/light/small/flicker{
	dir = 1
	},
/turf/simulated/floor,
/area/debrisfield/pirate_oupost)
"Lv" = (
/obj/item/stool/padded,
/obj/effect/floor_decal/borderfloorblack{
	dir = 4
	},
/turf/simulated/floor/tiled,
/area/debrisfield/pirate_oupost)
"LB" = (
/obj/machinery/light/small/flicker{
	dir = 1
	},
/turf/simulated/floor/airless,
/area/debrisfield/pirate_oupost)
"Mv" = (
/obj/machinery/door/airlock/maintenance/int,
/turf/simulated/floor,
/area/debrisfield/pirate_oupost)
"MW" = (
/obj/structure/bed,
/obj/item/bedsheet/red,
/turf/simulated/floor/tiled,
/area/debrisfield/pirate_oupost)
"NK" = (
/obj/structure/table/woodentable,
/obj/machinery/light/small,
/obj/item/paper_bin{
	pixel_x = -3;
	pixel_y = 7
	},
/turf/simulated/floor/wood,
/area/debrisfield/pirate_oupost)
"NR" = (
/obj/machinery/gibber,
/turf/simulated/floor/tiled/freezer,
/area/debrisfield/pirate_oupost)
"Pm" = (
/turf/simulated/floor/tiled,
/area/debrisfield/pirate_oupost)
"Pq" = (
/obj/structure/janitorialcart,
/obj/item/reagent_containers/glass/bucket,
/turf/simulated/floor,
/area/debrisfield/pirate_oupost)
"Pw" = (
/obj/structure/closet/secure_closet/freezer/fridge{
	anchored = 1
	},
/turf/simulated/floor/tiled/freezer,
/area/debrisfield/pirate_oupost)
"QU" = (
/obj/machinery/light{
	dir = 1
	},
/turf/simulated/floor/wood,
/area/debrisfield/pirate_oupost)
"QY" = (
/obj/structure/sink/kitchen{
	pixel_y = 28
	},
/turf/simulated/floor,
/area/debrisfield/pirate_oupost)
"RS" = (
/obj/machinery/door/airlock/external,
/obj/structure/fans/tiny,
/turf/simulated/floor/tiled,
/area/debrisfield/pirate_oupost)
"TO" = (
/turf/space,
/area/debrisfield/unexplored)
"Ue" = (
/obj/structure/closet{
	anchored = 1
	},
/obj/item/clothing/under/pirate,
/obj/random/mre,
/obj/item/gun/projectile/pirate,
/turf/simulated/floor/tiled,
/area/debrisfield/pirate_oupost)
"Ui" = (
/obj/machinery/light{
	dir = 8
	},
/turf/simulated/floor/tiled/techfloor/grid,
/area/debrisfield/pirate_oupost)
"Uw" = (
/obj/structure/closet/jcloset,
/obj/random/soap,
/obj/item/mop,
/obj/item/storage/bag/trash,
/obj/item/lightreplacer,
/obj/item/storage/box/mousetraps,
/obj/item/storage/box/mousetraps,
/turf/simulated/floor,
/area/debrisfield/pirate_oupost)
"UA" = (
/obj/machinery/light{
	dir = 1
	},
/turf/simulated/floor/tiled,
/area/debrisfield/pirate_oupost)
"UD" = (
/obj/item/stool/padded,
/obj/effect/floor_decal/borderfloorblack{
	dir = 1
	},
/turf/simulated/floor/tiled,
/area/debrisfield/pirate_oupost)
"UP" = (
/obj/structure/table/sifwoodentable,
/obj/machinery/light/small,
/obj/item/moneybag/vault,
/turf/simulated/floor/wood,
/area/debrisfield/pirate_oupost)
"Vi" = (
/turf/simulated/floor,
/area/debrisfield/pirate_oupost)
"Vk" = (
/obj/structure/bed/chair/office/dark{
	dir = 4
	},
/turf/simulated/floor/wood,
/area/debrisfield/pirate_oupost)
"Vy" = (
/turf/simulated/mineral/vacuum,
/area/debrisfield/explored)
"VT" = (
/obj/structure/bed,
/obj/item/bedsheet/purple,
/turf/simulated/floor/tiled,
/area/debrisfield/pirate_oupost)
"VU" = (
/obj/machinery/light/small,
/turf/simulated/floor/tiled,
/area/debrisfield/pirate_oupost)
"WD" = (
/obj/structure/toilet{
	pixel_y = 16
	},
/turf/simulated/floor/tiled/white,
/area/debrisfield/pirate_oupost)
"WM" = (
/obj/structure/table/rack/shelf/steel,
/obj/fiftyspawner/phoron,
/obj/fiftyspawner/phoron,
/turf/simulated/floor/tiled,
/area/debrisfield/pirate_oupost)
"XF" = (
/obj/random/trash_pile,
/turf/simulated/floor,
/area/debrisfield/pirate_oupost)
"XH" = (
/obj/machinery/door/airlock/external,
/turf/simulated/floor/tiled,
/area/debrisfield/pirate_oupost)
"Yp" = (
/obj/structure/table/marble,
/obj/item/material/kitchen/rollingpin,
/turf/simulated/floor/tiled/dark,
/area/debrisfield/pirate_oupost)
"Zo" = (
/obj/structure/closet/toolcloset,
/turf/simulated/floor/tiled/techfloor/grid,
/area/debrisfield/pirate_oupost)
"Zu" = (
/obj/structure/bed/chair/comfy/black{
	dir = 4
	},
/turf/simulated/floor/wood,
/area/debrisfield/pirate_oupost)
"ZC" = (
/obj/structure/window/reinforced/full,
/obj/structure/grille,
/turf/simulated/floor/tiled,
/area/debrisfield/pirate_oupost)
"ZD" = (
/turf/space,
/area/debrisfield/explored)

(1,1,1) = {"
ZD
ZD
ZD
ZD
ZD
ZD
ZD
ZD
ZD
ZD
ZD
ZD
TO
TO
TO
TO
TO
TO
TO
TO
TO
TO
ZD
ZD
ZD
ZD
ZD
ZD
ZD
ZD
ZD
ZD
ZD
ZD
ZD
ZD
ZD
ZD
ZD
ZD
"}
(2,1,1) = {"
ZD
ZD
Vy
Vy
Vy
Vy
Vy
ZD
ZD
ZD
ZD
ZD
ZD
TO
TO
TO
TO
TO
TO
TO
TO
TO
ZD
ZD
Vy
Vy
ZD
ZD
ZD
ZD
ZD
ZD
Vy
Vy
ZD
ZD
Vy
Vy
Vy
ZD
"}
(3,1,1) = {"
ZD
Vy
Vy
Vy
Vy
Vy
Vy
Vy
ZD
ZD
ZD
ZD
ZD
ZD
ZD
TO
TO
TO
TO
TO
TO
ZD
ZD
Vy
Vy
Vy
Vy
Vy
Vy
Vy
Vy
Vy
Vy
Vy
Vy
Vy
Vy
Vy
Vy
ZD
"}
(4,1,1) = {"
ZD
Vy
Vy
Vy
Vy
Vy
Vy
Vy
Vy
Vy
Vy
Vy
Vy
ZD
ZD
ZD
ZD
ZD
ZD
ZD
ZD
ZD
Vy
vQ
vQ
vQ
vQ
vQ
vQ
vQ
vQ
vQ
vQ
vQ
vQ
vQ
Vy
Vy
ZD
ZD
"}
(5,1,1) = {"
ZD
Vy
Vy
Vy
Vy
Vy
Vy
Vy
Vy
Vy
Vy
Vy
Vy
Vy
Vy
ZD
ZD
ZD
ZD
ZD
ZD
ZD
Vy
vQ
jc
jc
jc
jc
jc
jc
jc
jc
jc
jc
jc
vQ
Vy
ZD
ZD
ZD
"}
(6,1,1) = {"
ZD
Vy
Vy
Vy
Vy
Vy
Vy
Vy
Vy
Vy
Vy
Vy
Vy
Vy
Vy
Vy
Vy
Vy
ZD
ZD
Vy
Vy
Vy
vQ
jc
uq
qW
uq
jc
Zo
qW
qW
qW
xs
jc
vQ
Vy
ZD
ZD
ZD
"}
(7,1,1) = {"
ZD
Vy
Vy
Vy
Vy
Vy
Vy
Vy
Vy
Vy
Vy
Vy
vQ
vQ
vQ
vQ
vQ
vQ
Vy
Vy
Vy
Vy
Vy
vQ
jc
uq
qW
uq
jc
AC
qW
qW
qW
aw
jc
vQ
Vy
Vy
ZD
ZD
"}
(8,1,1) = {"
ZD
ZD
ZD
Vy
Vy
vQ
vQ
vQ
vQ
vQ
vQ
vQ
ij
ij
ij
ij
ij
ij
vQ
vQ
vQ
vQ
vQ
vQ
jc
qW
qW
qW
jc
vw
qW
qW
qW
zm
jc
vQ
vQ
Vy
ZD
ZD
"}
(9,1,1) = {"
TO
ZD
ZD
Vy
Vy
vQ
ij
ij
ij
ij
ij
ij
ij
gq
jv
jv
jv
ij
ij
jc
jc
jc
jc
jc
jc
bm
bm
bm
jc
jc
DC
jc
DC
jc
jc
jc
vQ
Vy
Vy
ZD
"}
(10,1,1) = {"
TO
TO
ZD
Vy
Vy
vQ
ij
uG
xQ
Zu
ij
pF
Pm
Pm
Pm
Pm
Pm
Pm
gb
jc
qW
qW
qW
Ui
qW
qW
qW
qW
Ui
qW
qW
Ui
qW
qW
qW
jc
vQ
Vy
Vy
ZD
"}
(11,1,1) = {"
TO
TO
ZD
Vy
Vy
vQ
ij
xQ
xQ
UP
ij
Pm
Pm
Pm
Pm
Pm
Pm
Pm
tf
jc
qW
qW
qW
qW
qW
qW
qW
qW
qW
qW
qW
qW
qW
qW
qW
jc
vQ
Vy
Vy
ZD
"}
(12,1,1) = {"
TO
TO
ZD
Vy
Vy
vQ
ij
jC
xQ
uj
ij
pF
Pm
Pm
Pm
gA
Pm
Pm
WM
jc
qW
qW
qW
qW
qW
qW
qW
qW
qW
qW
qW
qW
qW
qW
qW
jc
vQ
Vy
Vy
ZD
"}
(13,1,1) = {"
TO
ZD
ZD
Vy
Vy
vQ
ij
ij
zf
ij
ij
ij
mc
ij
ij
ij
ij
ij
ij
jc
bZ
qW
qW
qW
qW
qW
qW
qW
qW
qW
qW
qW
qW
qW
Bz
jc
vQ
Vy
Vy
ZD
"}
(14,1,1) = {"
ZD
ZD
Vy
Vy
Vy
vQ
ij
xQ
vE
fI
ij
xQ
xQ
fI
xQ
xQ
xZ
xQ
xZ
jc
qW
qW
qW
qW
qW
qW
qW
qW
qW
qW
qW
qW
qW
qW
qW
jc
vQ
Vy
Vy
ZD
"}
(15,1,1) = {"
ZD
Vy
Vy
Vy
Vy
vQ
ij
xQ
Vk
xQ
ij
xe
ko
ko
ko
ko
ko
ko
xQ
jc
qW
qW
qW
qW
qW
qW
qW
qW
qW
qW
qW
qW
qW
qW
qW
jc
vQ
Vy
Vy
ZD
"}
(16,1,1) = {"
ZD
Vy
vQ
vQ
vQ
vQ
ij
xQ
dY
NK
ij
QU
ko
ko
ko
ko
ko
ko
xQ
jc
qW
qW
qW
qW
qW
qW
qW
qW
qW
qW
qW
qW
qW
qW
qW
jc
vQ
Vy
Vy
ZD
"}
(17,1,1) = {"
ZD
Vy
vQ
ij
ij
ij
ij
xQ
rN
xQ
ij
xQ
ko
ko
ko
ko
ko
qd
zk
jc
qW
qW
qW
qW
qW
qW
qW
qW
qW
qW
qW
qW
qW
qW
qW
jc
vQ
Vy
Vy
ZD
"}
(18,1,1) = {"
ZD
Vy
vQ
ij
Uw
fC
ij
xQ
xQ
xQ
zf
xQ
ko
ko
ko
ko
ko
ko
xQ
jc
qW
qW
qW
qW
qW
qW
qW
qW
qW
qW
qW
qW
qW
qW
qW
jc
vQ
Vy
Vy
ZD
"}
(19,1,1) = {"
ZD
Vy
vQ
ij
Pq
Vi
ij
ac
xQ
gc
ij
qw
xQ
qw
AX
xQ
xQ
xQ
vx
jc
qW
qW
qW
qW
qW
qW
qW
qW
qW
qW
qW
qW
qW
qW
qW
jc
vQ
Vy
Vy
ZD
"}
(20,1,1) = {"
ZD
Vy
vQ
ij
QY
Vi
ij
ij
zf
ij
ij
ij
ij
ij
ij
Al
ZC
Al
ij
jc
qW
qW
qW
qW
qW
qW
qW
qW
qW
qW
qW
qW
qW
qW
qW
jc
vQ
Vy
Vy
ZD
"}
(21,1,1) = {"
ZD
Vy
vQ
ij
Vi
Vi
ij
Pm
Pm
Pm
IH
Pm
Pm
Pm
Pm
Pm
Pm
Pm
Pm
ma
qW
qW
qW
qW
qW
qW
qW
qW
qW
qW
qW
qW
qW
qW
qW
jc
vQ
Vy
Vy
ZD
"}
(22,1,1) = {"
ZD
Vy
vQ
ij
Js
Vi
Mv
Pm
Pm
Pm
Pm
Pm
Pm
Pm
Pm
Pm
Pm
Pm
eH
jc
bZ
qW
qW
qW
qW
qW
qW
qW
qW
qW
qW
qW
qW
qW
Bz
jc
vQ
Vy
Vy
ZD
"}
(23,1,1) = {"
ZD
Vy
vQ
ij
XF
qV
ij
Pm
Pm
Pm
Pm
Pm
Pm
Pm
Bd
Pm
Pm
Pm
Pm
ma
qW
qW
qW
qW
qW
qW
qW
qW
qW
qW
qW
qW
qW
qW
qW
jc
vQ
Vy
Vy
ZD
"}
(24,1,1) = {"
ZD
Vy
vQ
ij
ij
ij
ij
Pm
Pm
ij
ij
ij
ij
ij
ij
Al
ZC
Al
ij
jc
qW
qW
qW
qW
qW
qW
qW
qW
qW
qW
qW
qW
qW
qW
qW
jc
vQ
Vy
Vy
ZD
"}
(25,1,1) = {"
ZD
Vy
vQ
vQ
vQ
vQ
ij
Pm
Pm
ij
nY
CI
yJ
Pm
Pm
Pm
Pm
Pm
de
jc
qW
qW
qW
qW
qW
qW
qW
qW
qW
qW
qW
qW
qW
qW
qW
jc
vQ
Vy
ZD
ZD
"}
(26,1,1) = {"
ZD
Vy
Vy
Vy
Vy
vQ
ij
UA
Pm
ij
Pm
Pm
Pm
Pm
Pm
Pm
Pm
Pm
rA
jc
qW
qW
qW
qW
qW
qW
qW
qW
qW
qW
qW
qW
qW
qW
qW
jc
vQ
Vy
Vy
ZD
"}
(27,1,1) = {"
ZD
ZD
ZD
Vy
Vy
vQ
ij
Pm
Pm
ij
CG
Lv
Lv
ad
CG
fx
Pm
Pm
HU
jc
qW
qW
qW
qW
qW
qW
qW
qW
qW
qW
qW
qW
qW
qW
qW
jc
vQ
Vy
Vy
ZD
"}
(28,1,1) = {"
TO
ZD
ZD
ZD
Vy
vQ
ij
Pm
Pm
ij
ur
hn
tZ
hn
ij
dk
Pm
Pm
eH
jc
qW
qW
qW
qW
qW
qW
qW
qW
qW
qW
qW
qW
qW
qW
qW
jc
vQ
Vy
Vy
ZD
"}
(29,1,1) = {"
TO
TO
ZD
ZD
Vy
vQ
ij
Pm
Pm
ij
DM
DM
DM
Ci
hn
UD
Pm
Pm
de
jc
bZ
qW
qW
qW
qW
qW
qW
qW
qW
qW
qW
qW
qW
qW
Bz
jc
vQ
Vy
Vy
ZD
"}
(30,1,1) = {"
TO
TO
ZD
Vy
Vy
vQ
ij
Pm
Pm
ij
DM
lQ
by
DM
hn
UD
Pm
nY
wG
jc
qW
qW
qW
qW
qW
qW
qW
qW
qW
qW
qW
qW
qW
qW
qW
jc
vQ
Vy
Vy
ZD
"}
(31,1,1) = {"
TO
TO
ZD
Vy
Vy
vQ
ij
Pm
Pm
ij
DM
Yp
DM
DM
uJ
ae
Pm
Pm
HU
jc
qW
qW
qW
qW
qW
qW
qW
qW
qW
qW
qW
qW
qW
qW
qW
jc
vQ
Vy
Vy
ZD
"}
(32,1,1) = {"
TO
TO
ZD
Vy
cc
qZ
ij
UA
Pm
Al
DM
or
DM
Aq
ij
ij
ij
ij
ij
jc
wC
wC
wC
wC
wC
wC
wC
wC
wC
wC
wC
wC
wC
wC
wC
jc
vQ
Vy
Vy
ZD
"}
(33,1,1) = {"
TO
TO
ZD
Vy
cc
qZ
ij
Pm
Pm
ij
DM
DM
DM
hq
mP
mP
oi
ij
vQ
vQ
tN
tN
tN
tN
tN
tN
tN
tN
tN
tN
tN
tN
tN
tN
tN
vQ
vQ
Vy
Vy
ZD
"}
(34,1,1) = {"
TO
ZD
ZD
Vy
cc
qZ
ij
Pm
Pm
ij
bH
jh
gp
ij
Pw
dr
NR
ij
vQ
Vy
tN
tN
tN
tN
tN
tN
tN
tN
tN
tN
tN
tN
tN
tN
Vy
Vy
Vy
Vy
Vy
ZD
"}
(35,1,1) = {"
ZD
ZD
Vy
Vy
cc
qZ
ij
Pm
Pm
ij
ij
ij
ij
ij
ij
ij
ij
ij
vQ
Vy
Vy
tN
tN
tN
tN
tN
tN
tN
tN
tN
tN
tN
tN
tN
Vy
Vy
Vy
Vy
Vy
ZD
"}
(36,1,1) = {"
ZD
ZD
Vy
Vy
cc
qZ
ij
Pm
Pm
Pm
cD
xO
pT
pT
pT
pT
qZ
vQ
vQ
Vy
Vy
tN
tN
tN
tN
tN
tN
tN
tN
tN
tN
tN
tN
tN
tN
Vy
Vy
Vy
Vy
ZD
"}
(37,1,1) = {"
ZD
ZD
Vy
Vy
cc
qZ
ij
Pm
Pm
Pm
Pm
VU
vy
Pm
Pm
vy
yK
cC
cC
tN
tN
tN
tN
tN
tN
tN
tN
tN
tN
tN
tN
tN
tN
tN
Vy
Vy
Vy
Vy
Vy
ZD
"}
(38,1,1) = {"
ZD
ZD
Vy
Vy
cc
qZ
ij
Pm
Pm
Pm
Pm
Pm
XH
Pm
Pm
RS
yK
cC
cC
tN
tN
tN
tN
tN
tN
tN
tN
tN
tN
tN
tN
tN
tN
tN
Vy
Vy
Vy
Vy
Vy
ZD
"}
(39,1,1) = {"
ZD
Vy
Vy
vQ
qZ
qZ
ij
UA
Pm
Pm
Pm
Pm
vy
Pm
ca
vy
LB
cC
cC
tN
tN
tN
tN
tN
tN
tN
tN
tN
tN
tN
tN
tN
tN
tN
Vy
Vy
Vy
Vy
Vy
ZD
"}
(40,1,1) = {"
ZD
Vy
Vy
vQ
ij
ij
ij
Pm
Pm
Pm
cD
tp
pT
pT
pT
pT
qZ
vQ
vQ
Vy
Vy
tN
tN
tN
tN
tN
tN
tN
tN
tN
tN
tN
tN
tN
Vy
Vy
Vy
Vy
Vy
ZD
"}
(41,1,1) = {"
ZD
Vy
Vy
vQ
ij
ij
ij
ij
ij
Al
ij
ij
ij
ij
ij
ij
ij
ij
vQ
Vy
Vy
tN
tN
tN
tN
tN
tN
tN
tN
tN
tN
tN
tN
tN
Vy
Vy
Vy
Vy
Vy
ZD
"}
(42,1,1) = {"
ZD
Vy
Vy
vQ
ij
WD
nz
tv
Pm
Pm
Pm
zS
Ue
VT
Ue
MW
zx
ij
vQ
Vy
tN
tN
tN
tN
tN
tN
tN
tN
tN
tN
tN
tN
tN
tN
Vy
Vy
Vy
Vy
Vy
ZD
"}
(43,1,1) = {"
ZD
Vy
Vy
vQ
ij
tl
aa
ij
Pm
Pm
Pm
Pm
Pm
Pm
Pm
uk
eH
ij
vQ
Vy
Vy
tN
tN
tN
tN
tN
tN
tN
tN
tN
tN
tN
tN
tN
Vy
Vy
Vy
Vy
ZD
ZD
"}
(44,1,1) = {"
ZD
Vy
Vy
vQ
ij
ij
ij
ij
Pm
Pm
Pm
Pm
Pm
oh
Pm
Pm
Pm
ij
vQ
Vy
tN
tN
tN
tN
tN
tN
tN
tN
tN
tN
tN
tN
tN
tN
tN
Vy
Vy
Vy
ZD
ZD
"}
(45,1,1) = {"
ZD
Vy
Vy
vQ
ij
WD
ab
tv
Pm
Pm
gA
Bx
Ue
hf
zx
zS
va
ij
vQ
Vy
Vy
tN
tN
tN
tN
tN
tN
tN
tN
tN
tN
tN
tN
tN
tN
Vy
Vy
Vy
ZD
ZD
"}
(46,1,1) = {"
ZD
Vy
Vy
vQ
ij
ij
ij
ij
ij
ij
ij
ij
ij
ij
ij
ij
ij
ij
vQ
Vy
Vy
ZD
ZD
ZD
ZD
ZD
ZD
ZD
ZD
ZD
ZD
ZD
ZD
ZD
ZD
Vy
Vy
ZD
ZD
TO
"}
(47,1,1) = {"
ZD
ZD
Vy
vQ
vQ
vQ
vQ
vQ
vQ
vQ
vQ
vQ
vQ
vQ
vQ
vQ
vQ
vQ
vQ
Vy
ZD
ZD
ZD
ZD
ZD
ZD
ZD
ZD
ZD
ZD
ZD
ZD
ZD
ZD
ZD
ZD
ZD
ZD
TO
TO
"}
(48,1,1) = {"
ZD
ZD
Vy
Vy
Vy
Vy
Vy
Vy
Vy
Vy
Vy
Vy
Vy
Vy
Vy
Vy
Vy
Vy
Vy
ZD
ZD
ZD
ZD
ZD
ZD
ZD
ZD
ZD
ZD
ZD
ZD
ZD
ZD
ZD
ZD
ZD
ZD
ZD
TO
TO
"}
(49,1,1) = {"
TO
ZD
ZD
ZD
Vy
Vy
Vy
Vy
Vy
Vy
Vy
Vy
Vy
Vy
Vy
Vy
Vy
ZD
ZD
ZD
ZD
ZD
ZD
ZD
ZD
ZD
ZD
ZD
ZD
ZD
ZD
ZD
ZD
ZD
ZD
ZD
ZD
TO
TO
TO
"}
(50,1,1) = {"
TO
TO
ZD
ZD
ZD
ZD
ZD
ZD
ZD
ZD
ZD
ZD
ZD
ZD
ZD
ZD
ZD
ZD
ZD
ZD
ZD
ZD
ZD
ZD
ZD
ZD
ZD
ZD
ZD
ZD
ZD
ZD
ZD
ZD
ZD
ZD
ZD
TO
TO
TO
"}
