//MAP CONVERTED BY dmm2tgm.py THIS HEADER COMMENT PREVENTS RECONVERSION, DO NOT REMOVE
"a" = (
/turf/template_noop,
/area/debrisfield/explored)
"b" = (
/turf/simulated/mineral/vacuum,
/area/debrisfield/explored)
"c" = (
/turf/simulated/shuttle/wall,
/area/debrisfield/explored)
"d" = (
/turf/simulated/mineral/floor/vacuum,
/area/debrisfield/explored)
"e" = (
/obj/structure/shuttle/window,
/obj/structure/grille,
/turf/simulated/shuttle/plating/airless,
/area/debrisfield/explored)
"f" = (
/obj/structure/table/standard,
/obj/random/unidentified_medicine/fresh_medicine,
/obj/random/unidentified_medicine/fresh_medicine,
/obj/random/unidentified_medicine/old_medicine,
/obj/random/firstaid,
/turf/simulated/floor/tiled/airless,
/area/debrisfield/explored)
"g" = (
/obj/effect/decal/cleanable/generic,
/turf/simulated/mineral/floor/vacuum,
/area/debrisfield/explored)
"h" = (
/obj/effect/decal/cleanable/dirt,
/obj/structure/frame,
/turf/simulated/shuttle/plating/airless,
/area/debrisfield/explored)
"i" = (
/obj/structure/table/standard,
/obj/random/unidentified_medicine/fresh_medicine,
/obj/random/unidentified_medicine/fresh_medicine,
/obj/random/unidentified_medicine/viral,
/turf/simulated/floor/tiled/airless,
/area/debrisfield/explored)
"j" = (
/obj/structure/closet/secure_closet/sar{
	name = "sar locker";
	req_access = list()
	},
/turf/simulated/floor/tiled/airless,
/area/debrisfield/explored)
"k" = (
/obj/structure/shuttle/engine/propulsion{
	dir = 4
	},
/turf/simulated/shuttle/plating/airless,
/area/debrisfield/explored)
"l" = (
/obj/effect/decal/cleanable/dirt,
/turf/simulated/shuttle/plating/airless,
/area/debrisfield/explored)
"m" = (
/obj/structure/closet/walllocker/emerglocker{
	pixel_x = -32
	},
/obj/machinery/light{
	dir = 8
	},
/turf/simulated/floor/tiled/airless,
/area/debrisfield/explored)
"n" = (
/obj/effect/decal/cleanable/dirt,
/obj/effect/decal/cleanable/generic,
/turf/simulated/shuttle/plating/airless,
/area/debrisfield/explored)
"o" = (
/obj/machinery/sleeper{
	dir = 8
	},
/turf/simulated/floor/tiled/airless,
/area/debrisfield/explored)
"p" = (
/obj/structure/closet/secure_closet/medical3{
	name = "medical locker";
	req_access = list()
	},
/turf/simulated/floor/tiled/airless,
/area/debrisfield/explored)
"q" = (
/obj/effect/decal/cleanable/dirt,
/obj/effect/decal/cleanable/molten_item,
/turf/simulated/shuttle/plating/airless,
/area/debrisfield/explored)
"r" = (
/obj/effect/decal/cleanable/dirt,
/obj/effect/decal/cleanable/blood/oil,
/turf/simulated/shuttle/plating/airless,
/area/debrisfield/explored)
"s" = (
/obj/effect/decal/cleanable/dirt,
/obj/effect/decal/remains/posi,
/turf/simulated/shuttle/plating/airless,
/area/debrisfield/explored)
"t" = (
/obj/machinery/door/unpowered/shuttle,
/turf/simulated/floor/tiled/airless,
/area/debrisfield/explored)
"u" = (
/obj/structure/closet/emcloset,
/turf/simulated/floor/tiled/airless,
/area/debrisfield/explored)
"v" = (
/obj/structure/table/rack,
/obj/item/reagent_containers/chem_disp_cartridge/clonexadone,
/turf/simulated/floor/tiled/airless,
/area/debrisfield/explored)
"w" = (
/obj/effect/decal/cleanable/generic,
/turf/simulated/floor/tiled/airless,
/area/debrisfield/explored)
"x" = (
/obj/structure/dispenser/oxygen{
	oxygentanks = 7
	},
/turf/simulated/floor/tiled/airless,
/area/debrisfield/explored)
"y" = (
/obj/effect/decal/cleanable/blood/oil,
/turf/simulated/floor/tiled/airless,
/area/debrisfield/explored)
"z" = (
/obj/structure/frame/computer{
	dir = 1
	},
/turf/simulated/floor/tiled/airless,
/area/debrisfield/explored)
"A" = (
/obj/machinery/suit_cycler/medical,
/turf/simulated/floor/tiled/airless,
/area/debrisfield/explored)
"B" = (
/mob/living/bot/medbot{
	name = "Dr. Crusty"
	},
/turf/simulated/floor/tiled/airless,
/area/debrisfield/explored)
"C" = (
/obj/effect/decal/cleanable/dirt,
/obj/random/firstaid,
/turf/simulated/shuttle/plating/airless,
/area/debrisfield/explored)
"D" = (
/obj/effect/decal/cleanable/dirt,
/obj/item/storage/firstaid/adv,
/turf/simulated/shuttle/plating/airless,
/area/debrisfield/explored)
"E" = (
/obj/item/material/shard/shrapnel,
/turf/simulated/mineral/floor/vacuum,
/area/debrisfield/explored)
"F" = (
/obj/item/stack/material/steel,
/turf/simulated/mineral/floor/vacuum,
/area/debrisfield/explored)
"G" = (
/obj/item/stack/rods,
/turf/simulated/mineral/floor/vacuum,
/area/debrisfield/explored)
"H" = (
/obj/effect/decal/cleanable/dirt,
/obj/item/stack/material/steel,
/turf/simulated/shuttle/plating/airless,
/area/debrisfield/explored)
"I" = (
/obj/effect/decal/cleanable/dirt,
/obj/item/stack/rods,
/turf/simulated/shuttle/plating/airless,
/area/debrisfield/explored)
"J" = (
/obj/effect/decal/cleanable/dirt,
/obj/item/material/shard/shrapnel,
/turf/simulated/shuttle/plating/airless,
/area/debrisfield/explored)
"K" = (
/obj/item/material/shard/shrapnel,
/obj/machinery/light{
	dir = 4
	},
/turf/simulated/floor/tiled/airless,
/area/debrisfield/explored)
"L" = (
/obj/mob_spawner/carp,
/turf/template_noop,
/area/debrisfield/explored)
"M" = (
/turf/simulated/shuttle/wall/hard_corner,
/area/debrisfield/explored)
"N" = (
/turf/template_noop,
/area/debrisfield/unexplored)
"O" = (
/obj/mob_spawner/carp,
/turf/template_noop,
/area/debrisfield/unexplored)
"P" = (
/obj/machinery/light/small,
/turf/simulated/floor/tiled/airless,
/area/debrisfield/explored)
"Q" = (
/turf/simulated/floor/tiled/airless,
/area/debrisfield/explored)
"S" = (
/obj/structure/shuttle/engine/heater{
	dir = 4
	},
/turf/simulated/shuttle/wall,
/area/debrisfield/explored)
"T" = (
/obj/random/outcrop,
/turf/simulated/mineral/floor/vacuum,
/area/debrisfield/explored)
"U" = (
/obj/machinery/sleep_console,
/turf/simulated/floor/tiled/airless,
/area/debrisfield/explored)
"V" = (
/obj/structure/table/rack,
/obj/item/reagent_containers/chem_disp_cartridge/dexalin_p,
/turf/simulated/floor/tiled/airless,
/area/debrisfield/explored)
"W" = (
/obj/structure/table/rack,
/obj/item/reagent_containers/chem_disp_cartridge/peridaxon,
/turf/simulated/floor/tiled/airless,
/area/debrisfield/explored)
"X" = (
/obj/machinery/light{
	dir = 4
	},
/turf/simulated/floor/tiled/airless,
/area/debrisfield/explored)
"Y" = (
/obj/structure/closet/secure_closet/sar{
	name = "sar locker";
	req_access = list()
	},
/obj/machinery/light{
	dir = 4
	},
/turf/simulated/floor/tiled/airless,
/area/debrisfield/explored)
"Z" = (
/obj/structure/bed/chair/shuttle{
	dir = 8
	},
/turf/simulated/floor/tiled/airless,
/area/debrisfield/explored)

(1,1,1) = {"
N
N
N
a
a
a
a
a
a
a
a
a
a
a
a
a
a
N
N
N
"}
(2,1,1) = {"
N
a
a
a
L
a
a
b
b
b
b
b
b
b
b
a
a
a
a
N
"}
(3,1,1) = {"
a
a
a
a
b
b
b
b
b
b
b
b
b
b
b
b
b
b
a
a
"}
(4,1,1) = {"
a
a
b
b
b
b
b
b
b
b
b
b
b
b
b
b
b
b
b
a
"}
(5,1,1) = {"
a
b
b
b
b
b
b
b
b
T
d
T
b
b
b
b
b
b
b
a
"}
(6,1,1) = {"
a
b
b
b
b
b
T
T
d
d
d
d
b
b
b
b
b
b
b
a
"}
(7,1,1) = {"
a
b
b
b
b
T
d
d
d
T
T
d
d
T
b
b
b
b
b
a
"}
(8,1,1) = {"
a
b
b
b
b
d
d
d
d
T
T
d
d
b
b
b
b
b
b
a
"}
(9,1,1) = {"
a
b
b
b
b
T
d
T
d
d
d
d
T
b
b
b
b
b
b
a
"}
(10,1,1) = {"
a
b
b
b
b
b
b
b
b
T
d
b
b
b
b
b
b
b
b
a
"}
(11,1,1) = {"
a
b
b
b
b
b
b
b
b
b
b
b
b
b
b
b
b
b
b
a
"}
(12,1,1) = {"
a
b
b
b
b
b
b
b
b
b
b
b
b
b
b
b
b
b
b
a
"}
(13,1,1) = {"
a
b
b
b
b
b
b
F
G
E
E
G
d
b
b
b
b
b
a
a
"}
(14,1,1) = {"
a
a
b
b
c
g
E
n
q
r
H
D
J
g
c
b
a
a
a
N
"}
(15,1,1) = {"
a
a
a
a
c
h
l
C
H
s
n
I
w
y
c
a
a
a
a
N
"}
(16,1,1) = {"
N
a
a
a
c
c
c
c
M
Z
Q
Z
K
z
c
a
a
a
a
N
"}
(17,1,1) = {"
N
a
a
a
c
i
m
o
c
c
t
c
c
c
c
a
a
a
N
N
"}
(18,1,1) = {"
N
O
a
a
c
f
Q
U
c
Q
Q
u
x
A
c
a
a
a
N
N
"}
(19,1,1) = {"
N
N
a
a
e
B
Q
Q
t
Q
Q
Q
Q
Q
e
a
a
N
N
N
"}
(20,1,1) = {"
N
N
a
a
e
Q
Q
Q
c
Q
X
Q
Q
Q
e
a
a
N
N
N
"}
(21,1,1) = {"
N
N
a
a
c
j
Y
p
c
t
c
v
V
W
c
a
a
N
N
N
"}
(22,1,1) = {"
N
N
a
a
c
S
S
S
c
P
c
S
S
S
c
a
a
N
N
N
"}
(23,1,1) = {"
N
O
a
a
c
k
k
k
M
t
M
k
k
k
c
a
N
N
O
N
"}
(24,1,1) = {"
N
N
N
a
a
a
a
a
a
a
a
a
a
a
a
a
N
N
N
N
"}
(25,1,1) = {"
N
N
N
N
N
a
a
a
a
a
a
a
a
a
a
a
N
N
N
N
"}
