//MAP CONVERTED BY dmm2tgm.py THIS HEADER COMMENT PREVENTS RECONVERSION, DO NOT REMOVE
"a" = (
/turf/space,
/area/debrisfield/explored)
"c" = (
/obj/structure/table/standard,
/obj/item/aiModule/tyrant,
/turf/simulated/floor/airless,
/area/debrisfield/explored)
"e" = (
/obj/random/mob/robotic/hivebot,
/obj/machinery/recharge_station,
/turf/simulated/floor/airless,
/area/debrisfield/explored)
"f" = (
/obj/structure/table/rack/shelf/steel,
/obj/fiftyspawner/rglass,
/obj/fiftyspawner/rglass,
/turf/simulated/floor/airless,
/area/debrisfield/explored)
"g" = (
/obj/machinery/atmospherics/pipe/tank/phoron{
	dir = 8;
	volume = 30000
	},
/turf/simulated/floor/airless,
/area/debrisfield/explored)
"h" = (
/mob/living/simple_mob/mechanical/hivebot/support/logistics,
/turf/simulated/floor/airless,
/area/debrisfield/explored)
"i" = (
/obj/machinery/door/airlock/vault/bolted,
/turf/simulated/floor/airless,
/area/debrisfield/explored)
"m" = (
/obj/random/mob/robotic/hivebot,
/turf/simulated/floor/airless,
/area/debrisfield/explored)
"n" = (
/obj/structure/table/rack/shelf/steel,
/obj/fiftyspawner/durasteel,
/turf/simulated/floor/airless,
/area/debrisfield/explored)
"p" = (
/obj/structure/shuttle/engine/heater{
	dir = 8
	},
/obj/machinery/atmospherics/pipe/simple/hidden{
	dir = 10
	},
/turf/simulated/shuttle/wall/voidcraft,
/area/debrisfield/explored)
"q" = (
/turf/simulated/floor/airless,
/area/debrisfield/explored)
"s" = (
/obj/machinery/power/smes/buildable{
	charge = 1.5e+007;
	cur_coils = 3
	},
/turf/simulated/floor/airless,
/area/debrisfield/explored)
"t" = (
/obj/structure/table/standard,
/obj/item/aiModule/oxygen,
/turf/simulated/floor/airless,
/area/debrisfield/explored)
"u" = (
/obj/machinery/telecomms/server/presets/unused,
/turf/simulated/floor/airless,
/area/debrisfield/explored)
"v" = (
/obj/machinery/telecomms/hub,
/turf/simulated/floor/airless,
/area/debrisfield/explored)
"x" = (
/obj/structure/table/rack/shelf/steel,
/obj/fiftyspawner/iron,
/obj/fiftyspawner/iron,
/obj/fiftyspawner/iron,
/obj/fiftyspawner/iron,
/turf/simulated/floor/airless,
/area/debrisfield/explored)
"z" = (
/obj/machinery/telecomms/broadcaster,
/turf/simulated/floor/airless,
/area/debrisfield/explored)
"A" = (
/obj/structure/shuttle/engine/heater{
	dir = 8
	},
/obj/machinery/atmospherics/pipe/manifold/hidden{
	dir = 4
	},
/turf/simulated/shuttle/wall/voidcraft,
/area/debrisfield/explored)
"B" = (
/turf/simulated/shuttle/wall/voidcraft,
/area/debrisfield/explored)
"C" = (
/mob/living/simple_mob/mechanical/hivebot/ranged_damage/ion,
/turf/simulated/floor/airless,
/area/debrisfield/explored)
"D" = (
/obj/machinery/atmospherics/pipe/simple/hidden{
	dir = 6
	},
/turf/simulated/floor/airless,
/area/debrisfield/explored)
"E" = (
/obj/machinery/porta_turret/poi,
/turf/simulated/floor/airless,
/area/debrisfield/explored)
"F" = (
/obj/machinery/atmospherics/pipe/manifold/hidden,
/turf/simulated/floor/airless,
/area/debrisfield/explored)
"G" = (
/obj/structure/table/standard,
/obj/item/stack/cable_coil,
/obj/item/stack/cable_coil,
/obj/item/stack/cable_coil,
/turf/simulated/floor/airless,
/area/debrisfield/explored)
"H" = (
/obj/machinery/atmospherics/binary/pump{
	dir = 8;
	name = "main fuel pump"
	},
/turf/simulated/floor/airless,
/area/debrisfield/explored)
"I" = (
/mob/living/simple_mob/mechanical/hivebot/support/commander/autofollow,
/turf/simulated/floor/airless,
/area/debrisfield/explored)
"K" = (
/turf/simulated/mineral/floor/vacuum,
/area/debrisfield/explored)
"L" = (
/obj/structure/shuttle/engine/propulsion{
	dir = 8
	},
/turf/space,
/area/debrisfield/explored)
"N" = (
/obj/structure/table/rack/shelf/steel,
/obj/fiftyspawner/gold,
/turf/simulated/floor/airless,
/area/debrisfield/explored)
"O" = (
/obj/structure/shuttle/engine/heater{
	dir = 8
	},
/obj/machinery/atmospherics/pipe/manifold/hidden,
/turf/simulated/shuttle/wall/voidcraft,
/area/debrisfield/explored)
"P" = (
/obj/structure/table/rack/shelf/steel,
/obj/fiftyspawner/phoron,
/obj/fiftyspawner/phoron,
/obj/fiftyspawner/phoron,
/obj/fiftyspawner/phoron,
/turf/simulated/floor/airless,
/area/debrisfield/explored)
"R" = (
/obj/structure/table/standard,
/obj/item/aiModule/antimov,
/turf/simulated/floor/airless,
/area/debrisfield/explored)
"S" = (
/obj/machinery/door/airlock/hatch,
/turf/simulated/floor/airless,
/area/debrisfield/explored)
"T" = (
/turf/simulated/mineral/vacuum,
/area/debrisfield/explored)
"U" = (
/obj/machinery/recharge_station,
/turf/simulated/floor/airless,
/area/debrisfield/explored)
"V" = (
/obj/structure/table/rack/shelf/steel,
/obj/fiftyspawner/uranium,
/turf/simulated/floor/airless,
/area/debrisfield/explored)
"W" = (
/obj/machinery/atmospherics/pipe/manifold/hidden{
	dir = 8
	},
/turf/simulated/floor/airless,
/area/debrisfield/explored)
"X" = (
/obj/machinery/power/port_gen/pacman{
	anchored = 1
	},
/turf/simulated/floor/airless,
/area/debrisfield/explored)
"Y" = (
/obj/machinery/shipsensors/weak,
/turf/simulated/floor/airless,
/area/debrisfield/explored)
"Z" = (
/turf/simulated/shuttle/wall/voidcraft/hard_corner,
/area/debrisfield/explored)

(1,1,1) = {"
T
T
T
T
T
a
a
a
a
a
a
a
a
T
T
T
T
T
a
a
"}
(2,1,1) = {"
T
Z
B
Z
T
a
a
a
T
T
a
T
T
T
Z
B
Z
T
T
a
"}
(3,1,1) = {"
T
B
V
B
T
T
T
T
T
T
a
T
T
Z
Z
s
Z
Z
T
T
"}
(4,1,1) = {"
T
B
i
Z
B
B
Z
T
T
T
a
T
T
B
s
q
s
B
T
T
"}
(5,1,1) = {"
T
B
q
q
m
N
B
T
T
a
a
a
T
Z
Z
q
Z
Z
T
T
"}
(6,1,1) = {"
T
Z
Z
f
q
P
B
T
a
a
a
a
a
T
B
q
B
T
T
T
"}
(7,1,1) = {"
T
T
B
x
q
n
B
T
a
a
a
a
a
T
B
q
B
T
T
a
"}
(8,1,1) = {"
a
T
B
h
q
q
B
T
L
L
L
L
L
T
B
m
B
T
T
a
"}
(9,1,1) = {"
a
T
Z
Z
B
S
Z
B
p
A
A
A
O
Z
Z
S
Z
Z
T
a
"}
(10,1,1) = {"
a
T
T
B
X
q
B
G
G
G
q
m
H
B
m
q
U
B
T
a
"}
(11,1,1) = {"
a
a
T
B
m
q
S
q
D
W
W
W
F
S
q
q
U
B
T
a
"}
(12,1,1) = {"
a
a
Y
B
X
q
B
C
g
g
g
g
g
B
q
q
U
B
T
a
"}
(13,1,1) = {"
a
T
T
B
m
q
Z
B
B
B
B
B
B
Z
q
q
U
B
T
a
"}
(14,1,1) = {"
T
T
T
B
X
q
B
q
q
q
q
q
q
S
q
q
q
B
T
a
"}
(15,1,1) = {"
T
T
T
Z
B
S
Z
B
m
q
q
q
m
B
U
q
U
B
T
a
"}
(16,1,1) = {"
T
T
Z
Z
q
q
q
B
B
B
S
S
B
Z
U
q
U
B
T
a
"}
(17,1,1) = {"
T
T
B
v
m
q
m
U
B
E
K
K
E
B
U
q
U
B
T
a
"}
(18,1,1) = {"
T
T
B
u
q
m
q
U
B
K
K
K
K
B
e
q
e
B
T
a
"}
(19,1,1) = {"
T
T
B
z
I
q
q
U
B
K
K
K
K
Z
B
B
B
Z
T
a
"}
(20,1,1) = {"
T
T
Z
Z
R
t
c
Z
Z
K
K
K
T
T
T
T
T
T
T
a
"}
(21,1,1) = {"
T
T
T
Z
B
B
B
Z
T
K
K
T
T
T
K
K
K
T
T
a
"}
(22,1,1) = {"
a
a
T
T
T
T
T
T
T
K
K
T
K
K
K
K
K
T
T
a
"}
(23,1,1) = {"
a
a
T
T
T
T
T
T
T
K
K
K
K
K
T
T
K
K
T
a
"}
(24,1,1) = {"
a
T
T
T
T
T
T
T
T
T
T
T
T
T
T
T
a
a
a
a
"}
(25,1,1) = {"
T
T
T
a
a
a
T
T
T
T
T
T
T
T
T
a
a
a
a
a
"}
