"aa" = (/turf/template_noop,/area/debrisfield/explored)
"ab" = (/turf/simulated/shuttle/wall,/area/debrisfield/explored)
"ac" = (/obj/structure/shuttle/engine/propulsion{dir = 1},/turf/simulated/shuttle/plating/airless,/area/debrisfield/explored)
"ad" = (/obj/structure/closet/crate/secure/engineering,/obj/item/tool/screwdriver/power,/obj/item/tool/crowbar/power,/obj/item/tool/screwdriver/power,/obj/item/tool/crowbar/power,/obj/effect/decal/cleanable/dirt,/turf/simulated/shuttle/plating/airless,/area/debrisfield/explored)
"ae" = (/obj/structure/closet/crate/trashcart,/turf/template_noop,/area/debrisfield/explored)
"af" = (/obj/structure/lattice,/obj/structure/girder/displaced,/turf/template_noop,/area/debrisfield/explored)
"ag" = (/obj/effect/decal/cleanable/dirt,/turf/simulated/shuttle/plating/airless,/area/debrisfield/explored)
"ah" = (/obj/structure/lattice,/turf/template_noop,/area/debrisfield/explored)
"ai" = (/turf/simulated/shuttle/plating/airless,/area/debrisfield/explored)
"aj" = (/turf/simulated/shuttle/floor/white/airless,/area/debrisfield/explored)
"ak" = (/obj/effect/decal/cleanable/dirt,/obj/item/material/shard/shrapnel,/turf/simulated/shuttle/plating/airless,/area/debrisfield/explored)
"al" = (/obj/structure/ghost_pod/manual/lost_drone/dogborg,/turf/simulated/shuttle/floor/airless,/area/debrisfield/explored)
"am" = (/obj/effect/decal/cleanable/dirt,/obj/effect/decal/cleanable/blood/oil,/turf/simulated/shuttle/plating/airless,/area/debrisfield/explored)
"an" = (/obj/structure/girder/displaced,/turf/template_noop,/area/debrisfield/explored)
"ao" = (/obj/structure/girder/displaced,/turf/simulated/shuttle/floor/white/airless,/area/debrisfield/explored)
"ap" = (/obj/effect/decal/cleanable/dirt,/obj/effect/decal/cleanable/generic,/turf/simulated/shuttle/plating/airless,/area/debrisfield/explored)
"aq" = (/obj/item/stack/material/steel,/obj/effect/decal/cleanable/dirt,/turf/simulated/shuttle/plating/airless,/area/debrisfield/explored)
"ar" = (/obj/item/inflatable/torn,/turf/simulated/shuttle/floor/white/airless,/area/debrisfield/explored)
"as" = (/obj/structure/shuttle/window,/obj/structure/grille,/turf/simulated/shuttle/plating/airless,/area/debrisfield/explored)
"at" = (/obj/item/inflatable/door/torn,/turf/simulated/shuttle/floor/white/airless,/area/debrisfield/explored)
"au" = (/obj/structure/inflatable,/turf/simulated/shuttle/floor/white/airless,/area/debrisfield/explored)
"av" = (/obj/structure/door_assembly/door_assembly_com{anchored = 1},/turf/simulated/shuttle/floor/white/airless,/area/debrisfield/explored)
"aw" = (/obj/structure/lattice,/obj/item/stack/material/steel,/turf/template_noop,/area/debrisfield/explored)
"ax" = (/obj/structure/lattice,/obj/item/stack/material/steel,/obj/item/material/shard/shrapnel,/turf/template_noop,/area/debrisfield/explored)
"ay" = (/obj/item/stack/rods,/turf/template_noop,/area/debrisfield/explored)
"az" = (/obj/structure/girder,/turf/simulated/shuttle/floor/white/airless,/area/debrisfield/explored)
"aA" = (/turf/simulated/shuttle/floor/airless,/area/debrisfield/explored)
"aB" = (/obj/structure/girder,/obj/effect/decal/cleanable/dirt,/turf/simulated/shuttle/plating/airless,/area/debrisfield/explored)
"aC" = (/turf/template_noop,/area/debrisfield/unexplored)
"aD" = (/obj/structure/girder/displaced,/obj/effect/decal/cleanable/dirt,/turf/simulated/shuttle/plating/airless,/area/debrisfield/explored)
"aE" = (/obj/structure/lattice,/obj/effect/decal/cleanable/molten_item,/turf/template_noop,/area/debrisfield/explored)
"aF" = (/obj/structure/closet/crate/secure/engineering,/obj/item/weldingtool/experimental,/obj/item/weldingtool/electric,/obj/item/weldingtool/electric,/turf/template_noop,/area/debrisfield/explored)
"aG" = (/obj/item/material/shard/shrapnel,/turf/template_noop,/area/debrisfield/explored)
"aH" = (/obj/structure/lattice,/obj/structure/closet/crate/secure/engineering,/obj/fiftyspawner/plasteel,/turf/template_noop,/area/debrisfield/explored)
"aJ" = (/obj/structure/grille,/obj/item/material/shard,/obj/effect/decal/cleanable/dirt,/turf/simulated/shuttle/plating/airless,/area/debrisfield/explored)
"aK" = (/obj/item/material/shard,/obj/effect/decal/cleanable/dirt,/turf/simulated/shuttle/plating/airless,/area/debrisfield/explored)
"aL" = (/obj/item/inflatable/torn,/obj/effect/decal/remains,/obj/item/clothing/under/rank/cargotech,/obj/item/clothing/head/soft,/turf/simulated/shuttle/floor/white/airless,/area/debrisfield/explored)
"aM" = (/obj/structure/closet/secure_closet/cargotech{name = "cargotech locker"; req_access = list()},/obj/item/pickaxe/diamonddrill,/turf/simulated/shuttle/floor/airless,/area/debrisfield/explored)
"aN" = (/obj/structure/closet/emcloset,/turf/simulated/shuttle/floor/airless,/area/debrisfield/explored)
"aO" = (/obj/item/inflatable/door/torn,/obj/effect/decal/remains,/obj/item/clothing/under/rank/cargotech,/obj/item/clothing/head/soft,/turf/simulated/shuttle/floor/white/airless,/area/debrisfield/explored)
"aP" = (/obj/machinery/computer/shuttle{dir = 4},/turf/simulated/shuttle/floor/airless,/area/debrisfield/explored)
"aQ" = (/obj/structure/bed/chair{dir = 8},/turf/simulated/shuttle/floor/white/airless,/area/debrisfield/explored)
"aR" = (/obj/structure/closet/secure_closet/quartermaster{name = "quartermaster locker"; req_access = list()},/obj/item/clothing/under/mbill,/obj/item/clothing/head/soft/mbill,/turf/simulated/shuttle/floor/white/airless,/area/debrisfield/explored)
"aS" = (/obj/structure/closet/crate/secure/bin,/turf/simulated/shuttle/floor/white/airless,/area/debrisfield/explored)
"aT" = (/obj/structure/closet/emcloset,/obj/mob_spawner/derelict/corrupt_maint_swarm,/turf/simulated/shuttle/floor/white/airless,/area/debrisfield/explored)
"aU" = (/obj/structure/bed/chair{dir = 4},/turf/simulated/shuttle/floor/white/airless,/area/debrisfield/explored)
"aV" = (/obj/machinery/computer/shuttle{dir = 8},/turf/simulated/shuttle/floor/airless,/area/debrisfield/explored)
"aW" = (/obj/effect/decal/remains,/obj/item/clothing/under/mbill,/obj/item/clothing/head/soft/mbill,/turf/simulated/shuttle/floor/white/airless,/area/debrisfield/explored)
"aX" = (/obj/structure/bed/chair,/turf/simulated/shuttle/floor/airless,/area/debrisfield/explored)
"aY" = (/obj/structure/bed/chair/comfy/teal,/turf/simulated/shuttle/floor/white/airless,/area/debrisfield/explored)
"aZ" = (/obj/machinery/computer/shuttle{dir = 1},/turf/simulated/shuttle/floor/airless,/area/debrisfield/explored)
"bb" = (/obj/structure/lattice,/obj/item/material/shard/shrapnel,/turf/template_noop,/area/debrisfield/explored)
"bc" = (/obj/structure/lattice,/obj/effect/decal/cleanable/molten_item,/obj/item/material/shard/shrapnel,/turf/template_noop,/area/debrisfield/explored)
"bd" = (/turf/simulated/shuttle/wall/hard_corner,/area/debrisfield/explored)
"jk" = (/obj/machinery/giga_drill,/obj/machinery/mech_recharger,/turf/simulated/shuttle/floor/airless,/area/debrisfield/explored)
"jw" = (/obj/machinery/light/small/flicker{dir = 1},/turf/simulated/shuttle/floor/airless,/area/debrisfield/explored)
"uZ" = (/obj/machinery/light/flicker,/turf/simulated/shuttle/floor/airless,/area/debrisfield/explored)
"wb" = (/obj/effect/gibspawner/human,/turf/simulated/shuttle/floor/white/airless,/area/debrisfield/explored)
"xK" = (/obj/structure/shuttle/engine/heater{dir = 1},/turf/simulated/shuttle/wall,/area/debrisfield/explored)
"HF" = (/obj/mob_spawner/derelict/corrupt_maint_swarm,/turf/simulated/shuttle/floor/airless,/area/debrisfield/explored)
"Mp" = (/obj/machinery/light/small/flicker,/turf/simulated/shuttle/floor/white/airless,/area/debrisfield/explored)
"NO" = (/obj/mob_spawner/derelict/corrupt_maint_swarm,/turf/simulated/shuttle/floor/white/airless,/area/debrisfield/explored)
"TF" = (/obj/effect/decal/cleanable/dirt,/obj/machinery/light/small/flicker{dir = 8},/turf/simulated/shuttle/plating/airless,/area/debrisfield/explored)
"Xh" = (/obj/structure/shuttle/engine/heater{dir = 1},/turf/simulated/shuttle/wall/hard_corner,/area/debrisfield/explored)
"Zl" = (/obj/item/inflatable/torn,/obj/machinery/light/flicker{dir = 8},/turf/simulated/shuttle/floor/white/airless,/area/debrisfield/explored)

(1,1,1) = {"
aaaaaaaaaaaaaaaaaaaaaaaaaaaaaa
aaabacaaaaaaaaaaaaaaaaaaaaaaaa
aaabXhaBaaacaeaaaaacacacacabaa
aaabTFagafXhxKaDxKxKxKxKxKbdaa
aaabadamaaamamahahapaqjwaAaBaa
aaagamahaaahaxaaahahagaDaAaBaa
aaakbbawaaaaahaaaaaGbbahagaDaa
aaaaaabcaaawahaaaaaFaaaaagagaa
aaaaaaaaaaaaaaaaaaaaaaayahagaa
aaaaahaaaaaaaaaaaaaaaaaaahaBaa
aaahahaaaGaaanaaaaaGaGagagaBaa
aabbahaaaaaaahahahaEagagagaBaa
aaahahaHaybbahahagapaqagamabaa
aaahahahahahamagagagagabababaa
aaaBapahagagagapNOaoaoajalabaa
aaaJaKaiaBagarajarajajwbjkasaa
aaasHFajabZlaLatauarazajaMasaa
aaabaNMpabauauaOauauabMpaMabaa
aaababababababavababababababaa
aaasaPaQajaRajajaSaTajaUaVasaa
aaasaPaQwbajajajajajajaUaVasaa
aaababuZajNOajajwbajNOuZababaa
aaaaabbdaAajajaWajajaAbdabaaaa
aaaaaaababaXajaYajaXababaaaaaa
aCaaaaaaasaZaZaZaZaZasaaaaaaaC
aCaaaaaaabasasasasasabaaaaaaaC
aCaCaaaaaaaaaaaaaaaaaaaaaaaCaC
aCaCaCaaaaaaaaaaaaaaaaaaaCaCaC
"}
