//MAP CONVERTED BY dmm2tgm.py THIS HEADER COMMENT PREVENTS RECONVERSION, DO NOT REMOVE
"a" = (
/turf/template_noop,
/area/space/debrisfield/explored)
"b" = (
/turf/simulated/mineral/vacuum,
/area/space/debrisfield/asteroids/rocks)
"c" = (
/turf/simulated/shuttle/wall,
/area/space/debrisfield/medshuttlecrash)
"d" = (
/turf/simulated/mineral/floor/vacuum,
/area/space/debrisfield/medshuttlecrash)
"e" = (
/obj/structure/shuttle/window,
/obj/structure/grille,
/turf/simulated/shuttle/plating/airless,
/area/space/debrisfield/medshuttlecrash)
"f" = (
/turf/simulated/shuttle/floor/airless,
/area/space/debrisfield/medshuttlecrash)
"g" = (
/obj/effect/debris/cleanable/generic,
/turf/simulated/mineral/floor/vacuum,
/area/space/debrisfield/medshuttlecrash)
"h" = (
/obj/effect/debris/cleanable/dirt,
/obj/structure/frame,
/turf/simulated/shuttle/plating/airless,
/area/space/debrisfield/medshuttlecrash)
"i" = (
/obj/structure/frame,
/turf/simulated/shuttle/floor/airless,
/area/space/debrisfield/medshuttlecrash)
"j" = (
/obj/structure/closet/secure_closet/sar{
	name = "sar locker";
	req_access = list()
	},
/turf/simulated/shuttle/floor/airless,
/area/space/debrisfield/medshuttlecrash)
"k" = (
/obj/structure/shuttle/engine/propulsion{
	dir = 4
	},
/turf/simulated/shuttle/plating/airless,
/area/space/debrisfield/medshuttlecrash)
"l" = (
/obj/effect/debris/cleanable/dirt,
/turf/simulated/shuttle/plating/airless,
/area/space/debrisfield/medshuttlecrash)
"m" = (
/obj/structure/table/standard,
/obj/random/unidentified_medicine/fresh_medicine,
/obj/random/unidentified_medicine/fresh_medicine,
/obj/random/unidentified_medicine/old_medicine,
/obj/random/firstaid,
/turf/simulated/shuttle/floor/airless,
/area/space/debrisfield/medshuttlecrash)
"n" = (
/obj/effect/debris/cleanable/dirt,
/obj/effect/debris/cleanable/generic,
/turf/simulated/shuttle/plating/airless,
/area/space/debrisfield/medshuttlecrash)
"o" = (
/obj/structure/table/standard,
/obj/random/unidentified_medicine/fresh_medicine,
/obj/random/unidentified_medicine/fresh_medicine,
/obj/random/unidentified_medicine/viral,
/turf/simulated/shuttle/floor/airless,
/area/space/debrisfield/medshuttlecrash)
"p" = (
/obj/structure/closet/secure_closet/medical3{
	name = "medical locker";
	req_access = list()
	},
/turf/simulated/shuttle/floor/airless,
/area/space/debrisfield/medshuttlecrash)
"q" = (
/obj/effect/debris/cleanable/dirt,
/obj/effect/debris/cleanable/molten_item,
/turf/simulated/shuttle/plating/airless,
/area/space/debrisfield/medshuttlecrash)
"r" = (
/obj/effect/debris/cleanable/dirt,
/obj/effect/debris/cleanable/blood/oil,
/turf/simulated/shuttle/plating/airless,
/area/space/debrisfield/medshuttlecrash)
"s" = (
/obj/effect/debris/cleanable/dirt,
/obj/effect/decal/remains/posi,
/turf/simulated/shuttle/plating/airless,
/area/space/debrisfield/medshuttlecrash)
"t" = (
/obj/machinery/door/unpowered/shuttle,
/turf/simulated/shuttle/floor/airless,
/area/space/debrisfield/medshuttlecrash)
"u" = (
/obj/structure/closet/emcloset,
/turf/simulated/shuttle/floor/airless,
/area/space/debrisfield/medshuttlecrash)
"v" = (
/obj/structure/table/rack,
/obj/item/reagent_containers/chem_disp_cartridge/clonexadone,
/turf/simulated/shuttle/floor/airless,
/area/space/debrisfield/medshuttlecrash)
"w" = (
/obj/effect/debris/cleanable/generic,
/turf/simulated/shuttle/floor/airless,
/area/space/debrisfield/medshuttlecrash)
"x" = (
/obj/structure/dispenser/oxygen{
	oxygentanks = 7
	},
/turf/simulated/shuttle/floor/airless,
/area/space/debrisfield/medshuttlecrash)
"y" = (
/obj/effect/debris/cleanable/blood/oil,
/turf/simulated/shuttle/floor/airless,
/area/space/debrisfield/medshuttlecrash)
"z" = (
/obj/structure/frame/computer{
	dir = 1
	},
/turf/simulated/shuttle/floor/airless,
/area/space/debrisfield/medshuttlecrash)
"A" = (
/obj/machinery/suit_cycler/medical,
/turf/simulated/shuttle/floor/airless,
/area/space/debrisfield/medshuttlecrash)
"B" = (
/mob/living/bot/medibot{
	name = "Dr. Crusty"
	},
/turf/simulated/shuttle/floor/airless,
/area/space/debrisfield/medshuttlecrash)
"C" = (
/obj/effect/debris/cleanable/dirt,
/obj/random/firstaid,
/turf/simulated/shuttle/plating/airless,
/area/space/debrisfield/medshuttlecrash)
"D" = (
/obj/effect/debris/cleanable/dirt,
/obj/item/storage/firstaid/adv,
/turf/simulated/shuttle/plating/airless,
/area/space/debrisfield/medshuttlecrash)
"E" = (
/obj/item/material/shard/shrapnel,
/turf/simulated/mineral/floor/vacuum,
/area/space/debrisfield/medshuttlecrash)
"F" = (
/obj/item/stack/material/steel,
/turf/simulated/mineral/floor/vacuum,
/area/space/debrisfield/medshuttlecrash)
"G" = (
/obj/item/stack/rods,
/turf/simulated/mineral/floor/vacuum,
/area/space/debrisfield/medshuttlecrash)
"H" = (
/obj/effect/debris/cleanable/dirt,
/obj/item/stack/material/steel,
/turf/simulated/shuttle/plating/airless,
/area/space/debrisfield/medshuttlecrash)
"I" = (
/obj/effect/debris/cleanable/dirt,
/obj/item/stack/rods,
/turf/simulated/shuttle/plating/airless,
/area/space/debrisfield/medshuttlecrash)
"J" = (
/obj/effect/debris/cleanable/dirt,
/obj/item/material/shard/shrapnel,
/turf/simulated/shuttle/plating/airless,
/area/space/debrisfield/medshuttlecrash)
"K" = (
/obj/item/material/shard/shrapnel,
/turf/simulated/shuttle/floor/airless,
/area/space/debrisfield/medshuttlecrash)
"L" = (
/obj/mob_spawner/carp,
/turf/template_noop,
/area/space/debrisfield/medshuttlecrash)
"M" = (
/turf/simulated/shuttle/wall/hard_corner,
/area/space/debrisfield/medshuttlecrash)
"V" = (
/obj/structure/table/rack,
/obj/item/reagent_containers/chem_disp_cartridge/dexalin_p,
/turf/simulated/shuttle/floor/airless,
/area/space/debrisfield/medshuttlecrash)
"W" = (
/obj/structure/table/rack,
/obj/item/reagent_containers/chem_disp_cartridge/peridaxon,
/turf/simulated/shuttle/floor/airless,
/area/space/debrisfield/medshuttlecrash)

(1,1,1) = {"
a
a
a
a
a
a
a
a
a
a
a
a
a
a
a
a
a
a
a
a
"}
(2,1,1) = {"
a
a
a
a
L
a
a
b
b
b
b
b
b
b
b
a
a
a
a
a
"}
(3,1,1) = {"
a
a
a
a
b
b
b
b
b
b
b
b
b
b
b
b
b
b
a
a
"}
(4,1,1) = {"
a
a
b
b
b
b
b
b
b
b
b
b
b
b
b
b
b
b
b
a
"}
(5,1,1) = {"
a
b
b
b
b
b
b
b
b
b
b
b
b
b
b
b
b
b
b
a
"}
(6,1,1) = {"
a
b
b
b
b
b
b
b
b
b
b
b
b
b
b
b
b
b
b
a
"}
(7,1,1) = {"
a
b
b
b
b
b
b
b
b
b
b
b
b
b
b
b
b
b
b
a
"}
(8,1,1) = {"
a
b
b
b
b
b
b
b
b
b
b
b
b
b
b
b
b
b
b
a
"}
(9,1,1) = {"
a
b
b
b
b
b
b
b
b
b
b
b
b
b
b
b
b
b
b
a
"}
(10,1,1) = {"
a
b
b
b
b
b
b
b
b
b
b
b
b
b
b
b
b
b
b
a
"}
(11,1,1) = {"
a
b
b
b
b
b
b
b
b
b
b
b
b
b
b
b
b
b
b
a
"}
(12,1,1) = {"
a
b
b
b
b
b
b
b
b
b
b
b
b
b
b
b
b
b
b
a
"}
(13,1,1) = {"
a
b
b
b
b
b
b
F
G
E
E
G
d
b
b
b
b
b
a
a
"}
(14,1,1) = {"
a
a
b
b
c
g
E
n
q
r
H
D
J
g
c
b
a
a
a
a
"}
(15,1,1) = {"
a
a
a
a
c
h
l
C
H
s
n
I
w
y
c
a
a
a
a
a
"}
(16,1,1) = {"
a
a
a
a
c
c
c
c
M
f
f
f
K
z
c
a
a
a
a
a
"}
(17,1,1) = {"
a
a
a
a
c
i
m
o
c
f
f
c
c
c
c
a
a
a
a
a
"}
(18,1,1) = {"
a
L
a
a
c
f
f
f
f
f
f
u
x
A
c
a
a
a
a
a
"}
(19,1,1) = {"
a
a
a
a
e
B
f
f
c
f
f
f
f
f
e
a
a
a
a
a
"}
(20,1,1) = {"
a
a
a
a
e
f
f
f
c
f
f
f
f
f
e
a
a
a
a
a
"}
(21,1,1) = {"
a
a
a
a
c
j
j
p
c
t
c
v
V
W
c
a
a
a
a
a
"}
(22,1,1) = {"
a
a
a
a
c
c
c
c
c
f
c
c
c
c
c
a
a
a
a
a
"}
(23,1,1) = {"
a
L
a
a
c
k
k
k
M
t
M
k
k
k
c
a
a
a
L
a
"}
(24,1,1) = {"
a
a
a
a
a
a
a
a
a
a
a
a
a
a
a
a
a
a
a
a
"}
(25,1,1) = {"
a
a
a
a
a
a
a
a
a
a
a
a
a
a
a
a
a
a
a
a
"}
