"a" = (/turf/template_noop,/area/debrisfield/explored)
"b" = (/turf/simulated/mineral/vacuum,/area/debrisfield/explored)
"c" = (/turf/simulated/shuttle/wall,/area/debrisfield/explored)
"d" = (/turf/simulated/mineral/floor/vacuum,/area/debrisfield/explored)
"e" = (/obj/structure/shuttle/window,/obj/structure/grille,/turf/simulated/shuttle/plating/airless,/area/debrisfield/explored)
"f" = (/obj/structure/table/standard,/obj/random/unidentified_medicine/fresh_medicine,/obj/random/unidentified_medicine/fresh_medicine,/obj/random/unidentified_medicine/old_medicine,/obj/random/firstaid,/turf/simulated/floor/tiled/airless,/area/debrisfield/explored)
"g" = (/obj/effect/decal/cleanable/generic,/turf/simulated/mineral/floor/vacuum,/area/debrisfield/explored)
"h" = (/obj/effect/decal/cleanable/dirt,/obj/structure/frame,/turf/simulated/shuttle/plating/airless,/area/debrisfield/explored)
"i" = (/obj/structure/table/standard,/obj/random/unidentified_medicine/fresh_medicine,/obj/random/unidentified_medicine/fresh_medicine,/obj/random/unidentified_medicine/viral,/turf/simulated/floor/tiled/airless,/area/debrisfield/explored)
"j" = (/obj/structure/closet/secure_closet/sar{name = "sar locker"; req_access = list()},/turf/simulated/floor/tiled/airless,/area/debrisfield/explored)
"k" = (/obj/structure/shuttle/engine/propulsion{dir = 4},/turf/simulated/shuttle/plating/airless,/area/debrisfield/explored)
"l" = (/obj/effect/decal/cleanable/dirt,/turf/simulated/shuttle/plating/airless,/area/debrisfield/explored)
"m" = (/obj/structure/closet/walllocker/emerglocker{pixel_x = -32},/obj/machinery/light{dir = 8},/turf/simulated/floor/tiled/airless,/area/debrisfield/explored)
"n" = (/obj/effect/decal/cleanable/dirt,/obj/effect/decal/cleanable/generic,/turf/simulated/shuttle/plating/airless,/area/debrisfield/explored)
"o" = (/obj/machinery/sleeper{dir = 8},/turf/simulated/floor/tiled/airless,/area/debrisfield/explored)
"p" = (/obj/structure/closet/secure_closet/medical3{name = "medical locker"; req_access = list()},/turf/simulated/floor/tiled/airless,/area/debrisfield/explored)
"q" = (/obj/effect/decal/cleanable/dirt,/obj/effect/decal/cleanable/molten_item,/turf/simulated/shuttle/plating/airless,/area/debrisfield/explored)
"r" = (/obj/effect/decal/cleanable/dirt,/obj/effect/decal/cleanable/blood/oil,/turf/simulated/shuttle/plating/airless,/area/debrisfield/explored)
"s" = (/obj/effect/decal/cleanable/dirt,/obj/effect/decal/remains/posi,/turf/simulated/shuttle/plating/airless,/area/debrisfield/explored)
"t" = (/obj/machinery/door/unpowered/shuttle,/turf/simulated/floor/tiled/airless,/area/debrisfield/explored)
"u" = (/obj/structure/closet/emcloset,/turf/simulated/floor/tiled/airless,/area/debrisfield/explored)
"v" = (/obj/structure/table/rack,/obj/item/reagent_containers/chem_disp_cartridge/clonexadone,/turf/simulated/floor/tiled/airless,/area/debrisfield/explored)
"w" = (/obj/effect/decal/cleanable/generic,/turf/simulated/floor/tiled/airless,/area/debrisfield/explored)
"x" = (/obj/structure/dispenser/oxygen{oxygentanks = 7},/turf/simulated/floor/tiled/airless,/area/debrisfield/explored)
"y" = (/obj/effect/decal/cleanable/blood/oil,/turf/simulated/floor/tiled/airless,/area/debrisfield/explored)
"z" = (/obj/structure/frame/computer{dir = 1},/turf/simulated/floor/tiled/airless,/area/debrisfield/explored)
"A" = (/obj/machinery/suit_cycler/medical,/turf/simulated/floor/tiled/airless,/area/debrisfield/explored)
"B" = (/mob/living/bot/medbot{name = "Dr. Crusty"},/turf/simulated/floor/tiled/airless,/area/debrisfield/explored)
"C" = (/obj/effect/decal/cleanable/dirt,/obj/random/firstaid,/turf/simulated/shuttle/plating/airless,/area/debrisfield/explored)
"D" = (/obj/effect/decal/cleanable/dirt,/obj/item/storage/firstaid/adv,/turf/simulated/shuttle/plating/airless,/area/debrisfield/explored)
"E" = (/obj/item/material/shard/shrapnel,/turf/simulated/mineral/floor/vacuum,/area/debrisfield/explored)
"F" = (/obj/item/stack/material/steel,/turf/simulated/mineral/floor/vacuum,/area/debrisfield/explored)
"G" = (/obj/item/stack/rods,/turf/simulated/mineral/floor/vacuum,/area/debrisfield/explored)
"H" = (/obj/effect/decal/cleanable/dirt,/obj/item/stack/material/steel,/turf/simulated/shuttle/plating/airless,/area/debrisfield/explored)
"I" = (/obj/effect/decal/cleanable/dirt,/obj/item/stack/rods,/turf/simulated/shuttle/plating/airless,/area/debrisfield/explored)
"J" = (/obj/effect/decal/cleanable/dirt,/obj/item/material/shard/shrapnel,/turf/simulated/shuttle/plating/airless,/area/debrisfield/explored)
"K" = (/obj/item/material/shard/shrapnel,/obj/machinery/light{dir = 4},/turf/simulated/floor/tiled/airless,/area/debrisfield/explored)
"L" = (/obj/mob_spawner/carp,/turf/template_noop,/area/debrisfield/explored)
"M" = (/turf/simulated/shuttle/wall/hard_corner,/area/debrisfield/explored)
"N" = (/turf/template_noop,/area/debrisfield/unexplored)
"O" = (/obj/mob_spawner/carp,/turf/template_noop,/area/debrisfield/unexplored)
"P" = (/obj/machinery/light/small,/turf/simulated/floor/tiled/airless,/area/debrisfield/explored)
"Q" = (/turf/simulated/floor/tiled/airless,/area/debrisfield/explored)
"S" = (/obj/structure/shuttle/engine/heater{dir = 4},/turf/simulated/shuttle/wall,/area/debrisfield/explored)
"U" = (/obj/machinery/sleep_console,/turf/simulated/floor/tiled/airless,/area/debrisfield/explored)
"V" = (/obj/structure/table/rack,/obj/item/reagent_containers/chem_disp_cartridge/dexalin_p,/turf/simulated/floor/tiled/airless,/area/debrisfield/explored)
"W" = (/obj/structure/table/rack,/obj/item/reagent_containers/chem_disp_cartridge/peridaxon,/turf/simulated/floor/tiled/airless,/area/debrisfield/explored)
"X" = (/obj/machinery/light{dir = 4},/turf/simulated/floor/tiled/airless,/area/debrisfield/explored)
"Y" = (/obj/structure/closet/secure_closet/sar{name = "sar locker"; req_access = list()},/obj/machinery/light{dir = 4},/turf/simulated/floor/tiled/airless,/area/debrisfield/explored)
"Z" = (/obj/structure/bed/chair/shuttle{dir = 8},/turf/simulated/floor/tiled/airless,/area/debrisfield/explored)

(1,1,1) = {"
NNaaaaaaaaaaaaaNNNNNNNNNN
NaaabbbbbbbbbaaaaONNNNONN
Naabbbbbbbbbbbaaaaaaaaaaa
aaabbbbbbbbbbbaaaaaaaaaaa
aLbbbbbbbbbbbccccceecccaa
aabbbbbbbbbbbghcifBQjSkaa
aabbbbbbbbbbbElcmQQQYSkaa
abbbbbbbbbbbFnCcoUQQpSkaa
abbbbbbbbbbbGqHMcctcccMaa
abbbbbbbbbbbErsZcQQQtPtaa
abbbbbbbbbbbEHnQtQQXccMaa
abbbbbbbbbbbGDIZcuQQvSkaa
abbbbbbbbbbbdJwKcxQQVSkaa
abbbbbbbbbbbbgyzcAQQWSkaa
abbbbbbbbbbbbccccceecccaa
aabbbbbbbbbbbbaaaaaaaaaaa
aabbbbbbbbbbbaaaaaaaaaaaa
NabbbbbbbbbbbaaaaaaaaaaaN
NaabbbbbbbbbaaaaaNNNNNONN
NNaaaaaaaaaaaaaaNNNNNNNNN
"}
