//MAP CONVERTED BY dmm2tgm.py THIS HEADER COMMENT PREVENTS RECONVERSION, DO NOT REMOVE
"aa" = (
/turf/template_noop,
/area/space/debrisfield/explored)
"ab" = (
/turf/simulated/wall/thull,
/area/space/debrisfield/scioverrun)
"ac" = (
/turf/simulated/floor/airless,
/area/space/debrisfield/scioverrun)
"ad" = (
/turf/simulated/floor/tiled/white/airless,
/area/space/debrisfield/scioverrun)
"ae" = (
/obj/machinery/portable_atmospherics/hydroponics,
/turf/simulated/floor/tiled/white/airless,
/area/space/debrisfield/scioverrun)
"af" = (
/obj/machinery/botany/editor,
/turf/simulated/floor/tiled/white/airless,
/area/space/debrisfield/scioverrun)
"ag" = (
/obj/machinery/vending/hydronutrients,
/turf/simulated/floor/tiled/white/airless,
/area/space/debrisfield/scioverrun)
"ah" = (
/obj/machinery/seed_extractor,
/turf/simulated/floor/tiled/white/airless,
/area/space/debrisfield/scioverrun)
"ai" = (
/obj/machinery/seed_storage/xenobotany,
/turf/simulated/floor/tiled/white/airless,
/area/space/debrisfield/scioverrun)
"aj" = (
/obj/machinery/botany/extractor,
/turf/simulated/floor/tiled/white/airless,
/area/space/debrisfield/scioverrun)
"ak" = (
/obj/item/seeds/killertomatoseed,
/turf/simulated/floor/tiled/white/airless,
/area/space/debrisfield/scioverrun)
"al" = (
/obj/structure/railing,
/turf/simulated/floor/tiled/white/airless,
/area/space/debrisfield/scioverrun)
"am" = (
/obj/structure/railing{
	dir = 4
	},
/turf/simulated/floor/tiled/white/airless,
/area/space/debrisfield/scioverrun)
"an" = (
/obj/structure/reagent_dispensers/watertank/high,
/turf/simulated/floor/tiled/white/airless,
/area/space/debrisfield/scioverrun)
"ao" = (
/obj/structure/railing{
	dir = 8
	},
/turf/simulated/floor/tiled/white/airless,
/area/space/debrisfield/scioverrun)
"ap" = (
/obj/structure/table/rack,
/obj/item/shovel/spade,
/obj/item/shovel/spade,
/obj/item/material/minihoe,
/obj/item/material/minihoe,
/obj/item/material/knife/machete/hatchet,
/obj/item/material/knife/machete/hatchet,
/obj/item/reagent_containers/glass/bucket,
/obj/item/reagent_containers/glass/bucket,
/obj/item/analyzer/plant_analyzer,
/obj/item/analyzer/plant_analyzer,
/turf/simulated/floor/tiled/white/airless,
/area/space/debrisfield/scioverrun)
"aq" = (
/obj/structure/railing{
	dir = 1
	},
/turf/simulated/floor/tiled/white/airless,
/area/space/debrisfield/scioverrun)
"ar" = (
/mob/living/simple_mob/hostile/tomato/space,
/turf/simulated/floor/tiled/white/airless,
/area/space/debrisfield/scioverrun)
"as" = (
/obj/structure/table/rack,
/obj/random/tool,
/obj/random/tool,
/obj/random/tool,
/turf/simulated/floor/airless,
/area/space/debrisfield/scioverrun)
"at" = (
/obj/machinery/door/airlock/science{
	req_one_access = list(0)
	},
/turf/simulated/floor/tiled/white/airless,
/area/space/debrisfield/scioverrun)
"au" = (
/obj/item/clothing/head/collectable/slime,
/turf/simulated/floor/tiled/white/airless,
/area/space/debrisfield/scioverrun)
"av" = (
/obj/structure/sign/hydro,
/turf/simulated/wall/thull,
/area/space/debrisfield/scioverrun)
"aw" = (
/obj/structure/closet/firecloset,
/turf/simulated/floor/tiled/white/airless,
/area/space/debrisfield/scioverrun)
"ax" = (
/obj/machinery/door/airlock/maintenance/rnd{
	name = "Research Airlock";
	req_one_access = list(0)
	},
/turf/simulated/floor/airless,
/area/space/debrisfield/scioverrun)
"ay" = (
/obj/structure/sign/xenobio,
/turf/simulated/wall/thull,
/area/space/debrisfield/scioverrun)
"az" = (
/obj/item/slime_scanner,
/obj/item/slime_scanner,
/obj/structure/table/reinforced,
/turf/simulated/floor/tiled/white/airless,
/area/space/debrisfield/scioverrun)
"aA" = (
/obj/structure/table/reinforced,
/obj/item/gun/energy/taser/xeno,
/obj/item/melee/baton/slime/loaded,
/turf/simulated/floor/tiled/white/airless,
/area/space/debrisfield/scioverrun)
"aB" = (
/obj/structure/table/reinforced,
/obj/item/reagent_containers/chem_disp_cartridge/plantbgone,
/turf/simulated/floor/tiled/white/airless,
/area/space/debrisfield/scioverrun)
"aC" = (
/obj/structure/table/reinforced,
/obj/item/reagent_containers/food/snacks/monkeycube,
/obj/item/reagent_containers/food/snacks/monkeycube/farwacube,
/obj/item/reagent_containers/food/snacks/monkeycube/neaeracube,
/obj/item/reagent_containers/food/snacks/monkeycube/sarucube,
/obj/item/reagent_containers/food/snacks/monkeycube/sobakacube,
/obj/item/reagent_containers/food/snacks/monkeycube/sparracube,
/obj/item/reagent_containers/food/snacks/monkeycube/stokcube,
/obj/item/reagent_containers/food/snacks/monkeycube/wolpincube,
/turf/simulated/floor/tiled/white/airless,
/area/space/debrisfield/scioverrun)
"aD" = (
/obj/machinery/processor,
/obj/item/slime_extract/dark_blue,
/turf/simulated/floor/tiled/white/airless,
/area/space/debrisfield/scioverrun)
"aE" = (
/obj/structure/grille,
/obj/structure/window/reinforced/full,
/turf/simulated/floor/airless,
/area/space/debrisfield/scioverrun)
"aF" = (
/obj/item/reagent_containers/spray/plantbgone,
/turf/simulated/floor/tiled/white/airless,
/area/space/debrisfield/scioverrun)
"aG" = (
/obj/item/reagent_containers/spray/chemsprayer,
/turf/simulated/floor/tiled/white/airless,
/area/space/debrisfield/scioverrun)
"aH" = (
/obj/mob_spawner/carp,
/turf/template_noop,
/area/space/debrisfield/scioverrun)
"aI" = (
/obj/effect/decal/remains,
/obj/item/clothing/under/rank/hydroponics,
/obj/item/clothing/suit/storage/toggle/labcoat/green,
/obj/item/clothing/head/greenbandana,
/turf/simulated/floor/tiled/white/airless,
/area/space/debrisfield/scioverrun)
"aJ" = (
/obj/structure/table/rack,
/obj/item/slime_extract/rainbow,
/obj/structure/window/reinforced{
	dir = 4
	},
/obj/structure/window/reinforced{
	dir = 8
	},
/obj/structure/window/reinforced,
/turf/simulated/floor/tiled/white/airless,
/area/space/debrisfield/scioverrun)
"aK" = (
/obj/item/gun/energy/temperature,
/obj/structure/table/rack,
/obj/structure/window/reinforced,
/obj/structure/window/reinforced{
	dir = 1
	},
/obj/structure/window/reinforced{
	dir = 4
	},
/turf/simulated/floor/tiled/white/airless,
/area/space/debrisfield/scioverrun)
"aL" = (
/obj/structure/window/reinforced/full,
/obj/structure/grille,
/turf/simulated/floor/airless,
/area/space/debrisfield/scioverrun)
"aM" = (
/obj/machinery/computer/shuttle{
	dir = 8
	},
/turf/simulated/floor/tiled/white/airless,
/area/space/debrisfield/scioverrun)
"aN" = (
/obj/structure/bed/chair/comfy/purp{
	dir = 4
	},
/turf/simulated/floor/tiled/white/airless,
/area/space/debrisfield/scioverrun)
"aO" = (
/obj/item/gun/energy/decloner,
/obj/structure/table/rack,
/obj/structure/window/reinforced,
/obj/structure/window/reinforced{
	dir = 1
	},
/obj/structure/window/reinforced{
	dir = 4
	},
/turf/simulated/floor/tiled/white/airless,
/area/space/debrisfield/scioverrun)
"aP" = (
/obj/structure/filingcabinet/filingcabinet,
/turf/simulated/floor/tiled/white/airless,
/area/space/debrisfield/scioverrun)
"aQ" = (
/obj/structure/table/reinforced,
/obj/item/stack/material/phoron{
	amount = 10
	},
/obj/item/flashlight/pen,
/turf/simulated/floor/tiled/white/airless,
/area/space/debrisfield/scioverrun)
"aR" = (
/obj/structure/table/reinforced,
/obj/item/paper_bin,
/obj/item/pen/blue,
/obj/item/reagent_containers/chem_disp_cartridge/rezadone,
/turf/simulated/floor/tiled/white/airless,
/area/space/debrisfield/scioverrun)
"aS" = (
/obj/structure/table/reinforced,
/obj/item/folder/white,
/turf/simulated/floor/tiled/white/airless,
/area/space/debrisfield/scioverrun)
"aT" = (
/mob/living/simple_mob/slime/feral/dark_blue,
/turf/simulated/floor/tiled/white/airless,
/area/space/debrisfield/scioverrun)
"aU" = (
/obj/structure/table/rack,
/obj/structure/window/reinforced{
	dir = 4
	},
/obj/structure/window/reinforced{
	dir = 8
	},
/obj/item/material/shard,
/obj/item/clothing/mask/breath,
/turf/simulated/floor/tiled/white/airless,
/area/space/debrisfield/scioverrun)
"aV" = (
/obj/structure/bed/chair/office/light{
	dir = 1
	},
/turf/simulated/floor/tiled/white/airless,
/area/space/debrisfield/scioverrun)
"aW" = (
/obj/item/airlock_electronics,
/turf/simulated/floor/tiled/white/airless,
/area/space/debrisfield/scioverrun)
"aX" = (
/obj/item/material/shard,
/turf/simulated/floor/tiled/white/airless,
/area/space/debrisfield/scioverrun)
"aY" = (
/obj/structure/closet/emcloset,
/turf/simulated/floor/tiled/white/airless,
/area/space/debrisfield/scioverrun)
"aZ" = (
/obj/machinery/door/unpowered/shuttle,
/turf/simulated/floor/tiled/white/airless,
/area/space/debrisfield/scioverrun)
"ba" = (
/obj/item/clothing/suit/storage/toggle/labcoat/purple,
/turf/simulated/floor/tiled/white/airless,
/area/space/debrisfield/scioverrun)
"bb" = (
/obj/effect/decal/remains,
/obj/item/clothing/under/rank/scientist,
/obj/item/clothing/suit/storage/toggle/labcoat/blue,
/turf/simulated/floor/tiled/white/airless,
/area/space/debrisfield/scioverrun)
"bc" = (
/obj/structure/closet/secure_closet/scientist{
	name = "scientist locker";
	req_access = list(0)
	},
/turf/simulated/floor/tiled/white/airless,
/area/space/debrisfield/scioverrun)
"bd" = (
/obj/structure/bed,
/obj/item/bedsheet/blue,
/turf/simulated/floor/tiled/white/airless,
/area/space/debrisfield/scioverrun)
"be" = (
/obj/structure/bed,
/obj/item/bedsheet/green,
/turf/simulated/floor/tiled/white/airless,
/area/space/debrisfield/scioverrun)
"bf" = (
/obj/structure/bed,
/obj/item/bedsheet/rd,
/turf/simulated/floor/tiled/white/airless,
/area/space/debrisfield/scioverrun)
"bg" = (
/obj/structure/hygiene/sink{
	dir = 8;
	pixel_x = -12
	},
/turf/simulated/floor/tiled/white/airless,
/area/space/debrisfield/scioverrun)
"bh" = (
/obj/structure/shuttle/engine/propulsion{
	dir = 8
	},
/turf/simulated/floor/airless,
/area/space/debrisfield/scioverrun)
"bi" = (
/obj/structure/table/rack,
/obj/random/firstaid,
/obj/random/firstaid,
/turf/simulated/floor/airless,
/area/space/debrisfield/scioverrun)
"bj" = (
/obj/structure/table/rack,
/obj/random/unidentified_medicine/scientific,
/obj/random/unidentified_medicine/scientific,
/obj/random/unidentified_medicine/scientific,
/obj/random/unidentified_medicine/scientific,
/turf/simulated/floor/airless,
/area/space/debrisfield/scioverrun)
"bk" = (
/obj/machinery/door/airlock/command{
	name = "Research Airlock";
	req_one_access = list(0)
	},
/turf/simulated/floor/tiled/white/airless,
/area/space/debrisfield/scioverrun)
"bm" = (
/obj/structure/closet/crate,
/obj/item/stack/material/uranium{
	amount = 11
	},
/turf/simulated/floor/airless,
/area/space/debrisfield/scioverrun)
"bn" = (
/obj/machinery/power/port_gen/pacman/super,
/turf/simulated/floor/airless,
/area/space/debrisfield/scioverrun)
"bo" = (
/obj/structure/table/reinforced,
/obj/random/slimecore,
/obj/random/slimecore,
/obj/random/slimecore,
/obj/random/slimecore,
/obj/random/slimecore,
/obj/random/slimecore,
/obj/random/slimecore,
/obj/random/slimecore,
/turf/simulated/floor/tiled/white/airless,
/area/space/debrisfield/scioverrun)
"bp" = (
/obj/item/tool/prybar/red,
/turf/simulated/floor/airless,
/area/space/debrisfield/scioverrun)
"bq" = (
/mob/living/simple_mob/slime/feral/dark_blue,
/turf/simulated/floor/airless,
/area/space/debrisfield/scioverrun)
"cP" = (
/obj/machinery/door/airlock/maintenance/rnd{
	name = "Research Airlock";
	req_one_access = list(0)
	},
/turf/simulated/floor/tiled/white/airless,
/area/space/debrisfield/scioverrun)
"gH" = (
/turf/space,
/area/space/debrisfield/scioverrun)
"MV" = (
/obj/structure/closet/crate,
/obj/item/stack/material/phoron{
	amount = 10
	},
/turf/simulated/floor/airless,
/area/space/debrisfield/scioverrun)

(1,1,1) = {"
aa
aa
aa
aa
aa
aa
aa
aa
aa
aa
aa
aa
aa
aa
aa
aa
aa
aa
aa
aa
aa
aa
aa
aa
aa
"}
(2,1,1) = {"
aa
aa
aa
aa
aa
aa
aa
aa
aa
aa
aa
aa
aa
aa
aa
aa
aa
aa
aa
aa
aa
aa
aa
aa
aa
"}
(3,1,1) = {"
aa
aa
aa
aa
aa
aa
aa
aa
aa
aa
aa
aa
aa
aa
aa
aa
aa
aa
aa
aa
aa
aa
aa
aa
aa
"}
(4,1,1) = {"
aa
aa
aa
ab
bh
bh
ab
ab
bh
bh
ab
gH
gH
gH
ab
bh
bh
ab
ab
bh
bh
ab
aa
aa
aa
"}
(5,1,1) = {"
aa
aa
aa
ab
ab
ab
ab
ab
ab
ab
ab
bp
ac
ac
ab
ab
ab
ab
ab
ab
ab
ab
aa
aa
aa
"}
(6,1,1) = {"
aa
aa
aa
ab
as
as
ac
ac
bi
bj
ab
ab
aZ
ab
ab
bm
ac
ac
ac
ac
MV
ab
aa
aa
aa
"}
(7,1,1) = {"
aa
aa
aa
ab
ac
ac
ac
ac
bq
ac
ab
aY
ad
aY
ab
bm
ac
ac
ac
ac
bn
ab
aa
aa
aa
"}
(8,1,1) = {"
aa
aa
aa
ab
ab
ab
ax
ab
ab
ab
ab
ab
aZ
ab
ab
ab
ab
ab
cP
ab
ab
ab
aa
aa
aa
"}
(9,1,1) = {"
aa
aa
aa
ab
ad
ad
ad
ad
ad
ad
ad
ad
ad
ad
ad
ad
ad
ad
ad
ad
ad
ab
aa
aa
aa
"}
(10,1,1) = {"
aa
aa
aa
ab
ad
ad
ad
ad
ad
ad
ad
ad
ad
ad
ar
ad
ad
ad
ad
ad
ad
ab
aa
aa
aa
"}
(11,1,1) = {"
aa
aa
aa
ab
ab
ab
ab
ab
at
ab
ab
ad
ad
ad
ab
ab
ab
ab
ab
ab
ab
ab
aa
aa
aa
"}
(12,1,1) = {"
aa
aa
aa
ab
bc
bc
bc
ad
ad
bg
ab
ad
ad
ad
ab
aP
ad
ad
ab
ad
ad
ab
aa
aa
aa
"}
(13,1,1) = {"
aa
aa
aa
aE
ad
ad
ad
ad
au
ad
ab
ad
ad
ad
ab
aQ
ad
aW
aX
aT
ad
ab
aa
aa
aa
"}
(14,1,1) = {"
aa
aa
aa
aE
ad
ad
ar
ad
ad
ad
ab
ad
ad
ad
ab
aR
aV
ad
ab
ab
ab
ab
aa
aa
aa
"}
(15,1,1) = {"
aa
aa
aa
ab
bd
ad
be
ad
ad
bf
ab
ad
ad
ad
ab
aS
ad
ad
ab
ad
ad
ab
aa
aa
aa
"}
(16,1,1) = {"
aa
aa
aa
ab
ab
ab
ab
ab
ab
ab
ab
ad
ad
ad
ab
aB
ad
aT
aX
ad
ad
ab
aa
aa
aa
"}
(17,1,1) = {"
aa
aa
aa
ab
ae
ae
ae
ae
ae
ae
ab
ad
ad
ad
ab
ad
ad
ad
ab
ab
ab
ab
aa
aa
aa
"}
(18,1,1) = {"
aa
aa
aa
ab
ad
ak
ad
ad
ar
ad
ab
ad
ad
ad
ab
ad
ad
aX
ab
ad
ad
ab
aa
aa
aa
"}
(19,1,1) = {"
aa
aa
aa
ab
af
ar
ar
ad
ad
ad
ab
ar
ad
ad
ab
ad
ad
aW
ad
aT
ad
ab
aa
aa
aa
"}
(20,1,1) = {"
aa
aa
aa
ab
ag
ad
am
am
ad
ar
av
ad
ad
ad
ab
ad
ad
ad
ab
ab
ab
ab
aa
aa
aa
"}
(21,1,1) = {"
aa
aa
aa
ab
ah
al
an
ap
aq
ad
at
ad
ad
ad
ab
ad
ad
ad
aw
aw
aw
ab
aa
aa
aa
"}
(22,1,1) = {"
aa
aa
aa
ab
ai
ad
ao
ao
ar
ad
ab
ad
ad
ad
ay
ad
bb
ad
ad
ad
ad
ab
aa
aa
aa
"}
(23,1,1) = {"
aa
aa
aa
ab
aj
aF
ar
ad
ad
ad
ab
ad
ad
ad
at
ad
ad
ad
ad
ad
ad
ab
aa
aa
aa
"}
(24,1,1) = {"
aa
aa
aa
ab
aF
aG
aI
ad
ar
ak
ab
ad
ad
ad
ab
ad
ad
ad
ad
ad
aT
ab
aa
aa
aa
"}
(25,1,1) = {"
aa
aa
aa
ab
ae
ae
ae
ae
ae
ae
ab
aw
ad
aw
ab
az
aA
bo
bo
aC
aD
ab
aa
aa
aa
"}
(26,1,1) = {"
aa
aa
aa
ab
ab
ab
ab
ab
ab
ab
ab
ab
bk
ab
ab
ab
ab
ab
ab
ab
ab
ab
aa
aa
aa
"}
(27,1,1) = {"
aa
aa
aa
aa
aa
aa
aa
aa
ab
ad
aK
ad
ad
ad
aO
ad
ab
aa
aa
aa
aa
aa
aa
aa
aa
"}
(28,1,1) = {"
aa
aa
aa
aa
aa
aa
aa
aa
aE
ad
ad
ad
ad
ad
ad
ad
aE
aa
aa
aa
aa
aa
aa
aa
aa
"}
(29,1,1) = {"
aa
aa
aa
aa
aa
aa
aa
aa
aE
aJ
ad
ad
aN
ad
ba
aU
aE
aa
aa
aa
aa
aa
aa
aa
aa
"}
(30,1,1) = {"
aa
aa
aa
aa
aa
aH
aa
aa
ab
ad
ad
aM
aM
aM
ad
ad
ab
aa
aa
aa
aa
aa
aa
aa
aa
"}
(31,1,1) = {"
aa
aa
aa
aa
aa
aa
aa
aa
ab
ab
aL
aE
aE
aE
aE
ab
ab
aa
aa
aa
aa
aa
aa
aa
aa
"}
(32,1,1) = {"
aa
aa
aa
aa
aa
aa
aa
aa
aa
aa
aa
aa
aa
aa
aa
aa
aa
aa
aa
aa
aa
aa
aa
aa
aa
"}
