//MAP CONVERTED BY dmm2tgm.py THIS HEADER COMMENT PREVENTS RECONVERSION, DO NOT REMOVE
"a" = (
/turf/space,
/area/debrisfield/explored)
"b" = (
/obj/structure/table/steel,
/obj/structure/sink/kitchen,
/turf/simulated/floor/tiled/old_tile/yellow,
/area/debrisfield/explored)
"d" = (
/turf/template_noop,
/area/debrisfield/explored)
"e" = (
/obj/machinery/computer/ship/navigation/telescreen{
	pixel_x = 32
	},
/obj/structure/bed/chair/sofa/corner{
	dir = 8;
	icon_state = "sofacorner"
	},
/turf/simulated/floor/carpet/oracarpet,
/area/debrisfield/explored)
"f" = (
/obj/structure/bed/chair/comfy/brown{
	dir = 4
	},
/obj/structure/closet/walllocker/emerglocker{
	pixel_y = -32
	},
/turf/simulated/floor/carpet/oracarpet,
/area/debrisfield/explored)
"h" = (
/obj/structure/closet/secure_closet/freezer/meat,
/obj/item/reagent_containers/food/drinks/soymilk,
/obj/item/reagent_containers/food/drinks/soymilk,
/obj/item/reagent_containers/food/drinks/bottle/milk,
/obj/item/reagent_containers/food/drinks/bottle/milk,
/obj/item/reagent_containers/food/drinks/bottle/cola,
/obj/item/reagent_containers/food/drinks/bottle/cola,
/obj/item/reagent_containers/food/drinks/bottle/cola,
/obj/item/reagent_containers/food/drinks/bottle/cola,
/obj/item/reagent_containers/food/drinks/bottle/cola,
/obj/item/reagent_containers/food/drinks/bottle/cola,
/obj/item/reagent_containers/food/drinks/bottle/cola,
/obj/item/reagent_containers/food/drinks/bottle/cola,
/obj/item/reagent_containers/food/drinks/bottle/cola,
/obj/item/reagent_containers/food/drinks/bottle/cola,
/obj/item/reagent_containers/food/drinks/bottle/cola,
/obj/item/reagent_containers/food/drinks/bottle/cola,
/obj/item/reagent_containers/food/drinks/bottle/cola,
/obj/item/reagent_containers/food/drinks/bottle/cola,
/turf/simulated/floor/carpet/oracarpet,
/area/debrisfield/explored)
"j" = (
/obj/structure/simple_door,
/turf/simulated/floor/wood,
/area/debrisfield/explored)
"l" = (
/obj/machinery/computer/ship/helm{
	dir = 4
	},
/turf/simulated/floor/carpet/oracarpet,
/area/debrisfield/explored)
"p" = (
/obj/structure/bed/chair/comfy/brown{
	dir = 8
	},
/obj/structure/closet/walllocker/emerglocker{
	pixel_y = -32
	},
/turf/simulated/floor/carpet/oracarpet,
/area/debrisfield/explored)
"r" = (
/turf/simulated/floor/wood,
/area/debrisfield/explored)
"s" = (
/obj/machinery/door/window/westright{
	dir = 1
	},
/obj/structure/cable/green{
	d1 = 4;
	d2 = 8;
	icon_state = "4-8"
	},
/obj/machinery/light/small{
	dir = 4
	},
/turf/simulated/floor/carpet/oracarpet,
/area/debrisfield/explored)
"t" = (
/turf/simulated/floor/carpet/oracarpet,
/area/debrisfield/explored)
"z" = (
/obj/structure/cable/green{
	d1 = 2;
	d2 = 4;
	icon_state = "2-4"
	},
/turf/simulated/wall/wood,
/area/debrisfield/explored)
"B" = (
/obj/structure/bed/chair/comfy/brown{
	dir = 8
	},
/turf/simulated/floor/carpet/oracarpet,
/area/debrisfield/explored)
"C" = (
/obj/machinery/power/smes/buildable{
	charge = 1.5e+007;
	cur_coils = 3
	},
/obj/structure/cable/green{
	d2 = 2;
	icon_state = "0-2"
	},
/turf/simulated/floor/tiled/airless,
/area/debrisfield/explored)
"F" = (
/obj/structure/grille,
/obj/structure/window/reinforced/full,
/turf/simulated/floor/plating,
/area/debrisfield/explored)
"G" = (
/obj/structure/table/steel,
/obj/machinery/light/small{
	dir = 1
	},
/obj/item/reagent_containers/glass/beaker{
	pixel_x = 5
	},
/turf/simulated/floor/tiled/old_tile/yellow,
/area/debrisfield/explored)
"H" = (
/obj/structure/cable/green{
	d1 = 1;
	d2 = 8;
	icon_state = "1-8"
	},
/turf/simulated/wall/wood,
/area/debrisfield/explored)
"I" = (
/obj/structure/table/steel,
/obj/machinery/light_switch{
	dir = 1;
	pixel_y = -24
	},
/turf/simulated/floor/carpet/oracarpet,
/area/debrisfield/explored)
"N" = (
/obj/machinery/computer/shuttle_control/explore{
	dir = 4
	},
/turf/simulated/floor/carpet/oracarpet,
/area/debrisfield/explored)
"Q" = (
/obj/structure/sink{
	dir = 8;
	pixel_x = -12;
	pixel_y = 2
	},
/obj/structure/toilet{
	pixel_y = 10
	},
/obj/machinery/shower{
	dir = 8
	},
/turf/simulated/floor/tiled/old_tile/yellow,
/area/debrisfield/explored)
"S" = (
/obj/machinery/ion_engine{
	dir = 8
	},
/turf/simulated/floor/tiled/airless,
/area/debrisfield/explored)
"T" = (
/obj/machinery/computer/ship/sensors,
/turf/simulated/floor/carpet/oracarpet,
/area/debrisfield/explored)
"V" = (
/obj/structure/table/steel,
/obj/machinery/microwave,
/obj/machinery/light/small{
	dir = 1
	},
/turf/simulated/floor/tiled/old_tile/yellow,
/area/debrisfield/explored)
"W" = (
/obj/structure/bed/double/padded,
/obj/item/bedsheet/browndouble,
/turf/simulated/floor/carpet/oracarpet,
/area/debrisfield/explored)
"X" = (
/obj/structure/closet/walllocker/emerglocker{
	pixel_y = -32
	},
/obj/structure/bed/chair/sofa/right{
	dir = 1;
	icon_state = "sofaend_right"
	},
/turf/simulated/floor/carpet/oracarpet,
/area/debrisfield/explored)
"Y" = (
/obj/machinery/power/apc/alarms_hidden{
	pixel_y = 30
	},
/obj/structure/cable/green{
	d2 = 4;
	icon_state = "0-4"
	},
/turf/simulated/floor/carpet/oracarpet,
/area/debrisfield/explored)
"Z" = (
/turf/simulated/wall/wood,
/area/debrisfield/explored)

(1,1,1) = {"
d
a
a
a
a
a
d
"}
(2,1,1) = {"
a
Z
F
F
F
Z
a
"}
(3,1,1) = {"
a
F
T
N
l
F
a
"}
(4,1,1) = {"
a
j
r
t
B
Z
a
"}
(5,1,1) = {"
a
Z
V
t
f
Z
a
"}
(6,1,1) = {"
a
F
b
t
I
Z
a
"}
(7,1,1) = {"
a
Z
G
t
p
Z
a
"}
(8,1,1) = {"
a
j
r
t
X
Z
a
"}
(9,1,1) = {"
a
Z
h
t
e
F
a
"}
(10,1,1) = {"
a
Z
Z
Y
Z
Z
a
"}
(11,1,1) = {"
a
Z
Q
s
W
Z
a
"}
(12,1,1) = {"
a
Z
z
H
Z
Z
a
"}
(13,1,1) = {"
a
C
H
S
Z
Z
a
"}
(14,1,1) = {"
d
a
a
a
a
a
d
"}
