//MAP CONVERTED BY dmm2tgm.py THIS HEADER COMMENT PREVENTS RECONVERSION, DO NOT REMOVE
"aM" = (
/obj/machinery/atmospherics/pipe/simple/hidden{
	dir = 10
	},
/obj/structure/cable{
	icon_state = "2-4"
	},
/obj/structure/medical_stand,
/turf/simulated/floor/tiled/eris/dark/techfloor,
/area/shuttle/auto/named/engine)
"aP" = (
/obj/machinery/door/window/brigdoor/westright{
	req_access = list();
	req_one_access = list(5,67)
	},
/obj/structure/cable{
	icon_state = "1-2"
	},
/obj/machinery/atmospherics/component/unary/vent_scrubber/on{
	dir = 8
	},
/turf/simulated/floor/tiled/white,
/area/shuttle/auto/named/cockpit)
"bh" = (
/obj/structure/window/reinforced{
	dir = 1
	},
/obj/machinery/vitals_monitor,
/turf/simulated/floor/tiled/eris/dark/violetcorener,
/area/shuttle/auto/named/medbay)
"bA" = (
/obj/effect/floor_decal/borderfloorwhite{
	dir = 1
	},
/obj/effect/floor_decal/corner/paleblue/border{
	dir = 1
	},
/obj/machinery/atmospherics/pipe/simple/hidden/scrubbers{
	dir = 4
	},
/obj/structure/airlock_interconnect/hardmapped,
/obj/machinery/airlock_component/controller/vacuum_cycle/hardmapped,
/turf/simulated/floor/tiled/white,
/area/shuttle/auto/named/medbay)
"ca" = (
/obj/machinery/computer/ship/sensors{
	dir = 8
	},
/obj/machinery/light,
/obj/effect/floor_decal/borderfloorwhite{
	dir = 6
	},
/obj/effect/floor_decal/corner/paleblue/border{
	dir = 6
	},
/turf/simulated/floor/tiled/white,
/area/shuttle/auto/named/cockpit)
"dc" = (
/obj/machinery/atmospherics/component/binary/pump/fuel{
	dir = 8
	},
/obj/structure/cable{
	icon_state = "0-4"
	},
/obj/machinery/power/apc/west_mount{
	req_access = list();
	req_one_access = list(11,67)
	},
/obj/machinery/atmospherics/pipe/simple/hidden/supply,
/turf/simulated/floor/tiled/eris/dark/techfloor,
/area/shuttle/auto/named/engine)
"dr" = (
/obj/spawner/window/low_wall/reinforced/firelocks,
/obj/machinery/door/blast/regular{
	density = 0;
	dir = 4;
	icon_state = "pdoor0";
	id = "medivac blast";
	name = "Shuttle Blast Doors";
	opacity = 0
	},
/turf/simulated/floor/plating,
/area/shuttle/auto/named/cockpit)
"dW" = (
/obj/effect/floor_decal/borderfloorwhite{
	dir = 1
	},
/obj/effect/floor_decal/corner/paleblue/border{
	dir = 1
	},
/obj/structure/handrail,
/obj/machinery/atmospherics/component/unary/vent_pump/on,
/obj/machinery/atmospherics/pipe/simple/hidden/scrubbers{
	dir = 4
	},
/obj/machinery/airlock_peripheral/sensor/interior/hardmapped/north_mount,
/obj/structure/airlock_interconnect/hardmapped,
/obj/map_helper/airlock_linker/preset/shuttle_main,
/turf/simulated/floor/tiled/white,
/area/shuttle/auto/named/medbay)
"ee" = (
/obj/effect/floor_decal/borderfloorwhite,
/obj/effect/floor_decal/corner/paleblue/border,
/obj/machinery/atmospherics/pipe/simple/hidden/aux{
	dir = 5
	},
/obj/structure/bed/chair/shuttle{
	dir = 1
	},
/turf/simulated/floor/tiled/white,
/area/shuttle/auto/named/medbay)
"fl" = (
/obj/structure/sign/nosmoking_1,
/turf/simulated/wall/rshull,
/area/shuttle/auto/named/medbay)
"fX" = (
/turf/space/basic,
/area/space)
"gg" = (
/obj/machinery/power/apc/south_mount{
	alarms_hidden = 1;
	req_access = list();
	req_one_access = list(11,67)
	},
/obj/structure/cable,
/obj/effect/floor_decal/borderfloorwhite{
	dir = 10
	},
/obj/effect/floor_decal/corner/paleblue/border{
	dir = 10
	},
/obj/machinery/air_alarm{
	dir = 4;
	pixel_x = -23
	},
/obj/structure/table/glass,
/obj/item/storage/firstaid/fire{
	pixel_x = 5;
	pixel_y = 5
	},
/obj/item/storage/firstaid/adv,
/turf/simulated/floor/tiled/white,
/area/shuttle/auto/named/medbay)
"gq" = (
/obj/structure/cable{
	icon_state = "4-8"
	},
/obj/structure/cable{
	icon_state = "2-8"
	},
/obj/effect/floor_decal/borderfloorwhite/corner{
	dir = 8
	},
/obj/effect/floor_decal/corner/paleblue/bordercorner{
	dir = 8
	},
/obj/machinery/atmospherics/pipe/simple/hidden/supply{
	dir = 4
	},
/obj/machinery/atmospherics/component/unary/vent_scrubber/on{
	dir = 1
	},
/obj/machinery/atmospherics/pipe/simple/hidden/aux{
	dir = 4
	},
/turf/simulated/floor/tiled/white,
/area/shuttle/auto/named/medbay)
"gA" = (
/turf/simulated/wall/rshull,
/area/shuttle/auto/named/engine)
"gP" = (
/obj/structure/cable{
	icon_state = "1-4"
	},
/obj/machinery/atmospherics/pipe/simple/hidden/fuel{
	dir = 10
	},
/obj/structure/cable{
	icon_state = "4-8"
	},
/obj/machinery/atmospherics/pipe/simple/hidden/aux{
	dir = 6
	},
/turf/simulated/floor/tiled/eris/dark/techfloor,
/area/shuttle/auto/named/engine)
"gZ" = (
/obj/structure/closet/walllocker/emergsuit_wall{
	pixel_y = 32
	},
/obj/effect/floor_decal/borderfloorwhite{
	dir = 9
	},
/obj/effect/floor_decal/corner/paleblue/border{
	dir = 9
	},
/obj/structure/table/glass,
/obj/item/storage/firstaid/o2{
	pixel_x = 5;
	pixel_y = 5
	},
/obj/item/storage/firstaid/toxin,
/turf/simulated/floor/tiled/white,
/area/shuttle/auto/named/medbay)
"hr" = (
/obj/machinery/atmospherics/pipe/simple/hidden/aux,
/turf/simulated/floor/tiled/white,
/area/shuttle/auto/named/medbay)
"hM" = (
/obj/machinery/door/firedoor/glass,
/obj/machinery/atmospherics/pipe/simple/hidden{
	dir = 4
	},
/obj/structure/cable/green{
	icon_state = "4-8"
	},
/obj/machinery/atmospherics/pipe/simple/hidden/supply{
	dir = 8
	},
/obj/machinery/atmospherics/pipe/simple/hidden/scrubbers{
	dir = 4
	},
/turf/simulated/floor/tiled/eris/techmaint_panels,
/area/shuttle/auto/named/engine)
"hV" = (
/obj/machinery/shipsensors{
	dir = 4
	},
/obj/effect/floor_decal/industrial/warning/full,
/turf/simulated/floor/airless,
/area/shuttle/auto/named/cockpit)
"ij" = (
/obj/structure/window/reinforced{
	dir = 8
	},
/obj/structure/table/glass,
/obj/effect/floor_decal/borderfloorwhite,
/obj/effect/floor_decal/corner/paleblue/border,
/obj/machinery/air_alarm{
	dir = 1;
	pixel_y = -22
	},
/turf/simulated/floor/tiled/white,
/area/shuttle/auto/named/cockpit)
"iQ" = (
/obj/effect/floor_decal/industrial/outline/grey,
/obj/machinery/atmospherics/pipe/tank/air{
	dir = 4
	},
/turf/simulated/floor/tiled/eris/dark/techfloor,
/area/shuttle/auto/named/engine)
"iT" = (
/obj/spawner/window/low_wall/reinforced/firelocks,
/obj/machinery/door/blast/regular{
	density = 0;
	icon_state = "pdoor0";
	id = "medivac blast";
	name = "Shuttle Blast Doors";
	opacity = 0
	},
/turf/simulated/floor/plating,
/area/shuttle/auto/named/medbay)
"jj" = (
/obj/machinery/airlock_peripheral/sensor/exterior/hardmapped,
/obj/map_helper/airlock_linker/preset/shuttle_main,
/turf/simulated/wall/rshull,
/area/shuttle/auto/named/engine)
"jB" = (
/obj/structure/bed/chair/bay/chair/padded/blue{
	dir = 4
	},
/obj/machinery/button/remote/blast_door{
	dir = 8;
	id = "medivac blast";
	name = "Shuttle Blast Doors";
	pixel_x = -28;
	pixel_y = -28;
	req_access = list(67)
	},
/obj/effect/floor_decal/borderfloorwhite/corner,
/obj/effect/floor_decal/corner/paleblue/bordercorner,
/turf/simulated/floor/tiled/white,
/area/shuttle/auto/named/cockpit)
"me" = (
/obj/machinery/atmospherics/component/unary/engine{
	dir = 4
	},
/turf/simulated/floor/airless,
/area/shuttle/auto/named/engine)
"mh" = (
/obj/structure/sign/redcross,
/turf/simulated/wall/rshull,
/area/shuttle/auto/named/engine)
"nC" = (
/obj/structure/cable{
	icon_state = "1-2"
	},
/obj/machinery/light{
	dir = 8
	},
/obj/effect/floor_decal/borderfloorwhite{
	dir = 8
	},
/obj/effect/floor_decal/corner/paleblue/border{
	dir = 8
	},
/obj/structure/bed/chair/shuttle{
	dir = 4
	},
/turf/simulated/floor/tiled/white,
/area/shuttle/auto/named/medbay)
"nF" = (
/obj/machinery/computer/ship/engines,
/obj/effect/floor_decal/borderfloorwhite{
	dir = 5
	},
/obj/effect/floor_decal/corner/paleblue/border{
	dir = 5
	},
/turf/simulated/floor/tiled/white,
/area/shuttle/auto/named/cockpit)
"nG" = (
/obj/structure/cable{
	icon_state = "4-8"
	},
/obj/effect/floor_decal/borderfloorwhite,
/obj/effect/floor_decal/corner/paleblue/border,
/obj/machinery/atmospherics/pipe/simple/hidden/supply{
	dir = 4
	},
/obj/machinery/atmospherics/pipe/simple/hidden/aux{
	dir = 4
	},
/turf/simulated/floor/tiled/white,
/area/shuttle/auto/named/medbay)
"nQ" = (
/turf/simulated/floor/tiled/white,
/area/shuttle/auto/named/medbay)
"qQ" = (
/obj/machinery/computer/ship/helm{
	dir = 8
	},
/obj/machinery/light{
	dir = 1
	},
/obj/effect/floor_decal/borderfloorwhite{
	dir = 5
	},
/obj/effect/floor_decal/corner/paleblue/border{
	dir = 5
	},
/turf/simulated/floor/tiled/white,
/area/shuttle/auto/named/cockpit)
"ry" = (
/obj/machinery/atmospherics/pipe/manifold/hidden/fuel,
/turf/simulated/wall/rshull,
/area/shuttle/auto/named/engine)
"sy" = (
/obj/structure/cable/green{
	icon_state = "1-2"
	},
/obj/machinery/door/airlock/glass_external{
	req_one_access = null
	},
/obj/map_helper/access_helper/airlock/station/external_airlock,
/obj/machinery/airlock_component/handler/hardmapped,
/obj/structure/airlock_interconnect/hardmapped,
/obj/machinery/airlock_component/door_linker/indoors/hardmapped,
/turf/simulated/floor/tiled/eris/techmaint_panels,
/area/shuttle/auto/named/medbay)
"te" = (
/obj/machinery/computer/shuttle_control{
	dir = 1
	},
/obj/effect/floor_decal/borderfloorwhite{
	dir = 6
	},
/obj/effect/floor_decal/corner/paleblue/border{
	dir = 6
	},
/turf/simulated/floor/tiled/white,
/area/shuttle/auto/named/cockpit)
"uK" = (
/obj/machinery/bodyscanner{
	dir = 4
	},
/obj/effect/floor_decal/borderfloorwhite{
	dir = 6
	},
/obj/effect/floor_decal/corner/paleblue/border{
	dir = 6
	},
/turf/simulated/floor/tiled/white,
/area/shuttle/auto/named/medbay)
"vv" = (
/obj/structure/cable{
	icon_state = "1-2"
	},
/obj/machinery/atmospherics/pipe/simple/hidden/universal,
/obj/structure/medical_stand,
/turf/simulated/floor/tiled/eris/dark/techfloor,
/area/shuttle/auto/named/engine)
"vJ" = (
/turf/space,
/area/space)
"wb" = (
/obj/machinery/sleeper{
	dir = 4
	},
/obj/effect/floor_decal/borderfloorwhite{
	dir = 5
	},
/obj/effect/floor_decal/corner/paleblue/border{
	dir = 5
	},
/turf/simulated/floor/tiled/white,
/area/shuttle/auto/named/medbay)
"wm" = (
/obj/effect/floor_decal/corner/blue{
	dir = 10
	},
/obj/effect/floor_decal/corner/blue{
	dir = 4
	},
/obj/effect/floor_decal/corner/paleblue/border{
	dir = 6
	},
/obj/machinery/atmospherics/pipe/simple/hidden/scrubbers{
	dir = 4
	},
/turf/simulated/floor/tiled/white,
/area/shuttle/auto/named/medbay)
"wY" = (
/obj/structure/cable{
	icon_state = "4-8"
	},
/obj/effect/floor_decal/borderfloorwhite,
/obj/effect/floor_decal/corner/paleblue/border,
/obj/machinery/atmospherics/pipe/simple/hidden/supply{
	dir = 5
	},
/obj/machinery/atmospherics/pipe/simple/hidden/aux{
	dir = 4
	},
/turf/simulated/floor/tiled/white,
/area/shuttle/auto/named/medbay)
"xA" = (
/obj/machinery/body_scanconsole{
	dir = 4
	},
/obj/effect/floor_decal/borderfloorwhite,
/obj/effect/floor_decal/corner/paleblue/border,
/obj/machinery/atmospherics/pipe/simple/hidden/aux{
	dir = 9
	},
/turf/simulated/floor/tiled/white,
/area/shuttle/auto/named/medbay)
"xC" = (
/obj/machinery/door/window/brigdoor/westleft{
	req_access = list();
	req_one_access = list(5,67)
	},
/obj/structure/cable{
	icon_state = "1-8"
	},
/obj/machinery/atmospherics/component/unary/vent_pump/on{
	dir = 8
	},
/turf/simulated/floor/tiled/white,
/area/shuttle/auto/named/cockpit)
"yi" = (
/obj/effect/floor_decal/industrial/outline/yellow,
/obj/machinery/portable_atmospherics/canister/empty,
/obj/machinery/atmospherics/portables_connector/aux{
	dir = 4
	},
/turf/simulated/floor/tiled/eris/dark/techfloor,
/area/shuttle/auto/named/engine)
"yt" = (
/turf/simulated/wall/rshull,
/area/shuttle/auto/named/medbay)
"yP" = (
/obj/machinery/portable_atmospherics/canister/phoron,
/obj/effect/floor_decal/industrial/outline/red,
/obj/machinery/atmospherics/portables_connector/fuel{
	dir = 1
	},
/obj/machinery/atmospherics/pipe/simple/hidden/aux{
	dir = 4
	},
/turf/simulated/floor/tiled/eris/dark/techfloor,
/area/shuttle/auto/named/engine)
"zx" = (
/obj/machinery/atmospherics/pipe/simple/hidden/universal,
/turf/simulated/floor/tiled/white,
/area/shuttle/auto/named/medbay)
"zX" = (
/obj/machinery/atmospherics/pipe/simple/hidden/fuel{
	dir = 10
	},
/turf/simulated/wall/rshull,
/area/shuttle/auto/named/engine)
"Ah" = (
/obj/structure/bed/chair/bay/chair/padded/blue{
	dir = 4
	},
/obj/effect/floor_decal/borderfloorwhite/corner{
	dir = 4
	},
/obj/effect/floor_decal/corner/paleblue/bordercorner{
	dir = 4
	},
/turf/simulated/floor/tiled/white,
/area/shuttle/auto/named/cockpit)
"An" = (
/obj/structure/cable{
	icon_state = "4-8"
	},
/obj/effect/floor_decal/borderfloorwhite,
/obj/effect/floor_decal/corner/paleblue/border,
/obj/structure/handrail{
	dir = 1
	},
/obj/machinery/atmospherics/pipe/manifold/hidden/supply,
/obj/machinery/atmospherics/pipe/simple/hidden/aux{
	dir = 4
	},
/turf/simulated/floor/tiled/white,
/area/shuttle/auto/named/medbay)
"Bo" = (
/obj/machinery/door/airlock/glass_external{
	req_one_access = null
	},
/obj/map_helper/access_helper/airlock/station/external_airlock,
/obj/structure/airlock_interconnect/hardmapped,
/obj/machinery/airlock_component/door_linker/indoors/hardmapped,
/turf/simulated/floor/tiled/eris/techmaint_panels,
/area/shuttle/auto/named/medbay)
"BL" = (
/obj/machinery/atmospherics/pipe/simple/hidden/scrubbers{
	dir = 4
	},
/turf/simulated/floor/tiled/white,
/area/shuttle/auto/named/medbay)
"BQ" = (
/obj/item/radio/intercom/department/medbay,
/turf/simulated/wall/rshull,
/area/shuttle/auto/named/medbay)
"DZ" = (
/obj/effect/floor_decal/borderfloorwhite/corner{
	dir = 1
	},
/obj/effect/floor_decal/corner/paleblue/bordercorner{
	dir = 1
	},
/obj/machinery/atmospherics/pipe/manifold/hidden/scrubbers{
	dir = 1
	},
/obj/machinery/holopad/ship,
/turf/simulated/floor/tiled/white,
/area/shuttle/auto/named/medbay)
"FW" = (
/obj/machinery/optable,
/obj/machinery/oxygen_pump/anesthetic{
	dir = 1;
	pixel_y = -32
	},
/turf/simulated/floor/tiled/eris/dark/violetcorener,
/area/shuttle/auto/named/medbay)
"Hu" = (
/obj/machinery/power/smes/buildable/point_of_interest,
/obj/structure/cable{
	icon_state = "0-8"
	},
/obj/machinery/light/small{
	dir = 1
	},
/turf/simulated/floor/tiled/eris/dark/techfloor,
/area/shuttle/auto/named/engine)
"HH" = (
/obj/structure/cable/green{
	icon_state = "1-4"
	},
/obj/machinery/atmospherics/pipe/simple/hidden{
	dir = 4
	},
/obj/structure/cable{
	icon_state = "2-8"
	},
/obj/machinery/atmospherics/pipe/simple/hidden/supply{
	dir = 8
	},
/obj/machinery/atmospherics/pipe/simple/hidden/scrubbers{
	dir = 5
	},
/turf/simulated/floor/tiled/eris/dark/techfloor,
/area/shuttle/auto/named/engine)
"IL" = (
/obj/structure/cable/green{
	icon_state = "1-2"
	},
/obj/effect/shuttle_landmark{
	base_area = /area/mine/explored/upper_level;
	base_turf = /turf/simulated/floor/airless;
	docking_controller = "medivac_bay";
	landmark_tag = "tether_medivac_dock";
	name = "Medivac Bay"
	},
/obj/machinery/airlock_peripheral/panel/west_mount,
/obj/machinery/airlock_component/cycler/hardmapped,
/obj/structure/airlock_interconnect/hardmapped,
/obj/map_helper/airlock_linker/preset/shuttle_main,
/turf/simulated/floor/tiled/eris/steel/gray_perforated,
/area/shuttle/auto/named/medbay)
"JJ" = (
/obj/structure/cable/green{
	icon_state = "1-8"
	},
/obj/effect/floor_decal/borderfloorwhite{
	dir = 1
	},
/obj/effect/floor_decal/corner/paleblue/border{
	dir = 1
	},
/obj/machinery/atmospherics/pipe/manifold/hidden/scrubbers,
/obj/machinery/atmospherics/pipe/manifold/hidden/supply{
	dir = 4
	},
/turf/simulated/floor/tiled/white,
/area/shuttle/auto/named/medbay)
"Ki" = (
/obj/structure/sign/redcross,
/turf/simulated/wall/rshull,
/area/shuttle/auto/named/medbay)
"Kp" = (
/obj/structure/cable{
	icon_state = "4-8"
	},
/obj/effect/floor_decal/corner/blue{
	dir = 5
	},
/obj/effect/floor_decal/corner/blue{
	dir = 8
	},
/obj/effect/floor_decal/corner/paleblue/border{
	dir = 9
	},
/obj/machinery/atmospherics/pipe/simple/hidden/supply{
	dir = 4
	},
/obj/machinery/atmospherics/pipe/simple/hidden/scrubbers,
/turf/simulated/floor/tiled/white,
/area/shuttle/auto/named/medbay)
"KM" = (
/obj/effect/floor_decal/industrial/warning/full,
/turf/simulated/floor/airless,
/area/shuttle/auto/named/cockpit)
"KS" = (
/obj/machinery/door/airlock/glass_external{
	req_one_access = null
	},
/obj/structure/cable/green{
	icon_state = "1-2"
	},
/obj/map_helper/access_helper/airlock/station/external_airlock,
/obj/structure/airlock_interconnect/hardmapped,
/obj/machinery/airlock_component/door_linker/outdoors/hardmapped,
/obj/shuttle_aligner/port/two_wide/left_aligned/north/primary,
/turf/simulated/floor/tiled/eris/techmaint_panels,
/area/shuttle/auto/named/medbay)
"KU" = (
/obj/machinery/atmospherics/pipe/manifold/hidden/fuel{
	dir = 4
	},
/obj/machinery/air_alarm{
	breach_detection = 0;
	dir = 8;
	pixel_x = 25;
	rcon_setting = 3;
	report_danger_level = 0
	},
/obj/machinery/atmospherics/pipe/simple/hidden/aux,
/obj/structure/closet/crate,
/obj/item/roller{
	pixel_y = 8
	},
/obj/item/roller{
	pixel_y = 8
	},
/obj/item/roller{
	pixel_y = 8
	},
/turf/simulated/floor/tiled/eris/dark/techfloor,
/area/shuttle/auto/named/engine)
"Ma" = (
/obj/structure/cable{
	icon_state = "4-8"
	},
/obj/effect/floor_decal/corner/blue{
	dir = 5
	},
/obj/effect/floor_decal/corner/blue,
/obj/effect/floor_decal/corner/paleblue/border{
	dir = 5
	},
/obj/machinery/atmospherics/pipe/simple/hidden/supply{
	dir = 4
	},
/obj/machinery/atmospherics/pipe/simple/hidden/aux{
	dir = 10
	},
/turf/simulated/floor/tiled/white,
/area/shuttle/auto/named/medbay)
"MM" = (
/obj/machinery/light{
	dir = 8
	},
/obj/effect/floor_decal/borderfloorwhite{
	dir = 8
	},
/obj/effect/floor_decal/corner/paleblue/border{
	dir = 8
	},
/obj/item/radio/intercom/department/medbay{
	dir = 8;
	pixel_x = -24
	},
/obj/structure/bed/chair/shuttle{
	dir = 4
	},
/turf/simulated/floor/tiled/white,
/area/shuttle/auto/named/medbay)
"Pf" = (
/obj/structure/bed/chair/bay/chair/padded/blue{
	dir = 4
	},
/obj/structure/closet/walllocker/emergsuit_wall{
	dir = 8;
	pixel_x = -32
	},
/turf/simulated/floor/tiled/eris/dark/violetcorener,
/area/shuttle/auto/named/medbay)
"Pp" = (
/obj/effect/floor_decal/borderfloorwhite/corner{
	dir = 4
	},
/obj/effect/floor_decal/corner/paleblue/bordercorner{
	dir = 4
	},
/turf/simulated/floor/tiled/white,
/area/shuttle/auto/named/medbay)
"Pu" = (
/obj/machinery/door/airlock/multi_tile/metal/mait{
	dir = 4
	},
/obj/machinery/door/firedoor/glass,
/obj/structure/cable{
	icon_state = "4-8"
	},
/obj/machinery/atmospherics/pipe/simple/hidden/aux{
	dir = 4
	},
/obj/map_helper/access_helper/airlock/station/medical/department,
/turf/simulated/floor/tiled/eris/techmaint_panels,
/area/shuttle/auto/named/engine)
"Qm" = (
/obj/machinery/power/terminal{
	dir = 1
	},
/obj/structure/cable/green{
	icon_state = "0-2"
	},
/obj/structure/closet/crate/freezer,
/obj/item/reagent_containers/blood/OMinus,
/obj/item/reagent_containers/blood/OMinus,
/obj/item/reagent_containers/blood/OMinus,
/obj/item/reagent_containers/blood/OMinus,
/obj/machinery/atmospherics/component/unary/vent_scrubber/on,
/obj/structure/closet/walllocker/emergsuit_wall{
	pixel_x = 32
	},
/turf/simulated/floor/tiled/eris/dark/techfloor,
/area/shuttle/auto/named/engine)
"Qz" = (
/obj/effect/floor_decal/borderfloorwhite{
	dir = 1
	},
/obj/effect/floor_decal/corner/paleblue/border{
	dir = 1
	},
/obj/structure/bed/chair/shuttle,
/turf/simulated/floor/tiled/white,
/area/shuttle/auto/named/medbay)
"QV" = (
/obj/structure/shuttle_fuel_port{
	pixel_x = -32
	},
/obj/machinery/atmospherics/pipe/simple/hidden/fuel{
	dir = 6
	},
/obj/item/tank/phoron,
/obj/machinery/atmospherics/component/unary/vent_pump/on{
	dir = 1
	},
/turf/simulated/floor/tiled/eris/dark/techfloor,
/area/shuttle/auto/named/engine)
"Vr" = (
/obj/machinery/sleep_console{
	dir = 4
	},
/obj/effect/floor_decal/borderfloorwhite{
	dir = 1
	},
/obj/effect/floor_decal/corner/paleblue/border{
	dir = 1
	},
/turf/simulated/floor/tiled/white,
/area/shuttle/auto/named/medbay)
"Vt" = (
/obj/machinery/portable_atmospherics/canister/phoron,
/obj/effect/floor_decal/industrial/outline/red,
/obj/machinery/atmospherics/portables_connector/fuel{
	dir = 1
	},
/obj/machinery/atmospherics/pipe/simple/hidden/aux{
	dir = 9
	},
/obj/machinery/light/small,
/turf/simulated/floor/tiled/eris/dark/techfloor,
/area/shuttle/auto/named/engine)
"VJ" = (
/obj/machinery/door/window/brigdoor/northleft{
	req_access = list(5)
	},
/obj/structure/handrail{
	dir = 4
	},
/turf/simulated/floor/tiled/eris/dark/violetcorener,
/area/shuttle/auto/named/medbay)
"VN" = (
/obj/structure/cable{
	icon_state = "4-8"
	},
/obj/machinery/atmospherics/pipe/simple/hidden/supply{
	dir = 4
	},
/turf/simulated/floor/tiled/white,
/area/shuttle/auto/named/medbay)
"VY" = (
/turf/simulated/wall/rshull,
/area/shuttle/auto/named/cockpit)
"Wk" = (
/obj/effect/floor_decal/corner/blue{
	dir = 10
	},
/obj/effect/floor_decal/corner/blue{
	dir = 1
	},
/obj/effect/floor_decal/corner/paleblue/border{
	dir = 10
	},
/obj/machinery/atmospherics/pipe/manifold/hidden/scrubbers{
	dir = 1
	},
/turf/simulated/floor/tiled/white,
/area/shuttle/auto/named/medbay)
"WS" = (
/obj/machinery/door/airlock/glass_external{
	req_one_access = null
	},
/obj/map_helper/access_helper/airlock/station/external_airlock,
/obj/structure/airlock_interconnect/hardmapped,
/obj/machinery/airlock_component/door_linker/outdoors/hardmapped,
/turf/simulated/floor/tiled/eris/techmaint_panels,
/area/shuttle/auto/named/medbay)
"Xi" = (
/obj/structure/window/reinforced{
	dir = 8
	},
/obj/machinery/power/apc/north_mount{
	alarms_hidden = 1;
	req_access = list();
	req_one_access = list(11,67)
	},
/obj/structure/table/glass,
/obj/machinery/recharger,
/obj/structure/cable{
	icon_state = "0-2"
	},
/obj/effect/floor_decal/borderfloorwhite{
	dir = 1
	},
/obj/effect/floor_decal/corner/paleblue/border{
	dir = 1
	},
/turf/simulated/floor/tiled/white,
/area/shuttle/auto/named/cockpit)
"Xk" = (
/obj/effect/floor_decal/borderfloorwhite/corner,
/obj/effect/floor_decal/corner/paleblue/bordercorner,
/turf/simulated/floor/tiled/white,
/area/shuttle/auto/named/medbay)
"Yr" = (
/obj/machinery/atmospherics/pipe/simple/hidden{
	dir = 5
	},
/obj/structure/cable{
	icon_state = "1-4"
	},
/obj/machinery/atmospherics/pipe/manifold/hidden/supply{
	dir = 8
	},
/turf/simulated/floor/tiled/eris/dark/techfloor,
/area/shuttle/auto/named/engine)
"Yx" = (
/obj/machinery/airlock_component/interface/shuttle/port/hardmapped,
/obj/structure/airlock_interconnect/hardmapped,
/turf/simulated/floor/tiled/eris/steel/gray_perforated,
/area/shuttle/auto/named/medbay)

(1,1,1) = {"
fX
fX
fX
fX
fX
fX
fX
fX
fX
fX
fX
fX
fX
fX
fX
fX
fX
fX
fX
fX
fX
fX
fX
fX
fX
fX
fX
fX
fX
fX
"}
(2,1,1) = {"
fX
fX
fX
fX
fX
fX
fX
fX
fX
fX
fX
fX
fX
fX
fX
fX
fX
fX
fX
fX
fX
fX
fX
fX
fX
fX
fX
fX
fX
fX
"}
(3,1,1) = {"
fX
fX
fX
fX
fX
fX
fX
fX
fX
fX
fX
fX
fX
fX
fX
fX
fX
fX
fX
fX
fX
fX
fX
fX
fX
fX
fX
fX
fX
fX
"}
(4,1,1) = {"
fX
fX
fX
fX
fX
fX
fX
fX
fX
fX
fX
fX
fX
fX
fX
fX
fX
fX
fX
fX
fX
fX
fX
fX
fX
fX
fX
fX
fX
fX
"}
(5,1,1) = {"
fX
fX
fX
fX
fX
fX
fX
fX
fX
fX
fX
fX
fX
fX
fX
fX
fX
fX
fX
fX
fX
fX
fX
fX
fX
fX
fX
fX
fX
fX
"}
(6,1,1) = {"
fX
fX
fX
fX
fX
fX
fX
fX
fX
fX
fX
fX
fX
fX
fX
fX
fX
fX
fX
fX
fX
fX
fX
fX
fX
fX
fX
fX
fX
fX
"}
(7,1,1) = {"
fX
fX
fX
fX
fX
fX
fX
fX
fX
fX
fX
fX
fX
fX
fX
fX
fX
fX
fX
fX
fX
fX
fX
fX
fX
fX
fX
fX
fX
fX
"}
(8,1,1) = {"
fX
fX
fX
fX
fX
fX
fX
fX
fX
fX
gA
gA
gA
me
me
gA
gA
gA
fX
fX
fX
fX
fX
fX
fX
fX
fX
fX
fX
fX
"}
(9,1,1) = {"
fX
fX
fX
fX
fX
fX
fX
fX
fX
fX
gA
iQ
gA
zX
ry
gA
yi
gA
fX
fX
fX
fX
fX
fX
fX
fX
fX
fX
fX
fX
"}
(10,1,1) = {"
fX
fX
fX
fX
fX
fX
fX
fX
fX
fX
mh
aM
vv
Yr
dc
QV
yP
mh
fX
fX
fX
fX
fX
fX
fX
fX
fX
fX
fX
fX
"}
(11,1,1) = {"
fX
fX
fX
fX
fX
fX
fX
fX
fX
fX
gA
Hu
Qm
HH
gP
KU
Vt
gA
fX
fX
fX
fX
fX
fX
fX
fX
fX
fX
fX
fX
"}
(12,1,1) = {"
fX
fX
fX
fX
fX
fX
fX
fX
fX
fX
jj
gA
gA
hM
Pu
gA
gA
gA
fX
fX
fX
fX
fX
fX
fX
fX
fX
fX
fX
fX
"}
(13,1,1) = {"
fX
fX
fX
fX
fX
fX
fX
fX
fX
fX
KS
IL
sy
JJ
wY
VJ
Pf
BQ
fX
fX
fX
fX
fX
fX
fX
fX
fX
fX
fX
fX
"}
(14,1,1) = {"
fX
fX
fX
fX
fX
fX
fX
fX
fX
fX
WS
Yx
Bo
bA
nG
bh
FW
yt
fX
fX
fX
fX
fX
fX
fX
fX
fX
fX
fX
fX
"}
(15,1,1) = {"
fX
fX
fX
fX
fX
fX
fX
fX
fX
fX
yt
yt
yt
dW
An
fl
yt
yt
fX
fX
fX
fX
fX
fX
fX
fX
fX
fX
fX
fX
"}
(16,1,1) = {"
fX
fX
fX
fX
fX
fX
fX
fX
fX
fX
yt
gZ
MM
DZ
gq
nC
gg
yt
fX
fX
fX
fX
fX
fX
fX
fX
fX
fX
fX
fX
"}
(17,1,1) = {"
fX
fX
fX
fX
fX
fX
fX
fX
fX
fX
iT
Qz
nQ
wm
Ma
hr
ee
iT
fX
fX
fX
fX
fX
fX
fX
fX
fX
fX
fX
fX
"}
(18,1,1) = {"
fX
fX
fX
fX
fX
fX
fX
fX
fX
fX
iT
Vr
nQ
Wk
Kp
zx
xA
iT
fX
fX
fX
fX
fX
fX
fX
fX
fX
fX
fX
fX
"}
(19,1,1) = {"
fX
fX
fX
fX
fX
fX
fX
fX
fX
fX
Ki
wb
Pp
BL
VN
Xk
uK
Ki
fX
fX
fX
fX
fX
fX
fX
fX
fX
fX
fX
fX
"}
(20,1,1) = {"
fX
fX
fX
fX
fX
fX
fX
fX
fX
fX
VY
VY
Xi
aP
xC
ij
VY
VY
fX
fX
fX
fX
fX
fX
fX
fX
fX
fX
fX
fX
"}
(21,1,1) = {"
fX
fX
fX
fX
fX
fX
fX
fX
fX
fX
hV
VY
nF
Ah
jB
te
VY
KM
fX
fX
fX
fX
fX
fX
fX
fX
fX
fX
fX
fX
"}
(22,1,1) = {"
fX
fX
fX
fX
fX
fX
fX
fX
fX
fX
vJ
VY
VY
qQ
ca
VY
VY
vJ
fX
fX
fX
fX
fX
fX
fX
fX
fX
fX
fX
fX
"}
(23,1,1) = {"
fX
fX
fX
fX
fX
fX
fX
fX
fX
fX
vJ
vJ
VY
dr
dr
VY
vJ
vJ
fX
fX
fX
fX
fX
fX
fX
fX
fX
fX
fX
fX
"}
(24,1,1) = {"
fX
fX
fX
fX
fX
fX
fX
fX
fX
fX
fX
fX
fX
fX
fX
fX
fX
fX
fX
fX
fX
fX
fX
fX
fX
fX
fX
fX
fX
fX
"}
(25,1,1) = {"
fX
fX
fX
fX
fX
fX
fX
fX
fX
fX
fX
fX
fX
fX
fX
fX
fX
fX
fX
fX
fX
fX
fX
fX
fX
fX
fX
fX
fX
fX
"}
(26,1,1) = {"
fX
fX
fX
fX
fX
fX
fX
fX
fX
fX
fX
fX
fX
fX
fX
fX
fX
fX
fX
fX
fX
fX
fX
fX
fX
fX
fX
fX
fX
fX
"}
(27,1,1) = {"
fX
fX
fX
fX
fX
fX
fX
fX
fX
fX
fX
fX
fX
fX
fX
fX
fX
fX
fX
fX
fX
fX
fX
fX
fX
fX
fX
fX
fX
fX
"}
(28,1,1) = {"
fX
fX
fX
fX
fX
fX
fX
fX
fX
fX
fX
fX
fX
fX
fX
fX
fX
fX
fX
fX
fX
fX
fX
fX
fX
fX
fX
fX
fX
fX
"}
(29,1,1) = {"
fX
fX
fX
fX
fX
fX
fX
fX
fX
fX
fX
fX
fX
fX
fX
fX
fX
fX
fX
fX
fX
fX
fX
fX
fX
fX
fX
fX
fX
fX
"}
(30,1,1) = {"
fX
fX
fX
fX
fX
fX
fX
fX
fX
fX
fX
fX
fX
fX
fX
fX
fX
fX
fX
fX
fX
fX
fX
fX
fX
fX
fX
fX
fX
fX
"}
