//MAP CONVERTED BY dmm2tgm.py THIS HEADER COMMENT PREVENTS RECONVERSION, DO NOT REMOVE
"aW" = (
/obj/machinery/atmospherics/pipe/simple/hidden/aux,
/turf/simulated/wall/rshull,
/area/shuttle/auto/named/deck)
"cJ" = (
/turf/simulated/floor/tiled/eris/dark/techfloor_grid,
/area/shuttle/auto/named/cockpit)
"eV" = (
/turf/simulated/wall/rshull,
/area/shuttle/auto/named/engine)
"hM" = (
/obj/structure/window/reinforced{
	dir = 8
	},
/obj/machinery/atmospherics/portables_connector/aux,
/obj/machinery/portable_atmospherics/canister/air,
/obj/effect/floor_decal/industrial/outline/grey,
/turf/simulated/floor/tiled/eris/steel/gray_perforated,
/area/shuttle/auto/named/deck)
"ib" = (
/turf/simulated/floor/tiled/eris/dark/violetcorener,
/area/shuttle/auto/named/deck)
"if" = (
/obj/structure/window/reinforced{
	dir = 4
	},
/obj/structure/window/reinforced{
	dir = 1
	},
/obj/structure/bed/chair/bay/chair,
/turf/simulated/floor/tiled/eris/dark/violetcorener,
/area/shuttle/auto/named/deck)
"ih" = (
/obj/structure/bed/chair/bay/chair{
	dir = 1
	},
/turf/simulated/floor/tiled/eris/dark/violetcorener,
/area/shuttle/auto/named/deck)
"iu" = (
/obj/structure/cable/green{
	icon_state = "1-2"
	},
/turf/simulated/floor/tiled/eris/steel/gray_perforated,
/area/shuttle/auto/named/deck)
"iL" = (
/turf/space/basic,
/area/space)
"jc" = (
/obj/machinery/atmospherics/portables_connector/fuel{
	dir = 8
	},
/obj/machinery/portable_atmospherics/canister/phoron,
/obj/effect/floor_decal/industrial/outline/red,
/turf/simulated/floor/tiled/eris/dark/techfloor_grid,
/area/shuttle/auto/named/engine)
"kj" = (
/turf/simulated/floor/tiled/eris/steel/gray_perforated,
/area/shuttle/auto/named/deck)
"lz" = (
/obj/machinery/power/smes/buildable/point_of_interest,
/obj/structure/cable/cyan{
	icon_state = "0-4"
	},
/turf/simulated/floor/tiled/eris/dark/techfloor_grid,
/area/shuttle/auto/named/engine)
"mM" = (
/obj/machinery/door/window/brigdoor/eastleft,
/turf/simulated/floor/tiled/eris/dark/violetcorener,
/area/shuttle/auto/named/deck)
"nL" = (
/obj/machinery/door/airlock/glass_external{
	req_one_access = null
	},
/obj/structure/cable/green{
	icon_state = "4-8"
	},
/obj/map_helper/airlock/door/ext_door,
/obj/map_helper/access_helper/airlock/station/external_airlock,
/turf/simulated/floor/tiled/eris/techmaint_panels,
/area/shuttle/auto/named/deck)
"ok" = (
/obj/structure/cable/green{
	icon_state = "1-2"
	},
/turf/simulated/floor/tiled/eris/techmaint_panels,
/area/shuttle/auto/named/deck)
"om" = (
/obj/machinery/door/airlock/multi_tile/metal/mait,
/obj/structure/cable/cyan{
	icon_state = "1-2"
	},
/turf/simulated/floor/tiled/eris/techmaint_panels,
/area/shuttle/auto/named/deck)
"ov" = (
/obj/structure/bed/chair/bay/chair/padded/beige{
	dir = 4
	},
/turf/simulated/floor/tiled/eris/steel/gray_perforated,
/area/shuttle/auto/named/deck)
"oy" = (
/obj/machinery/atmospherics/pipe/simple/hidden/aux{
	dir = 9
	},
/obj/structure/cable/green{
	icon_state = "1-2"
	},
/turf/simulated/floor/tiled/eris/steel/gray_perforated,
/area/shuttle/auto/named/deck)
"pr" = (
/obj/structure/cable/cyan{
	icon_state = "1-8"
	},
/obj/machinery/atmospherics/pipe/simple/hidden/aux{
	dir = 5
	},
/turf/simulated/floor/tiled/eris/steel/gray_perforated,
/area/shuttle/auto/named/deck)
"pz" = (
/obj/machinery/door/blast/regular{
	density = 0;
	dir = 2;
	icon_state = "pdoor0";
	id = "securiship blast";
	name = "Shuttle Blast Doors";
	opacity = 0
	},
/obj/spawner/window/low_wall/reinforced/firelocks,
/turf/simulated/floor/plating,
/area/shuttle/auto/named/deck)
"pJ" = (
/obj/machinery/computer/shuttle_control{
	dir = 8
	},
/turf/simulated/floor/tiled/eris/dark/techfloor,
/area/shuttle/auto/named/deck)
"pL" = (
/obj/machinery/door/airlock/glass_external{
	req_one_access = null
	},
/obj/map_helper/airlock/door/ext_door,
/obj/machinery/airlock_sensor/airlock_exterior/shuttle{
	dir = 4;
	pixel_y = -28
	},
/obj/map_helper/airlock/sensor/ext_sensor,
/obj/map_helper/access_helper/airlock/station/external_airlock,
/turf/simulated/floor/tiled/eris/techmaint_panels,
/area/shuttle/auto/named/deck)
"qF" = (
/obj/structure/window/reinforced{
	dir = 8
	},
/obj/machinery/power/apc/east_mount{
	req_access = list();
	req_one_access = list(11,67)
	},
/obj/structure/cable/cyan{
	icon_state = "0-2"
	},
/obj/machinery/atmospherics/pipe/simple/hidden/aux,
/turf/simulated/floor/tiled/eris/steel/gray_perforated,
/area/shuttle/auto/named/deck)
"rY" = (
/obj/structure/cable/cyan{
	icon_state = "0-4"
	},
/obj/machinery/power/apc/west_mount{
	req_access = list();
	req_one_access = list(11,67)
	},
/turf/simulated/floor/tiled/eris/dark/techfloor_grid,
/area/shuttle/auto/named/cockpit)
"sD" = (
/obj/machinery/computer/ship/engines{
	dir = 4
	},
/turf/simulated/floor/tiled/eris/dark/techfloor_grid,
/area/shuttle/auto/named/cockpit)
"sQ" = (
/obj/machinery/atmospherics/pipe/simple/hidden/aux{
	dir = 6
	},
/turf/simulated/wall/rshull,
/area/shuttle/auto/named/deck)
"tJ" = (
/obj/machinery/computer/ship/sensors{
	dir = 8
	},
/turf/simulated/floor/tiled/eris/dark/techfloor_grid,
/area/shuttle/auto/named/cockpit)
"tP" = (
/obj/structure/cable/cyan{
	icon_state = "2-4"
	},
/obj/structure/cable/cyan{
	icon_state = "1-2"
	},
/turf/simulated/floor/tiled/eris/steel/gray_perforated,
/area/shuttle/auto/named/deck)
"uC" = (
/obj/structure/window/reinforced{
	dir = 1
	},
/obj/structure/bed/chair/bay/chair,
/turf/simulated/floor/tiled/eris/dark/violetcorener,
/area/shuttle/auto/named/deck)
"vX" = (
/obj/machinery/atmospherics/pipe/simple/hidden/fuel{
	dir = 10
	},
/turf/simulated/wall/rshull,
/area/shuttle/auto/named/engine)
"wn" = (
/obj/machinery/door/blast/regular{
	density = 0;
	dir = 4;
	icon_state = "pdoor0";
	id = "securiship blast";
	name = "Shuttle Blast Doors";
	opacity = 0
	},
/obj/spawner/window/low_wall/reinforced/firelocks,
/turf/simulated/floor/plating,
/area/shuttle/auto/named/deck)
"wN" = (
/obj/machinery/atmospherics/pipe/simple/hidden/fuel{
	dir = 6
	},
/obj/structure/cable/green{
	icon_state = "1-2"
	},
/turf/simulated/floor/tiled/eris/dark/techfloor_grid,
/area/shuttle/auto/named/engine)
"xh" = (
/obj/machinery/door/airlock/glass_external{
	req_one_access = null
	},
/obj/machinery/atmospherics/pipe/simple/hidden/aux,
/obj/map_helper/airlock/door/int_door,
/obj/structure/cable/green{
	icon_state = "1-2"
	},
/obj/map_helper/access_helper/airlock/station/external_airlock,
/turf/simulated/floor/tiled/eris/techmaint_panels,
/area/shuttle/auto/named/deck)
"xS" = (
/obj/structure/cable/cyan{
	icon_state = "2-8"
	},
/turf/simulated/floor/tiled/eris/dark/techfloor_grid,
/area/shuttle/auto/named/cockpit)
"yh" = (
/obj/effect/floor_decal/industrial/warning/full,
/obj/machinery/atmospherics/component/unary/vent_pump/high_volume/aux{
	dir = 8
	},
/obj/map_helper/airlock/atmos/pump_out_external,
/turf/simulated/floor/airless,
/area/shuttle/auto/named/deck)
"ym" = (
/obj/machinery/atmospherics/pipe/simple/hidden/fuel{
	dir = 6
	},
/turf/simulated/wall/rshull,
/area/shuttle/auto/named/engine)
"zr" = (
/turf/simulated/wall/rshull,
/area/shuttle/auto/named/deck)
"zD" = (
/obj/machinery/atmospherics/pipe/simple/hidden/fuel{
	dir = 5
	},
/obj/machinery/air_alarm{
	dir = 1;
	pixel_y = -22
	},
/turf/simulated/floor/tiled/eris/dark/techfloor_grid,
/area/shuttle/auto/named/engine)
"zY" = (
/obj/machinery/atmospherics/pipe/manifold/hidden/fuel{
	dir = 1
	},
/turf/simulated/wall/rshull,
/area/shuttle/auto/named/engine)
"AC" = (
/obj/structure/bed/chair/bay/chair/padded/beige{
	dir = 1
	},
/obj/machinery/button/remote/blast_door{
	id = "securiship blast";
	name = "Shuttle Blast Doors";
	pixel_x = -28;
	pixel_y = 28;
	req_access = list(67)
	},
/turf/simulated/floor/tiled/eris/dark/techfloor_grid,
/area/shuttle/auto/named/cockpit)
"BL" = (
/obj/machinery/door/blast/regular{
	density = 0;
	dir = 4;
	icon_state = "pdoor0";
	id = "securiship blast";
	name = "Shuttle Blast Doors";
	opacity = 0
	},
/obj/spawner/window/low_wall/reinforced/firelocks,
/turf/simulated/floor/plating,
/area/shuttle/auto/named/cockpit)
"Cr" = (
/obj/structure/cable/cyan{
	icon_state = "0-8"
	},
/obj/structure/cable/cyan{
	icon_state = "0-4"
	},
/obj/machinery/power/apc/north_mount{
	alarms_hidden = 1;
	req_access = list();
	req_one_access = list(11,67)
	},
/turf/simulated/floor/tiled/eris/dark/techfloor_grid,
/area/shuttle/auto/named/engine)
"Dj" = (
/obj/machinery/power/terminal{
	dir = 1
	},
/obj/structure/cable/green{
	icon_state = "0-4"
	},
/obj/structure/table/standard,
/obj/item/tank/phoron,
/turf/simulated/floor/tiled/eris/dark/techfloor_grid,
/area/shuttle/auto/named/engine)
"DG" = (
/obj/machinery/atmospherics/component/unary/engine{
	dir = 1
	},
/turf/simulated/floor/airless,
/area/shuttle/auto/named/engine)
"DV" = (
/obj/machinery/computer/ship/helm{
	req_one_access = list(67,58)
	},
/turf/simulated/floor/tiled/eris/dark/techfloor_grid,
/area/shuttle/auto/named/cockpit)
"Ec" = (
/obj/machinery/atmospherics/pipe/simple/hidden/aux{
	dir = 8
	},
/obj/machinery/airlock_sensor{
	pixel_y = 28
	},
/obj/map_helper/airlock/sensor/int_sensor,
/turf/simulated/floor/tiled/eris/steel/gray_perforated,
/area/shuttle/auto/named/deck)
"Fg" = (
/obj/structure/cable/cyan{
	icon_state = "1-8"
	},
/turf/simulated/floor/tiled/eris/dark/techfloor_grid,
/area/shuttle/auto/named/engine)
"Fi" = (
/obj/machinery/atmospherics/pipe/manifold/hidden/fuel{
	dir = 1
	},
/turf/simulated/floor/tiled/eris/dark/techfloor_grid,
/area/shuttle/auto/named/engine)
"Hh" = (
/obj/structure/cable/green{
	icon_state = "1-8"
	},
/obj/structure/table/rack/shelf,
/obj/machinery/air_alarm{
	breach_detection = 0;
	dir = 8;
	pixel_x = 25;
	rcon_setting = 3;
	report_danger_level = 0
	},
/turf/simulated/floor/tiled/eris/dark/techfloor,
/area/shuttle/auto/named/deck)
"KH" = (
/obj/structure/cable/green{
	icon_state = "4-8"
	},
/turf/simulated/floor/tiled/eris/dark/techfloor_grid,
/area/shuttle/auto/named/engine)
"MZ" = (
/obj/machinery/light{
	dir = 4
	},
/obj/structure/cable/cyan{
	icon_state = "1-2"
	},
/obj/machinery/atmospherics/pipe/simple/hidden/aux,
/turf/simulated/floor/tiled/eris/steel/gray_perforated,
/area/shuttle/auto/named/deck)
"Nz" = (
/obj/structure/cable/green{
	icon_state = "2-4"
	},
/obj/machinery/atmospherics/component/unary/vent_pump/high_volume/aux{
	dir = 1
	},
/obj/map_helper/airlock/atmos/pump_out_internal,
/obj/machinery/airlock_sensor{
	pixel_y = 28
	},
/obj/map_helper/airlock/sensor/chamber_sensor,
/obj/effect/shuttle_landmark{
	base_area = /area/space;
	base_turf = /turf/space;
	docking_controller = "securiship_bay";
	landmark_tag = "tether_securiship_dock";
	name = "Securiship Dock"
	},
/obj/overmap/entity/visitable/ship/landable/securiship,
/turf/simulated/floor/tiled/eris/techmaint_cargo,
/area/shuttle/auto/named/deck)
"Ok" = (
/turf/simulated/wall/rshull,
/area/shuttle/auto/named/cockpit)
"OT" = (
/obj/machinery/shipsensors{
	dir = 1
	},
/obj/effect/floor_decal/industrial/warning/full,
/turf/simulated/floor/airless,
/area/shuttle/auto/named/cockpit)
"OU" = (
/obj/machinery/atmospherics/pipe/manifold/hidden/fuel,
/turf/simulated/wall/rshull,
/area/shuttle/auto/named/engine)
"Qp" = (
/obj/machinery/light,
/obj/structure/cable/green{
	icon_state = "1-8"
	},
/obj/machinery/atmospherics/component/binary/pump/fuel,
/turf/simulated/floor/tiled/eris/dark/techfloor_grid,
/area/shuttle/auto/named/engine)
"QV" = (
/obj/structure/window/reinforced{
	dir = 8
	},
/obj/machinery/atmospherics/pipe/simple/hidden/aux,
/obj/structure/closet/walllocker/emergsuit_wall{
	pixel_x = 27
	},
/turf/simulated/floor/tiled/eris/steel/gray_perforated,
/area/shuttle/auto/named/deck)
"RS" = (
/obj/machinery/light{
	dir = 8
	},
/obj/structure/bed/chair/bay/chair/padded/beige{
	dir = 4
	},
/turf/simulated/floor/tiled/eris/steel/gray_perforated,
/area/shuttle/auto/named/deck)
"RW" = (
/obj/structure/cable/green{
	icon_state = "2-4"
	},
/turf/simulated/floor/tiled/eris/steel/gray_perforated,
/area/shuttle/auto/named/deck)
"SR" = (
/obj/structure/cable/cyan{
	icon_state = "1-2"
	},
/obj/structure/bed/chair/bay/chair/padded/beige,
/turf/simulated/floor/tiled/eris/steel/gray_perforated,
/area/shuttle/auto/named/deck)
"Ue" = (
/obj/structure/cable/green{
	icon_state = "4-8"
	},
/obj/structure/table/rack/shelf,
/turf/simulated/floor/tiled/eris/dark/techfloor,
/area/shuttle/auto/named/deck)
"Us" = (
/obj/structure/cable/cyan{
	icon_state = "1-2"
	},
/turf/simulated/floor/tiled/eris/steel/gray_perforated,
/area/shuttle/auto/named/deck)
"Uw" = (
/obj/structure/bed/chair/bay/chair/padded/beige{
	dir = 4
	},
/turf/simulated/floor/tiled/eris/dark/techfloor,
/area/shuttle/auto/named/deck)
"UM" = (
/obj/structure/cable/green{
	icon_state = "4-8"
	},
/obj/structure/shuttle_fuel_port{
	dir = 1
	},
/turf/simulated/floor/tiled/eris/dark/techfloor_grid,
/area/shuttle/auto/named/engine)
"Vk" = (
/obj/machinery/atmospherics/pipe/simple/hidden/fuel{
	dir = 8
	},
/turf/simulated/wall/rshull,
/area/shuttle/auto/named/engine)
"XC" = (
/obj/structure/cable/cyan{
	icon_state = "4-8"
	},
/turf/simulated/floor/tiled/eris/dark/techfloor_grid,
/area/shuttle/auto/named/cockpit)
"XX" = (
/obj/machinery/atmospherics/component/unary/vent_pump/high_volume/aux,
/obj/map_helper/airlock/atmos/chamber_pump,
/obj/machinery/light/small{
	dir = 8
	},
/obj/structure/cable/green{
	icon_state = "1-2"
	},
/turf/simulated/floor/tiled/eris/techmaint_cargo,
/area/shuttle/auto/named/deck)
"Yi" = (
/obj/structure/window/reinforced{
	dir = 4
	},
/obj/structure/bed/chair/bay/chair{
	dir = 1
	},
/turf/simulated/floor/tiled/eris/dark/violetcorener,
/area/shuttle/auto/named/deck)

(1,1,1) = {"
iL
iL
iL
iL
iL
iL
iL
iL
iL
iL
iL
iL
iL
iL
iL
iL
iL
iL
iL
iL
iL
iL
iL
iL
iL
iL
iL
iL
iL
iL
"}
(2,1,1) = {"
iL
iL
iL
iL
iL
iL
iL
iL
iL
iL
iL
iL
iL
iL
iL
iL
iL
iL
iL
iL
iL
iL
iL
iL
iL
iL
iL
iL
iL
iL
"}
(3,1,1) = {"
iL
iL
iL
iL
iL
iL
iL
iL
iL
iL
iL
iL
iL
iL
iL
iL
iL
iL
iL
iL
iL
iL
iL
iL
iL
iL
iL
iL
iL
iL
"}
(4,1,1) = {"
iL
iL
iL
iL
iL
iL
iL
iL
iL
iL
iL
iL
iL
iL
iL
iL
iL
iL
iL
iL
iL
iL
iL
iL
iL
iL
iL
iL
iL
iL
"}
(5,1,1) = {"
iL
iL
iL
iL
iL
iL
iL
iL
iL
iL
iL
iL
iL
iL
iL
iL
iL
iL
iL
iL
iL
iL
iL
iL
iL
iL
iL
iL
iL
iL
"}
(6,1,1) = {"
iL
iL
iL
iL
iL
iL
iL
iL
iL
iL
iL
iL
iL
iL
iL
iL
iL
iL
iL
iL
iL
iL
iL
iL
iL
iL
iL
iL
iL
iL
"}
(7,1,1) = {"
iL
iL
iL
iL
iL
iL
iL
iL
iL
iL
iL
iL
iL
iL
iL
iL
iL
iL
iL
iL
iL
iL
iL
iL
iL
iL
iL
iL
iL
iL
"}
(8,1,1) = {"
iL
iL
iL
iL
iL
iL
iL
iL
iL
iL
iL
iL
iL
iL
iL
iL
iL
iL
iL
iL
iL
iL
iL
iL
iL
iL
iL
iL
iL
iL
"}
(9,1,1) = {"
iL
iL
iL
iL
iL
iL
iL
iL
iL
iL
iL
iL
iL
iL
iL
iL
iL
iL
iL
iL
iL
iL
iL
iL
iL
iL
iL
iL
iL
iL
"}
(10,1,1) = {"
iL
iL
iL
iL
iL
iL
iL
iL
iL
iL
iL
iL
iL
iL
iL
iL
iL
iL
iL
iL
iL
iL
iL
iL
iL
iL
iL
iL
iL
iL
"}
(11,1,1) = {"
iL
iL
iL
iL
iL
iL
iL
iL
iL
iL
iL
iL
iL
iL
iL
iL
iL
iL
iL
iL
iL
iL
iL
iL
iL
iL
iL
iL
iL
iL
"}
(12,1,1) = {"
iL
iL
iL
iL
iL
iL
OT
Ok
Ok
Ok
zr
wn
wn
zr
zr
zr
eV
eV
eV
eV
iL
iL
iL
iL
iL
iL
iL
iL
iL
iL
"}
(13,1,1) = {"
iL
iL
iL
iL
iL
iL
Ok
Ok
sD
rY
RS
ov
uC
ib
ih
zr
lz
Dj
ym
DG
iL
iL
iL
iL
iL
iL
iL
iL
iL
iL
"}
(14,1,1) = {"
iL
iL
iL
iL
iL
iL
BL
DV
AC
XC
kj
kj
if
mM
Yi
zr
Cr
KH
zY
DG
iL
iL
iL
iL
iL
iL
iL
iL
iL
iL
"}
(15,1,1) = {"
iL
iL
iL
iL
iL
iL
BL
cJ
tJ
xS
Us
tP
SR
Us
Us
om
Fg
UM
Vk
eV
iL
iL
iL
iL
iL
iL
iL
iL
iL
iL
"}
(16,1,1) = {"
iL
iL
iL
iL
iL
iL
zr
hM
QV
qF
MZ
pr
kj
RW
iu
ok
wN
Qp
OU
eV
iL
iL
iL
iL
iL
iL
iL
iL
iL
iL
"}
(17,1,1) = {"
iL
iL
iL
iL
iL
iL
zr
zr
zr
zr
zr
Ec
kj
Ue
Uw
zr
Fi
zD
zY
DG
iL
iL
iL
iL
iL
iL
iL
iL
iL
iL
"}
(18,1,1) = {"
iL
iL
iL
iL
iL
iL
sQ
aW
Nz
XX
xh
oy
iu
Hh
pJ
zr
jc
jc
vX
DG
iL
iL
iL
iL
iL
iL
iL
iL
iL
iL
"}
(19,1,1) = {"
iL
iL
iL
iL
iL
iL
yh
zr
nL
pL
zr
pz
pz
zr
pz
zr
eV
eV
eV
eV
iL
iL
iL
iL
iL
iL
iL
iL
iL
iL
"}
(20,1,1) = {"
iL
iL
iL
iL
iL
iL
iL
iL
iL
iL
iL
iL
iL
iL
iL
iL
iL
iL
iL
iL
iL
iL
iL
iL
iL
iL
iL
iL
iL
iL
"}
(21,1,1) = {"
iL
iL
iL
iL
iL
iL
iL
iL
iL
iL
iL
iL
iL
iL
iL
iL
iL
iL
iL
iL
iL
iL
iL
iL
iL
iL
iL
iL
iL
iL
"}
(22,1,1) = {"
iL
iL
iL
iL
iL
iL
iL
iL
iL
iL
iL
iL
iL
iL
iL
iL
iL
iL
iL
iL
iL
iL
iL
iL
iL
iL
iL
iL
iL
iL
"}
(23,1,1) = {"
iL
iL
iL
iL
iL
iL
iL
iL
iL
iL
iL
iL
iL
iL
iL
iL
iL
iL
iL
iL
iL
iL
iL
iL
iL
iL
iL
iL
iL
iL
"}
(24,1,1) = {"
iL
iL
iL
iL
iL
iL
iL
iL
iL
iL
iL
iL
iL
iL
iL
iL
iL
iL
iL
iL
iL
iL
iL
iL
iL
iL
iL
iL
iL
iL
"}
(25,1,1) = {"
iL
iL
iL
iL
iL
iL
iL
iL
iL
iL
iL
iL
iL
iL
iL
iL
iL
iL
iL
iL
iL
iL
iL
iL
iL
iL
iL
iL
iL
iL
"}
(26,1,1) = {"
iL
iL
iL
iL
iL
iL
iL
iL
iL
iL
iL
iL
iL
iL
iL
iL
iL
iL
iL
iL
iL
iL
iL
iL
iL
iL
iL
iL
iL
iL
"}
(27,1,1) = {"
iL
iL
iL
iL
iL
iL
iL
iL
iL
iL
iL
iL
iL
iL
iL
iL
iL
iL
iL
iL
iL
iL
iL
iL
iL
iL
iL
iL
iL
iL
"}
(28,1,1) = {"
iL
iL
iL
iL
iL
iL
iL
iL
iL
iL
iL
iL
iL
iL
iL
iL
iL
iL
iL
iL
iL
iL
iL
iL
iL
iL
iL
iL
iL
iL
"}
(29,1,1) = {"
iL
iL
iL
iL
iL
iL
iL
iL
iL
iL
iL
iL
iL
iL
iL
iL
iL
iL
iL
iL
iL
iL
iL
iL
iL
iL
iL
iL
iL
iL
"}
(30,1,1) = {"
iL
iL
iL
iL
iL
iL
iL
iL
iL
iL
iL
iL
iL
iL
iL
iL
iL
iL
iL
iL
iL
iL
iL
iL
iL
iL
iL
iL
iL
iL
"}
