//MAP CONVERTED BY dmm2tgm.py THIS HEADER COMMENT PREVENTS RECONVERSION, DO NOT REMOVE
"a" = (
/turf/space/basic,
/area/space)
"c" = (
/turf/simulated/shuttle/floor,
/area/shuttle/auto/one_single_area)
"f" = (
/obj/machinery/conveyor{
	dir = 4;
	id = "QMLoad2"
	},
/turf/simulated/shuttle/floor,
/area/shuttle/auto/one_single_area)
"g" = (
/turf/simulated/shuttle/wall,
/area/shuttle/auto/one_single_area)
"h" = (
/obj/structure/shuttle/engine/heater,
/obj/structure/window/reinforced{
	dir = 1
	},
/turf/simulated/floor/airless,
/area/shuttle/auto/one_single_area)
"l" = (
/obj/machinery/conveyor{
	dir = 4;
	id = "QMLoad"
	},
/obj/machinery/door/airlock/glass_external{
	frequency = 1380;
	icon_state = "door_locked";
	id_tag = "supply_shuttle_hatch";
	locked = 1;
	name = "Shuttle Hatch";
	req_one_access = null
	},
/obj/map_helper/access_helper/airlock/station/external_airlock,
/turf/simulated/shuttle/plating,
/area/shuttle/auto/one_single_area)
"m" = (
/obj/machinery/light{
	dir = 8
	},
/obj/machinery/airlock_peripheral/panel/hardmapped/west_mount,
/obj/machinery/airlock_component/controller/dock_hatch/hardmapped,
/obj/map_helper/airlock_linker/preset/shuttle_main,
/obj/structure/airlock_interconnect/hardmapped,
/turf/simulated/shuttle/floor,
/area/shuttle/auto/one_single_area)
"n" = (
/turf/space,
/area/space)
"p" = (
/obj/machinery/light{
	dir = 4
	},
/turf/simulated/shuttle/floor,
/area/shuttle/auto/one_single_area)
"q" = (
/obj/structure/shuttle/engine/propulsion{
	icon_state = "burst_l"
	},
/turf/simulated/shuttle/plating/airless/carry{
	dir = 1
	},
/area/shuttle/auto/one_single_area)
"r" = (
/obj/machinery/door/airlock/glass_external{
	frequency = 1380;
	icon_state = "door_locked";
	id_tag = "supply_shuttle_hatch";
	locked = 1;
	name = "Shuttle Hatch";
	req_one_access = null
	},
/obj/machinery/conveyor{
	dir = 4;
	id = "QMLoad2"
	},
/obj/map_helper/access_helper/airlock/station/external_airlock,
/obj/machinery/airlock_component/door_linker/outdoors/hardmapped,
/obj/structure/airlock_interconnect/hardmapped,
/obj/shuttle_aligner/port/two_wide/right_aligned/west/primary,
/turf/simulated/shuttle/plating,
/area/shuttle/auto/one_single_area)
"x" = (
/obj/machinery/door/airlock/glass_external{
	frequency = 1380;
	icon_state = "door_locked";
	id_tag = "supply_shuttle_hatch";
	locked = 1;
	name = "Shuttle Hatch";
	req_one_access = null
	},
/obj/map_helper/access_helper/airlock/station/external_airlock,
/turf/simulated/shuttle/floor,
/area/shuttle/auto/one_single_area)
"z" = (
/obj/machinery/conveyor{
	dir = 4;
	id = "QMLoad"
	},
/turf/simulated/shuttle/floor,
/area/shuttle/auto/one_single_area)
"E" = (
/obj/machinery/airlock_component/interface/shuttle/port/hardmapped,
/obj/structure/airlock_interconnect/hardmapped,
/turf/simulated/shuttle/floor,
/area/shuttle/auto/one_single_area)
"H" = (
/obj/machinery/conveyor{
	dir = 4;
	id = "QMLoad2"
	},
/obj/structure/airlock_interconnect/hardmapped,
/turf/simulated/shuttle/floor,
/area/shuttle/auto/one_single_area)
"J" = (
/obj/structure/shuttle/engine/propulsion,
/obj/effect/shuttle_landmark{
	base_area = /area/space;
	base_turf = /turf/space;
	landmark_tag = "supply_cc";
	name = "Centcom Supply Depot"
	},
/turf/simulated/shuttle/plating/airless/carry{
	dir = 1
	},
/area/shuttle/auto/one_single_area)
"M" = (
/obj/machinery/light{
	dir = 8
	},
/turf/simulated/shuttle/floor,
/area/shuttle/auto/one_single_area)
"N" = (
/obj/machinery/door/airlock/glass_external{
	frequency = 1380;
	icon_state = "door_locked";
	id_tag = "supply_shuttle_hatch";
	locked = 1;
	name = "Shuttle Hatch";
	req_one_access = null
	},
/obj/map_helper/access_helper/airlock/station/external_airlock,
/obj/machinery/airlock_component/door_linker/outdoors/hardmapped,
/obj/structure/airlock_interconnect/hardmapped,
/turf/simulated/shuttle/floor,
/area/shuttle/auto/one_single_area)
"V" = (
/obj/structure/shuttle/engine/propulsion,
/turf/simulated/shuttle/plating/airless/carry{
	dir = 1
	},
/area/shuttle/auto/one_single_area)
"W" = (
/obj/structure/shuttle/engine/propulsion{
	icon_state = "burst_r"
	},
/turf/simulated/shuttle/plating/airless/carry{
	dir = 1
	},
/area/shuttle/auto/one_single_area)

(1,1,1) = {"
a
a
a
a
a
a
a
a
a
a
a
a
a
a
a
"}
(2,1,1) = {"
a
a
a
a
a
a
a
a
a
a
a
a
a
a
a
"}
(3,1,1) = {"
a
a
a
a
a
a
a
a
a
a
a
a
a
a
a
"}
(4,1,1) = {"
a
a
a
a
a
a
a
a
a
a
a
a
a
a
a
"}
(5,1,1) = {"
a
g
g
g
r
N
g
x
l
g
g
g
a
a
a
"}
(6,1,1) = {"
a
g
c
m
H
E
c
c
z
M
g
g
q
a
a
"}
(7,1,1) = {"
a
g
c
c
f
c
c
c
z
c
c
h
V
a
a
"}
(8,1,1) = {"
a
g
c
c
f
c
c
c
z
c
c
h
J
a
a
"}
(9,1,1) = {"
a
g
c
c
c
c
c
c
c
c
c
h
V
a
a
"}
(10,1,1) = {"
a
g
c
p
c
c
c
c
c
p
g
g
W
a
a
"}
(11,1,1) = {"
a
g
g
g
g
g
g
g
g
g
g
g
n
a
a
"}
(12,1,1) = {"
a
a
a
a
a
a
a
a
a
a
a
a
a
a
a
"}
(13,1,1) = {"
a
a
a
a
a
a
a
a
a
a
a
a
a
a
a
"}
(14,1,1) = {"
a
a
a
a
a
a
a
a
a
a
a
a
a
a
a
"}
(15,1,1) = {"
a
a
a
a
a
a
a
a
a
a
a
a
a
a
a
"}
