//MAP CONVERTED BY dmm2tgm.py THIS HEADER COMMENT PREVENTS RECONVERSION, DO NOT REMOVE
"a" = (
/turf/template_noop,
/area/template_noop)
"c" = (
/turf/simulated/floor/greengrid,
/area/lavaland/bosses)
"e" = (
/mob/living/simple_mob/mechanical/cyber_horror/grey/surt,
/turf/simulated/floor/greengrid,
/area/lavaland/bosses)
"h" = (
/obj/effect/decal/remains/xeno,
/turf/simulated/floor/outdoors/lavaland,
/area/template_noop)
"j" = (
/obj/effect/decal/remains/mummy2,
/turf/simulated/floor/outdoors/lavaland,
/area/template_noop)
"l" = (
/obj/structure/railing{
	dir = 8
	},
/turf/simulated/floor/greengrid,
/area/lavaland/bosses)
"m" = (
/obj/effect/decal/cleanable/blood/gibs,
/turf/simulated/floor/greengrid,
/area/lavaland/bosses)
"r" = (
/turf/simulated/floor/bluegrid,
/area/lavaland/bosses)
"s" = (
/obj/structure/girder/displaced,
/turf/simulated/floor/greengrid,
/area/lavaland/bosses)
"t" = (
/turf/simulated/floor/outdoors/lavaland,
/area/template_noop)
"u" = (
/obj/effect/decal/remains/ribcage,
/turf/simulated/floor/outdoors/lavaland,
/area/template_noop)
"v" = (
/mob/living/simple_mob/mechanical/cyber_horror/surt,
/turf/simulated/floor/greengrid,
/area/lavaland/bosses)
"z" = (
/obj/structure/girder,
/turf/simulated/floor/bluegrid,
/area/lavaland/bosses)
"A" = (
/obj/effect/decal/remains/mummy1,
/turf/simulated/floor/outdoors/lavaland,
/area/template_noop)
"C" = (
/turf/simulated/wall/titanium,
/area/lavaland/bosses)
"D" = (
/obj/effect/forcefield/swarm,
/turf/simulated/floor/bluegrid,
/area/lavaland/bosses)
"E" = (
/obj/effect/floor_decal/corner_steel_grid,
/turf/simulated/floor/greengrid,
/area/lavaland/bosses)
"F" = (
/obj/effect/decal/remains/human,
/turf/simulated/floor/greengrid,
/area/lavaland/bosses)
"H" = (
/obj/effect/decal/remains/deer,
/turf/simulated/floor/outdoors/lavaland,
/area/template_noop)
"I" = (
/obj/effect/decal/remains/tajaran,
/turf/simulated/floor/outdoors/lavaland,
/area/template_noop)
"J" = (
/obj/structure/railing{
	dir = 1
	},
/turf/simulated/floor/greengrid,
/area/lavaland/bosses)
"M" = (
/obj/effect/floor_decal/corner_techfloor_grid,
/turf/simulated/floor/greengrid,
/area/lavaland/bosses)
"O" = (
/obj/effect/floor_decal/corner_techfloor_grid/diagonal,
/turf/simulated/floor/greengrid,
/area/lavaland/bosses)
"Q" = (
/obj/structure/barricade{
	dir = 8;
	icon = 'icons/obj/stairs.dmi';
	icon_state = null;
	name = "stairs"
	},
/obj/effect/forcefield/swarm,
/turf/simulated/floor/greengrid,
/area/lavaland/bosses)
"R" = (
/obj/random/multiple/treasure,
/obj/structure/closet/crate,
/turf/simulated/floor/greengrid,
/area/lavaland/bosses)
"S" = (
/obj/effect/decal/cleanable/blood/gibs,
/turf/simulated/floor/bluegrid,
/area/lavaland/bosses)
"U" = (
/turf/simulated/wall/solidrock,
/area/template_noop)
"V" = (
/mob/living/simple_mob/mechanical/cyber_horror/tajaran/surt,
/turf/simulated/floor/greengrid,
/area/lavaland/bosses)

(1,1,1) = {"
a
a
a
a
a
a
a
a
a
a
a
a
a
a
a
a
a
a
a
a
a
a
a
a
a
a
a
a
a
a
"}
(2,1,1) = {"
a
a
a
a
a
a
a
a
a
a
a
a
a
a
a
a
a
a
a
a
a
a
a
a
a
a
a
a
a
a
"}
(3,1,1) = {"
a
a
a
a
a
a
a
a
a
a
a
a
a
a
a
a
a
t
h
a
a
a
a
a
a
a
a
a
a
a
"}
(4,1,1) = {"
a
a
a
a
a
a
a
t
t
a
a
a
a
a
a
a
a
t
t
t
t
a
a
a
a
a
t
t
a
a
"}
(5,1,1) = {"
a
a
a
a
a
a
t
t
t
a
a
a
a
a
a
a
a
a
t
t
a
a
a
a
a
t
t
t
a
a
"}
(6,1,1) = {"
a
a
a
a
a
t
t
H
t
a
a
a
a
a
a
a
a
a
a
t
t
t
t
t
t
t
t
a
a
a
"}
(7,1,1) = {"
a
a
a
a
a
t
t
t
t
a
a
a
a
a
a
a
a
a
a
t
t
t
A
t
t
t
t
a
a
a
"}
(8,1,1) = {"
a
a
a
a
a
a
a
t
t
t
a
a
a
a
a
a
a
a
a
a
t
t
t
t
t
t
t
a
a
a
"}
(9,1,1) = {"
a
a
a
a
a
a
a
t
a
t
t
t
U
U
a
a
a
a
a
t
t
t
t
t
a
a
t
a
a
a
"}
(10,1,1) = {"
a
a
a
a
a
a
a
a
a
t
c
c
c
c
c
c
r
c
c
c
c
t
t
a
a
a
a
a
a
a
"}
(11,1,1) = {"
a
a
a
a
a
a
a
a
a
t
r
c
c
r
c
c
c
c
c
r
c
t
a
a
a
a
a
a
a
a
"}
(12,1,1) = {"
a
a
a
a
a
a
a
a
a
a
c
c
r
v
E
r
C
C
r
c
c
U
a
a
a
a
a
a
a
a
"}
(13,1,1) = {"
a
a
a
a
a
a
a
a
a
a
c
C
c
m
c
c
c
c
c
C
c
a
a
a
a
a
a
a
a
a
"}
(14,1,1) = {"
a
a
a
a
a
a
a
a
a
a
c
z
Q
J
r
c
e
r
c
C
r
a
a
a
a
a
a
a
a
a
"}
(15,1,1) = {"
a
a
a
a
a
a
a
a
a
a
c
C
D
J
c
R
c
c
O
C
c
a
a
a
a
a
a
a
a
a
"}
(16,1,1) = {"
a
a
a
a
a
a
a
a
a
j
c
C
l
F
c
r
c
r
c
C
c
a
a
a
a
a
a
a
a
a
"}
(17,1,1) = {"
a
a
a
a
a
a
a
a
a
t
r
C
r
c
r
c
c
c
c
r
c
a
a
a
a
a
a
a
a
a
"}
(18,1,1) = {"
a
a
a
a
a
a
a
a
a
t
c
V
C
v
c
s
c
C
C
c
c
t
a
a
a
a
a
a
a
a
"}
(19,1,1) = {"
a
a
a
a
a
a
a
a
a
t
c
M
r
c
c
r
c
c
S
c
r
t
a
a
a
a
a
a
a
a
"}
(20,1,1) = {"
a
a
a
a
a
a
a
a
a
t
c
c
c
c
c
c
c
r
c
c
c
t
t
a
a
a
a
a
a
a
"}
(21,1,1) = {"
a
a
a
a
a
a
t
t
t
t
t
t
t
a
a
a
a
a
U
t
t
t
t
t
a
a
a
a
a
a
"}
(22,1,1) = {"
a
a
a
a
a
t
t
t
t
a
a
a
a
a
a
a
a
a
a
a
t
t
u
t
t
t
t
t
a
a
"}
(23,1,1) = {"
a
a
a
a
a
t
t
t
t
a
a
a
a
a
a
a
a
a
a
a
t
t
t
t
t
t
t
t
a
a
"}
(24,1,1) = {"
a
a
a
a
a
t
t
t
a
a
a
a
a
a
a
a
a
a
a
t
t
t
a
a
t
t
t
t
a
a
"}
(25,1,1) = {"
a
a
a
a
a
a
t
t
a
a
a
a
a
a
a
a
a
a
a
t
t
t
a
a
a
t
t
t
a
a
"}
(26,1,1) = {"
a
a
a
a
a
a
a
a
a
a
a
a
a
a
a
a
a
a
a
t
t
a
a
a
a
a
t
t
t
a
"}
(27,1,1) = {"
a
a
a
a
a
a
a
a
a
a
a
a
a
a
a
a
a
a
t
t
t
a
a
a
a
a
a
t
t
a
"}
(28,1,1) = {"
a
a
a
a
a
a
a
a
a
a
a
a
a
a
a
a
a
a
I
t
a
a
a
a
a
a
a
a
a
a
"}
(29,1,1) = {"
a
a
a
a
a
a
a
a
a
a
a
a
a
a
a
a
a
a
a
a
a
a
a
a
a
a
a
a
a
a
"}
(30,1,1) = {"
a
a
a
a
a
a
a
a
a
a
a
a
a
a
a
a
a
a
a
a
a
a
a
a
a
a
a
a
a
a
"}
