//MAP CONVERTED BY dmm2tgm.py THIS HEADER COMMENT PREVENTS RECONVERSION, DO NOT REMOVE
"cY" = (
/obj/structure/closet/secure_closet/sar{
	name = "sar locker";
	req_access = list()
	},
/turf/simulated/floor/plating/lavaland,
/area/lavaland/idleruins)
"gJ" = (
/turf/simulated/floor/plating/lavaland,
/area/lavaland/idleruins)
"hd" = (
/obj/effect/debris/cleanable/blood/oil,
/turf/simulated/shuttle/floor/lavaland,
/area/lavaland/idleruins)
"hv" = (
/obj/structure/shuttle/window,
/obj/structure/grille,
/turf/simulated/floor/plating/lavaland,
/area/lavaland/idleruins)
"hH" = (
/obj/structure/table/rack,
/obj/effect/debris/cleanable/cobweb2,
/turf/simulated/shuttle/floor/lavaland,
/area/lavaland/idleruins)
"jd" = (
/obj/effect/debris/cleanable/generic,
/turf/simulated/mineral/floor/ignore_mapgen/lavaland,
/area/lavaland/idleruins)
"kt" = (
/obj/effect/debris/cleanable/generic,
/turf/simulated/floor/outdoors/lavaland,
/area/lavaland/idleruins)
"nr" = (
/obj/structure/frame,
/turf/simulated/shuttle/floor/lavaland,
/area/lavaland/idleruins)
"or" = (
/turf/template_noop,
/area/template_noop)
"oN" = (
/obj/item/material/shard/shrapnel,
/turf/simulated/floor/outdoors/lavaland,
/area/lavaland/idleruins)
"qO" = (
/obj/structure/table/standard,
/obj/random/unidentified_medicine/fresh_medicine,
/obj/random/unidentified_medicine/fresh_medicine,
/obj/random/unidentified_medicine/old_medicine,
/turf/simulated/shuttle/floor/lavaland,
/area/lavaland/idleruins)
"ri" = (
/obj/structure/table/rack,
/turf/simulated/shuttle/floor/lavaland,
/area/lavaland/idleruins)
"rw" = (
/obj/item/stack/material/steel,
/turf/simulated/floor/outdoors/lavaland,
/area/lavaland/idleruins)
"rG" = (
/obj/effect/debris/cleanable/dirt,
/turf/simulated/shuttle/floor/lavaland,
/area/lavaland/idleruins)
"sI" = (
/obj/item/material/shard/shrapnel,
/turf/simulated/shuttle/floor/lavaland,
/area/lavaland/idleruins)
"uc" = (
/obj/effect/debris/cleanable/dirt,
/obj/effect/debris/cleanable/generic,
/turf/simulated/floor/plating/lavaland,
/area/lavaland/idleruins)
"uO" = (
/obj/effect/debris/cleanable/dirt,
/obj/random/firstaid,
/turf/simulated/floor/plating/lavaland,
/area/lavaland/idleruins)
"wX" = (
/obj/structure/dispenser/oxygen{
	oxygentanks = 7
	},
/turf/simulated/shuttle/floor/lavaland,
/area/lavaland/idleruins)
"xU" = (
/obj/effect/debris/cleanable/dirt,
/turf/simulated/floor/plating/lavaland,
/area/lavaland/idleruins)
"yQ" = (
/mob/living/bot/medibot{
	name = "Dr. Crusty"
	},
/turf/simulated/shuttle/floor/lavaland,
/area/lavaland/idleruins)
"zE" = (
/obj/effect/debris/cleanable/dirt,
/obj/structure/frame,
/obj/effect/debris/cleanable/cobweb2,
/turf/simulated/floor/plating/lavaland,
/area/lavaland/idleruins)
"Cr" = (
/obj/effect/debris/cleanable/cobweb,
/obj/effect/debris/cleanable/dirt,
/turf/simulated/floor/plating/lavaland,
/area/lavaland/idleruins)
"DM" = (
/obj/random/unidentified_medicine/fresh_medicine,
/obj/random/unidentified_medicine/fresh_medicine,
/obj/random/unidentified_medicine/viral,
/obj/structure/table,
/turf/simulated/shuttle/floor/lavaland,
/area/lavaland/idleruins)
"EJ" = (
/turf/simulated/floor/outdoors/lavaland,
/area/lavaland/idleruins)
"IJ" = (
/obj/effect/debris/cleanable/vomit,
/turf/simulated/shuttle/floor/lavaland,
/area/lavaland/idleruins)
"IO" = (
/obj/structure/closet/secure_closet/medical3{
	name = "medical locker";
	req_access = list()
	},
/turf/simulated/shuttle/floor/lavaland,
/area/lavaland/idleruins)
"IX" = (
/mob/living/simple_mob/mechanical/cyber_horror/plasma_cyber_horror/surt,
/turf/simulated/shuttle/floor/lavaland,
/area/lavaland/idleruins)
"KO" = (
/obj/structure/closet/secure_closet/sar{
	name = "sar locker";
	req_access = list()
	},
/turf/simulated/shuttle/floor/lavaland,
/area/lavaland/idleruins)
"Mo" = (
/obj/structure/closet/emcloset,
/turf/simulated/shuttle/floor/lavaland,
/area/lavaland/idleruins)
"Of" = (
/obj/effect/debris/cleanable/dirt,
/obj/item/material/shard/shrapnel,
/turf/simulated/floor/plating/lavaland,
/area/lavaland/idleruins)
"Oo" = (
/obj/item/stack/rods,
/turf/simulated/floor/outdoors/lavaland,
/area/lavaland/idleruins)
"Qp" = (
/obj/structure/frame/computer{
	dir = 1
	},
/turf/simulated/shuttle/floor/lavaland,
/area/lavaland/idleruins)
"Qu" = (
/obj/effect/debris/cleanable/dirt,
/obj/effect/debris/cleanable/molten_item,
/turf/simulated/floor/plating/lavaland,
/area/lavaland/idleruins)
"Qv" = (
/obj/structure/ghost_pod/manual/human{
	dir = 8
	},
/turf/simulated/shuttle/floor/lavaland,
/area/lavaland/idleruins)
"Re" = (
/turf/template_noop,
/area/lavaland/idleruins)
"Sk" = (
/turf/simulated/shuttle/floor/lavaland,
/area/lavaland/idleruins)
"Uo" = (
/obj/structure/shuttle/engine/propulsion{
	dir = 4
	},
/turf/simulated/mineral/floor/ignore_mapgen/lavaland,
/area/lavaland/idleruins)
"VZ" = (
/turf/simulated/shuttle/wall/hard_corner,
/area/lavaland/idleruins)
"Wd" = (
/obj/effect/debris/cleanable/dirt,
/obj/item/stack/material/steel,
/turf/simulated/floor/plating/lavaland,
/area/lavaland/idleruins)
"WH" = (
/obj/effect/debris/cleanable/dirt,
/obj/effect/debris/cleanable/blood/oil,
/turf/simulated/floor/plating/lavaland,
/area/lavaland/idleruins)
"WM" = (
/obj/effect/debris/cleanable/dirt,
/obj/effect/decal/remains/posi,
/turf/simulated/floor/plating/lavaland,
/area/lavaland/idleruins)
"Xu" = (
/obj/machinery/door/unpowered/shuttle,
/turf/simulated/floor/plating/lavaland,
/area/lavaland/idleruins)
"XA" = (
/obj/effect/debris/cleanable/dirt,
/obj/item/storage/firstaid/adv,
/turf/simulated/floor/plating/lavaland,
/area/lavaland/idleruins)
"Yt" = (
/obj/machinery/suit_cycler/medical,
/turf/simulated/shuttle/floor/lavaland,
/area/lavaland/idleruins)
"YZ" = (
/turf/simulated/shuttle/wall/lavaland,
/area/lavaland/idleruins)
"Zb" = (
/obj/effect/debris/cleanable/generic,
/turf/simulated/floor/plating/lavaland,
/area/lavaland/idleruins)
"ZP" = (
/obj/effect/debris/cleanable/dirt,
/obj/item/stack/rods,
/turf/simulated/floor/plating/lavaland,
/area/lavaland/idleruins)

(1,1,1) = {"
or
or
or
or
or
or
or
or
or
or
or
or
or
or
or
"}
(2,1,1) = {"
or
or
or
Re
Re
Re
Re
Re
Re
Re
Re
Re
Re
Re
or
"}
(3,1,1) = {"
or
or
or
Re
Re
Re
rw
Oo
oN
oN
Oo
EJ
Re
Re
or
"}
(4,1,1) = {"
or
or
or
YZ
jd
oN
uc
Qu
WH
Wd
XA
Of
kt
YZ
or
"}
(5,1,1) = {"
or
or
or
YZ
zE
xU
uO
Wd
WM
uc
ZP
Zb
hd
YZ
or
"}
(6,1,1) = {"
or
or
or
YZ
YZ
YZ
YZ
VZ
gJ
xU
gJ
sI
Qp
YZ
or
"}
(7,1,1) = {"
or
or
or
YZ
nr
qO
DM
YZ
gJ
gJ
YZ
YZ
YZ
YZ
or
"}
(8,1,1) = {"
or
or
or
YZ
Sk
IJ
gJ
gJ
gJ
gJ
Mo
wX
Yt
YZ
or
"}
(9,1,1) = {"
or
or
or
hv
yQ
xU
cY
YZ
gJ
gJ
xU
rG
Sk
hv
or
"}
(10,1,1) = {"
or
or
or
hv
Sk
rG
KO
YZ
gJ
gJ
Sk
IX
Sk
hv
or
"}
(11,1,1) = {"
or
or
or
YZ
Qv
Sk
IO
YZ
Xu
VZ
hH
ri
ri
YZ
or
"}
(12,1,1) = {"
or
or
or
YZ
YZ
YZ
YZ
YZ
Cr
YZ
YZ
YZ
YZ
YZ
or
"}
(13,1,1) = {"
or
or
or
YZ
Uo
Uo
Uo
VZ
Xu
VZ
Uo
Uo
Uo
YZ
or
"}
(14,1,1) = {"
or
or
or
or
or
or
or
or
or
or
or
or
or
or
or
"}
(15,1,1) = {"
or
or
or
or
or
or
or
or
or
or
or
or
or
or
or
"}
