//MAP CONVERTED BY dmm2tgm.py THIS HEADER COMMENT PREVENTS RECONVERSION, DO NOT REMOVE
"a" = (
/turf/template_noop,
/area/template_noop)
"b" = (
/obj/effect/floor_decal/asteroid,
/turf/simulated/floor/outdoors/lavaland,
/area/lavaland/idleruins)
"c" = (
/obj/structure/table/bench/wooden,
/turf/simulated/floor/wood/lavaland,
/area/lavaland/idleruins)
"d" = (
/turf/simulated/floor/wood/lavaland,
/area/lavaland/idleruins)
"j" = (
/mob/living/simple_mob/mechanical/cyber_horror/corgi/surt,
/turf/simulated/floor/wood/lavaland,
/area/lavaland/idleruins)
"k" = (
/obj/effect/decal/cleanable/blood/gibs,
/obj/structure/table/bench/wooden,
/turf/simulated/floor/wood/lavaland,
/area/lavaland/idleruins)
"l" = (
/obj/effect/decal/cleanable/blood,
/turf/simulated/floor/wood/lavaland,
/area/lavaland/idleruins)
"q" = (
/obj/structure/trash_pile,
/turf/simulated/floor/wood/lavaland,
/area/lavaland/idleruins)
"t" = (
/obj/structure/table/woodentable,
/turf/simulated/floor/wood/lavaland,
/area/lavaland/idleruins)
"v" = (
/obj/effect/floor_decal/asteroid,
/turf/simulated/mineral/floor/ignore_mapgen/lavaland,
/area/lavaland/idleruins)
"w" = (
/turf/simulated/wall/wood,
/area/lavaland/idleruins)
"x" = (
/obj/item/bone,
/obj/effect/decal/cleanable/blood,
/obj/item/material/shard/shrapnel,
/obj/structure/table,
/turf/simulated/floor/wood/lavaland,
/area/lavaland/idleruins)
"y" = (
/obj/item/bone,
/obj/effect/decal/cleanable/blood,
/turf/simulated/floor/outdoors/lavaland,
/area/lavaland/idleruins)
"D" = (
/mob/living/simple_mob/mechanical/cyber_horror/cat_cyber_horror/surt,
/turf/simulated/mineral/floor/ignore_mapgen/lavaland,
/area/lavaland/idleruins)
"E" = (
/turf/simulated/mineral/floor/ignore_mapgen/lavaland,
/area/lavaland/idleruins)
"I" = (
/obj/structure/barricade,
/turf/simulated/floor/wood/lavaland,
/area/lavaland/idleruins)
"M" = (
/turf/simulated/floor/outdoors/lavaland,
/area/lavaland/idleruins)
"N" = (
/obj/structure/loot_pile/surface/bones,
/obj/effect/decal/cleanable/blood,
/turf/simulated/floor/wood/lavaland,
/area/lavaland/idleruins)
"P" = (
/obj/structure/loot_pile/surface/bones,
/obj/effect/decal/cleanable/blood,
/turf/simulated/floor/outdoors/lavaland,
/area/lavaland/idleruins)
"T" = (
/obj/effect/decal/cleanable/blood/gibs,
/turf/simulated/floor/wood/lavaland,
/area/lavaland/idleruins)

(1,1,1) = {"
a
a
a
a
a
a
a
a
a
a
a
a
a
a
a
"}
(2,1,1) = {"
a
E
E
E
E
M
M
M
M
M
M
M
a
a
a
"}
(3,1,1) = {"
a
E
E
D
w
w
I
I
I
w
w
M
a
a
a
"}
(4,1,1) = {"
a
E
E
E
w
t
q
q
q
t
w
M
a
a
a
"}
(5,1,1) = {"
a
a
a
E
w
d
d
d
d
d
w
M
M
M
a
"}
(6,1,1) = {"
a
a
a
E
w
c
k
d
c
c
w
M
M
M
a
"}
(7,1,1) = {"
a
a
a
E
w
d
d
d
d
d
w
M
M
M
a
"}
(8,1,1) = {"
a
a
a
E
w
c
c
j
c
c
w
M
a
a
a
"}
(9,1,1) = {"
a
a
a
E
w
P
d
T
d
d
w
a
a
a
a
"}
(10,1,1) = {"
a
E
E
E
v
b
y
d
c
c
w
a
a
a
a
"}
(11,1,1) = {"
a
E
E
E
w
E
E
d
d
d
w
E
E
E
a
"}
(12,1,1) = {"
a
a
E
E
w
E
t
t
x
t
w
E
E
E
a
"}
(13,1,1) = {"
a
a
E
E
w
d
N
l
d
d
w
E
E
E
a
"}
(14,1,1) = {"
a
a
a
E
w
w
w
w
w
w
w
E
E
a
a
"}
(15,1,1) = {"
a
a
a
a
a
a
a
a
a
a
a
a
a
a
a
"}
