//MAP CONVERTED BY dmm2tgm.py THIS HEADER COMMENT PREVENTS RECONVERSION, DO NOT REMOVE
"a" = (
/turf/simulated/wall,
/area/space)
"c" = (
/obj/machinery/artifact_harvester,
/obj/machinery/air_alarm{
	dir = 8
	},
/turf/simulated/floor/plating/outdoors,
/area/space)
"d" = (
/obj/machinery/door/window/brigdoor,
/turf/simulated/floor/plating/outdoors,
/area/space)
"k" = (
/obj/machinery/artifact_scanpad,
/turf/simulated/floor/plating/outdoors,
/area/space)
"m" = (
/obj/structure/window/reinforced,
/turf/simulated/floor/plating/outdoors,
/area/space)
"p" = (
/obj/machinery/door/airlock/glass/research,
/turf/simulated/floor/plating/outdoors,
/area/space)
"s" = (
/obj/spawner/window/low_wall/reinforced/full,
/turf/simulated/floor/plating/outdoors,
/area/space)
"u" = (
/turf/space/basic,
/area/space)
"v" = (
/obj/machinery/artifact_analyser,
/turf/simulated/floor/plating/outdoors,
/area/space)
"z" = (
/obj/machinery/power/emitter{
	dir = 4
	},
/obj/structure/window/reinforced,
/turf/simulated/floor/plating/outdoors,
/area/space)
"H" = (
/obj/machinery/door/airlock/glass/research,
/turf/simulated/floor/plating/indoors,
/area/space)
"J" = (
/obj/structure/table/rack/shelf,
/turf/simulated/floor/plating/indoors,
/area/space)
"K" = (
/obj/structure/anomaly_container,
/turf/space/basic,
/area/space)
"O" = (
/obj/structure/table/reinforced,
/turf/simulated/floor/plating/outdoors,
/area/space)
"R" = (
/turf/simulated/floor/plating/outdoors,
/area/space)
"T" = (
/obj/spawner/window/low_wall/reinforced/full,
/turf/simulated/floor/plating/indoors,
/area/space)
"V" = (
/obj/machinery/air_alarm{
	dir = 4
	},
/obj/machinery/radiocarbon_spectrometer,
/turf/simulated/floor/plating/outdoors,
/area/space)
"W" = (
/turf/simulated/floor/plating/indoors,
/area/space)
"X" = (
/obj/machinery/door/airlock/multi_tile/glass,
/turf/simulated/floor/plating/indoors,
/area/space)
"Y" = (
/obj/machinery/mech_recharger,
/turf/simulated/floor/plating/indoors,
/area/space)

(1,1,1) = {"
u
u
u
u
u
u
u
u
u
u
u
u
u
u
u
u
u
u
u
u
u
u
u
u
u
u
u
u
u
u
u
u
u
u
u
u
u
u
u
u
"}
(2,1,1) = {"
u
u
u
u
u
u
u
u
u
u
u
u
u
u
u
u
u
u
u
u
u
u
u
u
u
u
u
u
u
u
u
u
u
u
u
u
u
u
u
u
"}
(3,1,1) = {"
u
u
u
u
u
u
u
u
u
u
u
u
u
u
u
u
u
u
u
u
u
u
u
u
u
u
u
u
u
u
u
u
u
u
u
u
u
u
u
u
"}
(4,1,1) = {"
u
u
u
u
u
u
u
u
u
u
u
u
u
u
u
u
u
u
u
u
u
u
u
u
u
u
u
u
u
u
u
u
u
u
u
u
u
u
u
u
"}
(5,1,1) = {"
u
u
u
u
u
u
u
u
u
u
u
u
u
u
u
u
u
u
u
u
u
u
u
u
u
u
u
u
u
u
u
u
u
u
u
u
u
u
u
u
"}
(6,1,1) = {"
u
u
u
u
u
u
u
u
u
u
u
u
u
u
u
u
u
u
u
u
u
u
u
u
u
u
u
u
u
u
u
u
u
u
u
u
u
u
u
u
"}
(7,1,1) = {"
u
u
u
u
u
u
u
u
u
u
u
u
u
u
u
u
u
u
u
u
u
u
u
u
u
u
u
u
u
u
u
u
u
u
u
u
u
u
u
u
"}
(8,1,1) = {"
u
u
u
u
u
u
u
u
u
u
u
u
u
u
u
u
u
u
u
u
u
u
u
u
u
u
u
u
u
u
u
u
u
u
u
u
u
u
u
u
"}
(9,1,1) = {"
u
u
u
u
u
u
u
u
u
u
u
u
u
u
u
u
u
u
u
u
u
u
u
u
u
u
u
u
u
u
u
u
u
u
u
u
u
u
u
u
"}
(10,1,1) = {"
u
u
u
u
u
u
u
u
u
u
u
u
u
u
u
u
u
u
u
u
u
u
u
u
u
u
u
u
u
u
u
u
u
u
u
u
u
u
u
u
"}
(11,1,1) = {"
u
u
u
u
u
u
u
u
u
u
u
u
u
u
u
u
u
u
u
u
u
u
u
u
u
u
u
u
u
u
u
u
u
u
u
u
u
u
u
u
"}
(12,1,1) = {"
u
u
u
u
u
u
u
u
u
u
u
u
u
u
u
u
u
u
u
u
u
u
u
u
u
u
u
u
u
u
u
u
u
u
u
u
u
u
u
u
"}
(13,1,1) = {"
u
u
u
u
u
u
u
u
u
u
u
u
u
u
u
u
u
u
u
u
u
u
u
u
u
u
u
u
u
u
u
u
u
u
u
u
u
u
u
u
"}
(14,1,1) = {"
u
u
u
u
u
u
u
u
u
u
u
u
u
u
u
u
u
u
u
u
u
u
u
u
u
u
u
u
u
u
u
u
u
u
u
u
u
u
u
u
"}
(15,1,1) = {"
u
u
u
u
u
u
u
u
u
u
u
u
u
u
u
W
u
u
u
u
u
u
u
u
u
u
u
u
u
u
u
u
u
u
u
u
u
u
u
u
"}
(16,1,1) = {"
u
u
u
u
u
u
u
u
u
u
u
u
u
W
W
W
W
W
W
u
u
u
u
u
u
u
u
u
u
u
u
u
u
u
u
u
u
u
u
u
"}
(17,1,1) = {"
u
u
u
u
u
u
u
u
u
u
u
W
W
W
W
W
W
W
W
W
W
W
u
u
u
u
u
u
u
u
u
u
u
u
u
u
u
u
u
u
"}
(18,1,1) = {"
u
u
u
u
u
u
u
u
u
u
u
W
W
W
W
W
W
W
W
W
W
W
W
u
u
u
u
u
u
u
u
u
u
u
u
u
u
u
u
u
"}
(19,1,1) = {"
u
u
u
u
u
u
u
u
u
u
u
W
W
W
W
W
W
W
W
W
W
W
W
u
u
u
u
u
a
W
W
a
u
u
u
u
u
u
u
u
"}
(20,1,1) = {"
u
u
u
u
u
u
u
u
u
u
u
W
W
W
W
W
W
W
W
W
W
W
W
u
u
u
u
W
W
Y
Y
W
W
u
u
u
u
u
u
u
"}
(21,1,1) = {"
u
u
u
u
u
u
u
u
u
u
u
W
W
W
W
W
W
W
W
W
W
W
W
u
u
u
u
W
W
Y
Y
W
W
u
u
u
u
u
u
u
"}
(22,1,1) = {"
u
u
u
u
u
u
u
u
u
u
u
W
W
W
W
W
W
W
W
W
W
W
W
u
u
u
u
u
a
W
W
a
u
u
u
u
u
u
u
u
"}
(23,1,1) = {"
u
u
u
u
u
u
u
u
u
u
u
W
W
W
W
W
W
W
W
W
W
W
W
u
u
u
u
u
u
u
u
u
u
u
u
u
u
u
u
u
"}
(24,1,1) = {"
u
u
u
u
u
u
u
u
u
u
u
W
W
W
W
W
W
W
W
W
W
W
u
u
u
u
u
u
u
u
u
u
u
u
u
u
u
u
u
u
"}
(25,1,1) = {"
u
u
u
u
u
u
u
u
u
u
u
u
u
W
W
W
W
W
W
u
u
u
u
u
u
u
u
u
u
u
u
u
u
u
u
u
u
u
u
u
"}
(26,1,1) = {"
u
u
u
u
u
u
u
u
u
u
u
u
u
u
u
W
u
u
u
u
u
u
u
u
u
u
u
u
u
u
u
u
u
u
u
u
u
u
u
u
"}
(27,1,1) = {"
u
u
u
u
u
u
u
u
u
u
u
u
u
u
u
u
u
u
u
u
u
u
u
a
a
a
a
W
W
a
a
a
a
u
u
u
u
u
u
u
"}
(28,1,1) = {"
u
u
u
u
u
u
u
u
u
u
u
u
u
u
u
u
u
u
u
u
u
u
u
a
z
V
R
W
W
T
J
J
a
u
u
u
u
u
u
u
"}
(29,1,1) = {"
u
u
u
u
u
u
u
u
u
u
u
u
u
u
u
u
u
u
u
u
u
u
u
a
d
R
R
W
W
H
W
W
a
u
u
u
u
u
u
u
"}
(30,1,1) = {"
u
u
u
u
u
u
u
u
u
u
u
u
u
u
u
u
u
u
u
u
u
u
u
a
m
O
R
W
W
T
J
J
a
u
u
u
u
u
u
u
"}
(31,1,1) = {"
u
u
u
u
u
u
u
u
u
u
u
u
u
u
u
u
u
u
u
u
u
u
u
a
s
s
s
W
W
a
a
a
a
u
u
u
u
u
u
u
"}
(32,1,1) = {"
u
u
u
u
u
u
u
u
u
u
u
u
u
u
u
u
u
u
u
u
u
u
u
a
k
R
p
W
W
X
K
K
a
u
u
u
u
u
u
u
"}
(33,1,1) = {"
u
u
u
u
u
u
u
u
u
u
u
u
u
u
u
u
u
u
u
u
u
u
u
a
v
c
T
W
W
W
K
K
a
u
u
u
u
u
u
u
"}
(34,1,1) = {"
u
u
u
u
u
u
u
u
u
u
u
u
u
u
u
u
u
u
u
u
u
u
u
a
a
a
a
W
W
a
a
a
a
u
u
u
u
u
u
u
"}
(35,1,1) = {"
u
u
u
u
u
u
u
u
u
u
u
u
u
u
u
u
u
u
u
u
u
u
u
u
u
u
u
u
u
u
u
u
u
u
u
u
u
u
u
u
"}
(36,1,1) = {"
u
u
u
u
u
u
u
u
u
u
u
u
u
u
u
u
u
u
u
u
u
u
u
u
u
u
u
u
u
u
u
u
u
u
u
u
u
u
u
u
"}
(37,1,1) = {"
u
u
u
u
u
u
u
u
u
u
u
u
u
u
u
u
u
u
u
u
u
u
u
u
u
u
u
u
u
u
u
u
u
u
u
u
u
u
u
u
"}
(38,1,1) = {"
u
u
u
u
u
u
u
u
u
u
u
u
u
u
u
u
u
u
u
u
u
u
u
u
u
u
u
u
u
u
u
u
u
u
u
u
u
u
u
u
"}
(39,1,1) = {"
u
u
u
u
u
u
u
u
u
u
u
u
u
u
u
u
u
u
u
u
u
u
u
u
u
u
u
u
u
u
u
u
u
u
u
u
u
u
u
u
"}
(40,1,1) = {"
u
u
u
u
u
u
u
u
u
u
u
u
u
u
u
u
u
u
u
u
u
u
u
u
u
u
u
u
u
u
u
u
u
u
u
u
u
u
u
u
"}
