//MAP CONVERTED BY dmm2tgm.py THIS HEADER COMMENT PREVENTS RECONVERSION, DO NOT REMOVE
"a" = (
/turf/template_noop,
/area/template_noop)
"c" = (
/turf/simulated/floor/sandstone,
/area/submap/one_single_area)
"g" = (
/obj/structure/table/marble,
/obj/item/flame/candle/candelabra/everburn,
/turf/simulated/floor/sandstone,
/area/submap/one_single_area)
"i" = (
/turf/simulated/wall/sandstone,
/area/submap/one_single_area)

(1,1,1) = {"
i
i
i
i
i
i
i
i
i
a
a
a
a
a
a
"}
(2,1,1) = {"
i
c
c
c
c
c
c
c
i
a
a
a
a
a
a
"}
(3,1,1) = {"
i
c
g
c
c
c
g
c
i
a
a
a
a
a
a
"}
(4,1,1) = {"
i
c
c
c
c
c
c
c
i
a
a
a
a
a
a
"}
(5,1,1) = {"
i
c
c
c
i
c
c
c
i
a
a
a
a
a
a
"}
(6,1,1) = {"
i
c
c
c
i
c
c
c
i
i
i
c
c
c
i
"}
(7,1,1) = {"
c
c
c
c
i
c
c
c
c
c
i
c
c
c
c
"}
(8,1,1) = {"
c
c
g
c
i
c
g
c
g
c
i
c
g
c
c
"}
(9,1,1) = {"
c
c
c
c
i
c
c
c
c
c
i
c
c
c
c
"}
(10,1,1) = {"
i
c
c
c
i
i
i
c
c
c
i
c
c
c
i
"}
(11,1,1) = {"
a
a
a
a
a
a
i
c
c
c
i
c
c
c
i
"}
(12,1,1) = {"
a
a
a
a
a
a
i
c
c
c
c
c
c
c
i
"}
(13,1,1) = {"
a
a
a
a
a
a
i
c
g
c
c
c
g
c
i
"}
(14,1,1) = {"
a
a
a
a
a
a
i
c
c
c
c
c
c
c
i
"}
(15,1,1) = {"
a
a
a
a
a
a
i
i
i
i
i
i
i
i
i
"}
