//MAP CONVERTED BY dmm2tgm.py THIS HEADER COMMENT PREVENTS RECONVERSION, DO NOT REMOVE
"aD" = (
/obj/machinery/mech_recharger,
/obj/effect/floor_decal/industrial/warning{
	dir = 1
	},
/turf/simulated/floor/tiled/techmaint,
/area/space)
"bv" = (
/obj/machinery/atmospherics/pipe/tank/phoron{
	volume = 20000
	},
/turf/simulated/floor/tiled/techmaint,
/area/space)
"bB" = (
/obj/machinery/mech_recharger,
/obj/effect/floor_decal/borderfloorblack{
	dir = 4
	},
/obj/effect/floor_decal/industrial/warning{
	dir = 5
	},
/turf/simulated/floor/tiled/techmaint,
/area/space)
"bH" = (
/obj/spawner/window/low_wall/reinforced/full/firelocks,
/turf/space/basic,
/area/space)
"dp" = (
/obj/effect/floor_decal/industrial/warning{
	dir = 1
	},
/obj/machinery/atmospherics/portables_connector{
	dir = 4
	},
/obj/machinery/mech_recharger,
/turf/simulated/floor/tiled/techmaint,
/area/space)
"dB" = (
/obj/machinery/porta_turret/crescent{
	density = 1;
	faction = "neutral"
	},
/turf/space,
/area/space)
"dR" = (
/obj/machinery/mech_recharger,
/obj/vehicle/sealed/mecha/combat/fighter/baron/sec/loaded{
	dir = 1
	},
/obj/effect/floor_decal/borderfloorblack{
	dir = 8
	},
/obj/effect/floor_decal/industrial/warning{
	dir = 8
	},
/turf/simulated/floor/tiled/techmaint,
/area/space)
"eg" = (
/obj/effect/floor_decal/borderfloorblack{
	dir = 4
	},
/obj/effect/floor_decal/industrial/warning{
	dir = 6
	},
/obj/effect/floor_decal/sign/dock/two,
/turf/simulated/floor/tiled/techmaint,
/area/space)
"eI" = (
/obj/machinery/mech_recharger,
/obj/machinery/atmospherics/portables_connector{
	dir = 1
	},
/obj/effect/floor_decal/borderfloorblack{
	dir = 8
	},
/obj/effect/floor_decal/industrial/warning{
	dir = 9
	},
/turf/simulated/floor/tiled/techmaint,
/area/space)
"fv" = (
/turf/space/basic,
/area/space)
"fE" = (
/obj/machinery/computer/ship/navigation/telescreen{
	pixel_y = 24
	},
/turf/simulated/floor/tiled/techmaint,
/area/space)
"fP" = (
/obj/structure/fuel_port{
	pixel_x = 1;
	pixel_y = 30
	},
/turf/simulated/floor/tiled/techmaint,
/area/space)
"gn" = (
/obj/machinery/door/firedoor/glass,
/obj/machinery/door/airlock/voidcraft/vertical{
	name = "Flight Operations"
	},
/obj/map_helper/access_helper/airlock/station/security/department,
/turf/simulated/floor/tiled/techfloor,
/area/space)
"hy" = (
/obj/effect/floor_decal/borderfloorblack{
	dir = 4
	},
/obj/effect/floor_decal/industrial/warning{
	dir = 5
	},
/obj/effect/floor_decal/sign/dock/one,
/obj/machinery/mech_recharger,
/turf/simulated/floor/tiled/techmaint,
/area/space)
"jh" = (
/obj/effect/floor_decal/borderfloorblack{
	dir = 8
	},
/obj/effect/floor_decal/industrial/warning{
	dir = 9
	},
/obj/machinery/mech_recharger,
/turf/simulated/floor/tiled/techmaint,
/area/space)
"jJ" = (
/obj/item/radio/intercom/department/security{
	pixel_y = -24
	},
/obj/structure/table/standard,
/obj/item/storage/firstaid/regular{
	pixel_x = -2;
	pixel_y = -1
	},
/obj/item/storage/firstaid/fire{
	pixel_x = 2;
	pixel_y = 3
	},
/turf/simulated/floor/tiled/techmaint,
/area/space)
"jY" = (
/obj/effect/floor_decal/borderfloorblack{
	dir = 8
	},
/obj/effect/floor_decal/industrial/warning{
	dir = 8
	},
/turf/simulated/floor/tiled/techmaint,
/area/space)
"mp" = (
/obj/effect/floor_decal/borderfloorblack{
	dir = 8
	},
/obj/effect/floor_decal/industrial/warning{
	dir = 10
	},
/turf/simulated/floor/tiled/techmaint,
/area/space)
"mG" = (
/obj/machinery/atmospheric_field_generator/perma,
/obj/machinery/door/blast/regular{
	dir = 4;
	id = "hammerfighterport";
	name = "Port Fighter Bay"
	},
/obj/effect/floor_decal/borderfloorblack{
	dir = 4
	},
/turf/simulated/floor/tiled/techmaint,
/area/space)
"pQ" = (
/obj/effect/floor_decal/borderfloorblack{
	dir = 4
	},
/obj/effect/floor_decal/industrial/warning{
	dir = 4
	},
/turf/simulated/floor/tiled/techmaint,
/area/space)
"qG" = (
/obj/machinery/power/smes/buildable{
	charge = 1.5e+007;
	cur_coils = 3
	},
/turf/simulated/floor/tiled/techmaint,
/area/space)
"qV" = (
/obj/machinery/porta_turret/crescent{
	density = 1;
	faction = "neutral"
	},
/turf/space/basic,
/area/space)
"su" = (
/obj/effect/floor_decal/industrial/warning{
	dir = 1
	},
/obj/machinery/mech_recharger,
/obj/machinery/atmospherics/portables_connector{
	dir = 1
	},
/turf/simulated/floor/tiled/techmaint,
/area/space)
"sA" = (
/obj/machinery/mech_recharger,
/obj/effect/floor_decal/borderfloorblack{
	dir = 4
	},
/obj/effect/floor_decal/industrial/warning{
	dir = 4
	},
/turf/simulated/floor/tiled/techmaint,
/area/space)
"sI" = (
/obj/machinery/mech_recharger,
/obj/machinery/atmospherics/portables_connector{
	dir = 1
	},
/obj/effect/floor_decal/industrial/warning{
	dir = 1
	},
/turf/simulated/floor/tiled/techmaint,
/area/space)
"tu" = (
/obj/machinery/computer/shuttle_control/explore/hammerhead{
	dir = 4
	},
/turf/simulated/floor/tiled/techmaint,
/area/space)
"uT" = (
/obj/effect/floor_decal/borderfloorblack{
	dir = 4
	},
/obj/effect/floor_decal/industrial/warning{
	dir = 6
	},
/obj/effect/floor_decal/sign/dock/two,
/obj/machinery/mech_recharger,
/turf/simulated/floor/tiled/techmaint,
/area/space)
"vD" = (
/obj/effect/floor_decal/borderfloorblack{
	dir = 8
	},
/obj/effect/floor_decal/industrial/warning{
	dir = 8
	},
/obj/machinery/mech_recharger,
/obj/vehicle/sealed/mecha/combat/fighter/baron/sec/loaded{
	dir = 8
	},
/turf/simulated/floor/tiled/techmaint,
/area/space)
"wn" = (
/turf/space,
/area/space)
"wA" = (
/obj/structure/closet/hydrant{
	pixel_y = 32
	},
/turf/simulated/floor/tiled/techmaint,
/area/space)
"wP" = (
/obj/effect/floor_decal/borderfloorblack{
	dir = 8
	},
/obj/effect/floor_decal/industrial/warning{
	dir = 10
	},
/obj/effect/floor_decal/sign/dock/one,
/obj/machinery/mech_recharger,
/turf/simulated/floor/tiled/techmaint,
/area/space)
"xb" = (
/obj/machinery/atmospherics/component/unary/engine{
	dir = 8
	},
/turf/space/basic,
/area/space)
"xm" = (
/obj/effect/floor_decal/borderfloorblack{
	dir = 4
	},
/obj/effect/floor_decal/industrial/warning{
	dir = 6
	},
/turf/simulated/floor/tiled/techmaint,
/area/space)
"yd" = (
/obj/machinery/mech_recharger,
/obj/vehicle/sealed/mecha/combat/fighter/baron/sec/loaded{
	dir = 1
	},
/turf/simulated/floor/tiled/techmaint,
/area/space)
"zb" = (
/obj/effect/floor_decal/industrial/warning,
/obj/machinery/mech_recharger,
/obj/machinery/atmospherics/portables_connector{
	dir = 4
	},
/turf/simulated/floor/tiled/techmaint,
/area/space)
"zl" = (
/obj/vehicle/sealed/mecha/combat/fighter/baron/sec/loaded,
/obj/machinery/mech_recharger,
/obj/machinery/atmospherics/portables_connector{
	dir = 1
	},
/turf/simulated/floor/tiled/techmaint,
/area/space)
"zL" = (
/obj/structure/bed/chair/bay/shuttle,
/turf/simulated/floor/tiled/techfloor,
/area/space)
"AI" = (
/obj/machinery/computer/ship/sensors,
/turf/simulated/floor/tiled/techmaint,
/area/space)
"Bs" = (
/obj/effect/floor_decal/industrial/warning,
/turf/simulated/floor/tiled/techmaint,
/area/space)
"Bx" = (
/obj/machinery/computer/ship/helm,
/turf/simulated/floor/tiled/techmaint,
/area/space)
"Cl" = (
/obj/machinery/atmospherics/component/unary/engine{
	dir = 1
	},
/turf/space/basic,
/area/space)
"CB" = (
/obj/effect/floor_decal/industrial/warning,
/obj/machinery/atmospherics/portables_connector,
/obj/machinery/mech_recharger,
/obj/vehicle/sealed/mecha/combat/fighter/baron/sec/loaded{
	dir = 4
	},
/turf/simulated/floor/tiled/techmaint,
/area/space)
"CE" = (
/turf/simulated/wall/r_wall/prepainted/security,
/area/space)
"DA" = (
/obj/machinery/atmospherics/component/unary/engine,
/turf/space,
/area/space)
"DS" = (
/obj/machinery/atmospheric_field_generator/perma,
/obj/machinery/door/blast/regular{
	dir = 4;
	id = "hammerfighterport";
	name = "Port Fighter Bay"
	},
/turf/simulated/floor/tiled/techmaint,
/area/space)
"Ez" = (
/obj/machinery/mech_recharger,
/obj/vehicle/sealed/mecha/combat/fighter/baron/sec/loaded{
	dir = 4
	},
/turf/simulated/floor/tiled/techmaint,
/area/space)
"Gp" = (
/obj/effect/floor_decal/industrial/warning/full,
/obj/machinery/shipsensors,
/obj/item/gps/internal/base{
	desc = "A tracking beacon embedded in the shuttle systems, to help explorers find where they landed.";
	gps_tag = "BARGE";
	name = "shuttle beacon"
	},
/obj/machinery/light/no_nightshift,
/turf/simulated/floor/plating,
/area/space)
"GB" = (
/obj/effect/floor_decal/borderfloorblack{
	dir = 4
	},
/obj/effect/floor_decal/industrial/warning{
	dir = 5
	},
/turf/simulated/floor/tiled/techmaint,
/area/space)
"Ic" = (
/obj/effect/floor_decal/industrial/warning{
	dir = 1
	},
/turf/simulated/floor/tiled/techmaint,
/area/space)
"IW" = (
/obj/structure/bed/chair/bay/shuttle{
	dir = 8;
	name = "Copilot's Seat"
	},
/turf/simulated/floor/tiled/techmaint,
/area/space)
"JA" = (
/obj/machinery/computer/ship/engines{
	dir = 4
	},
/turf/simulated/floor/tiled/techmaint,
/area/space)
"LW" = (
/obj/machinery/atmospherics/component/unary/engine,
/turf/space/basic,
/area/space)
"LX" = (
/obj/effect/floor_decal/borderfloorblack{
	dir = 8
	},
/obj/effect/floor_decal/industrial/warning{
	dir = 8
	},
/obj/machinery/mech_recharger,
/turf/simulated/floor/tiled/techmaint,
/area/space)
"Mh" = (
/obj/spawner/window/low_wall/reinforced/full/firelocks,
/obj/machinery/porta_turret/crescent{
	density = 1;
	faction = "neutral"
	},
/turf/space/basic,
/area/space)
"Nk" = (
/obj/effect/floor_decal/borderfloorblack{
	dir = 8
	},
/obj/effect/floor_decal/industrial/warning{
	dir = 10
	},
/obj/effect/floor_decal/sign/dock/one,
/turf/simulated/floor/tiled/techmaint,
/area/space)
"PQ" = (
/obj/effect/floor_decal/borderfloorblack{
	dir = 8
	},
/obj/effect/floor_decal/industrial/warning{
	dir = 10
	},
/obj/machinery/mech_recharger,
/obj/vehicle/sealed/mecha/combat/fighter/baron/sec/loaded{
	dir = 8
	},
/turf/simulated/floor/tiled/techmaint,
/area/space)
"QF" = (
/obj/structure/closet/secure_closet/guncabinet/excursion,
/turf/simulated/floor/tiled/techmaint,
/area/space)
"RT" = (
/obj/machinery/atmospheric_field_generator/perma,
/obj/machinery/door/blast/regular{
	dir = 4;
	id = "hammerfighterport";
	name = "Port Fighter Bay"
	},
/obj/effect/floor_decal/borderfloorblack{
	dir = 8
	},
/turf/simulated/floor/tiled/techmaint,
/area/space)
"St" = (
/obj/effect/floor_decal/industrial/warning,
/obj/machinery/mech_recharger,
/turf/simulated/floor/tiled/techmaint,
/area/space)
"Tx" = (
/turf/simulated/floor/tiled/techmaint,
/area/space)
"TE" = (
/obj/structure/bed/chair/bay/shuttle{
	dir = 1
	},
/turf/simulated/floor/tiled/techfloor,
/area/space)
"TJ" = (
/obj/vehicle/sealed/mecha/combat/fighter/baron/sec/loaded,
/obj/effect/floor_decal/borderfloorblack{
	dir = 8
	},
/obj/effect/floor_decal/industrial/warning{
	dir = 8
	},
/obj/machinery/mech_recharger,
/obj/machinery/atmospherics/portables_connector{
	dir = 1
	},
/turf/simulated/floor/tiled/techmaint,
/area/space)
"Us" = (
/obj/effect/floor_decal/borderfloorblack{
	dir = 4
	},
/obj/effect/floor_decal/industrial/warning{
	dir = 4
	},
/obj/machinery/mech_recharger,
/turf/simulated/floor/tiled/techmaint,
/area/space)
"Vi" = (
/obj/machinery/mech_recharger,
/turf/simulated/floor/tiled/techmaint,
/area/space)
"VR" = (
/obj/machinery/atmospherics/component/unary/engine{
	dir = 4
	},
/turf/space,
/area/space)
"YJ" = (
/obj/machinery/air_alarm{
	dir = 4;
	pixel_x = -24
	},
/turf/simulated/floor/tiled/techmaint,
/area/space)
"Zf" = (
/obj/effect/floor_decal/borderfloorblack{
	dir = 8
	},
/obj/effect/floor_decal/industrial/warning{
	dir = 9
	},
/turf/simulated/floor/tiled/techmaint,
/area/space)

(1,1,1) = {"
fv
fv
fv
fv
fv
fv
fv
fv
fv
fv
fv
fv
fv
fv
fv
fv
fv
fv
fv
fv
fv
fv
fv
fv
fv
fv
fv
fv
fv
fv
fv
fv
fv
fv
fv
fv
fv
fv
fv
fv
fv
fv
fv
fv
fv
fv
fv
fv
fv
fv
"}
(2,1,1) = {"
fv
fv
fv
fv
fv
fv
fv
fv
fv
fv
fv
fv
fv
fv
fv
fv
fv
fv
fv
fv
fv
fv
fv
fv
fv
fv
fv
fv
fv
fv
fv
fv
fv
fv
fv
fv
fv
fv
fv
fv
fv
fv
fv
fv
fv
fv
fv
fv
fv
fv
"}
(3,1,1) = {"
fv
fv
fv
fv
fv
fv
fv
fv
fv
fv
fv
fv
fv
fv
fv
fv
fv
fv
fv
fv
fv
fv
fv
fv
fv
fv
fv
fv
fv
fv
fv
fv
fv
fv
fv
fv
fv
fv
fv
fv
fv
fv
fv
fv
fv
fv
fv
fv
fv
fv
"}
(4,1,1) = {"
fv
fv
fv
fv
fv
fv
fv
fv
fv
fv
fv
fv
fv
fv
fv
fv
fv
fv
fv
fv
fv
fv
fv
fv
fv
fv
fv
fv
fv
fv
fv
fv
fv
fv
fv
fv
fv
fv
fv
fv
fv
fv
fv
fv
fv
fv
fv
fv
fv
fv
"}
(5,1,1) = {"
fv
fv
fv
fv
fv
fv
fv
fv
fv
fv
fv
fv
fv
fv
fv
fv
fv
fv
fv
fv
fv
fv
fv
fv
fv
fv
fv
fv
fv
fv
fv
fv
fv
fv
fv
fv
fv
fv
fv
fv
fv
fv
fv
fv
fv
fv
fv
fv
fv
fv
"}
(6,1,1) = {"
fv
fv
fv
fv
fv
fv
fv
fv
fv
fv
fv
fv
fv
fv
fv
fv
fv
fv
fv
fv
fv
fv
fv
fv
fv
fv
fv
fv
fv
fv
fv
fv
fv
fv
fv
fv
fv
fv
fv
fv
fv
fv
fv
fv
fv
fv
fv
fv
fv
fv
"}
(7,1,1) = {"
fv
fv
fv
fv
fv
fv
fv
fv
fv
fv
fv
fv
fv
fv
fv
fv
fv
fv
fv
fv
fv
fv
fv
fv
fv
fv
fv
fv
fv
fv
fv
fv
fv
fv
fv
fv
fv
fv
fv
fv
fv
fv
fv
fv
fv
fv
fv
fv
fv
fv
"}
(8,1,1) = {"
fv
fv
fv
fv
fv
fv
fv
fv
fv
fv
fv
fv
fv
fv
fv
fv
fv
fv
fv
fv
fv
fv
fv
fv
fv
fv
fv
fv
fv
fv
fv
fv
fv
fv
fv
fv
fv
fv
fv
fv
fv
fv
fv
fv
fv
fv
fv
fv
fv
fv
"}
(9,1,1) = {"
fv
fv
fv
fv
fv
fv
fv
fv
fv
fv
fv
fv
fv
fv
fv
wn
wn
wn
wn
wn
wn
wn
wn
wn
wn
wn
wn
wn
wn
wn
wn
wn
wn
wn
wn
wn
wn
fv
fv
fv
fv
fv
fv
fv
fv
fv
fv
fv
fv
fv
"}
(10,1,1) = {"
fv
fv
fv
fv
fv
fv
fv
fv
fv
fv
fv
fv
fv
fv
fv
wn
wn
wn
wn
wn
wn
wn
wn
wn
wn
wn
wn
wn
wn
wn
wn
wn
wn
wn
wn
wn
wn
fv
fv
fv
fv
fv
fv
fv
fv
fv
fv
fv
fv
fv
"}
(11,1,1) = {"
fv
fv
fv
fv
fv
fv
fv
fv
fv
fv
fv
fv
fv
fv
fv
wn
wn
wn
wn
wn
wn
wn
wn
wn
wn
wn
wn
wn
wn
wn
wn
wn
wn
wn
wn
wn
wn
fv
fv
fv
fv
fv
fv
fv
fv
fv
fv
fv
fv
fv
"}
(12,1,1) = {"
fv
fv
fv
fv
fv
fv
fv
fv
fv
fv
fv
fv
fv
fv
fv
wn
wn
wn
wn
wn
wn
wn
VR
CE
RT
DS
DS
mG
CE
VR
wn
wn
wn
wn
wn
wn
wn
fv
fv
fv
fv
fv
fv
fv
fv
fv
fv
fv
fv
fv
"}
(13,1,1) = {"
fv
fv
fv
fv
fv
fv
fv
fv
fv
fv
fv
fv
fv
fv
fv
wn
wn
wn
wn
wn
wn
dB
CE
CE
jh
vD
LX
PQ
CE
CE
dB
fv
wn
wn
wn
wn
wn
fv
fv
fv
fv
fv
fv
fv
fv
fv
fv
fv
fv
fv
"}
(14,1,1) = {"
fv
fv
fv
fv
fv
fv
fv
fv
fv
fv
fv
fv
fv
fv
fv
wn
wn
wn
wn
dB
Mh
bH
CE
CE
dp
Vi
Vi
zb
CE
CE
CE
fv
wn
wn
wn
wn
wn
fv
fv
fv
fv
fv
fv
fv
fv
fv
fv
fv
fv
fv
"}
(15,1,1) = {"
fv
fv
fv
fv
fv
fv
fv
fv
fv
fv
fv
fv
fv
fv
fv
fv
fv
wn
wn
Mh
bH
tu
JA
CE
GB
pQ
pQ
xm
CE
wA
CE
CE
CE
wn
wn
wn
wn
fv
fv
fv
fv
fv
fv
fv
fv
fv
fv
fv
fv
fv
"}
(16,1,1) = {"
fv
fv
fv
fv
fv
fv
fv
fv
fv
fv
fv
fv
fv
fv
fv
fv
fv
wn
dB
bH
Bx
IW
Tx
CE
CE
gn
gn
CE
CE
Tx
Tx
Tx
CE
dB
wn
wn
wn
fv
fv
fv
fv
fv
fv
fv
fv
fv
fv
fv
fv
fv
"}
(17,1,1) = {"
fv
fv
fv
fv
fv
fv
fv
fv
fv
fv
fv
fv
fv
fv
fv
fv
fv
DA
CE
CE
AI
Tx
Tx
Tx
Tx
Tx
Tx
Tx
YJ
Tx
Tx
QF
CE
CE
Cl
wn
wn
fv
fv
fv
fv
fv
fv
fv
fv
fv
fv
fv
fv
fv
"}
(18,1,1) = {"
fv
fv
fv
fv
fv
fv
fv
fv
fv
fv
fv
fv
fv
fv
fv
fv
fv
CE
CE
CE
CE
CE
fP
Tx
Tx
Tx
Tx
Tx
Tx
Tx
CE
CE
CE
CE
CE
wn
wn
fv
fv
fv
fv
fv
fv
fv
fv
fv
fv
fv
fv
fv
"}
(19,1,1) = {"
fv
fv
fv
fv
fv
fv
fv
fv
fv
fv
fv
fv
fv
fv
fv
fv
fv
RT
eI
dR
Nk
CE
Tx
Tx
Tx
TE
zL
Tx
Tx
Tx
CE
Zf
TJ
wP
RT
fv
fv
fv
fv
fv
fv
fv
fv
fv
fv
fv
fv
fv
fv
fv
"}
(20,1,1) = {"
fv
fv
fv
fv
fv
fv
fv
fv
fv
fv
fv
fv
fv
fv
fv
fv
fv
DS
aD
Vi
Bs
gn
Tx
Tx
Tx
TE
zL
Tx
Tx
Tx
gn
Ic
Vi
St
DS
fv
fv
fv
fv
fv
fv
fv
fv
fv
fv
fv
fv
fv
fv
fv
"}
(21,1,1) = {"
fv
fv
fv
fv
fv
fv
fv
fv
fv
fv
fv
fv
fv
fv
fv
fv
fv
DS
sI
yd
Bs
gn
Tx
Tx
Tx
TE
zL
Tx
Tx
Tx
gn
Ic
zl
St
DS
fv
fv
fv
fv
fv
fv
fv
fv
fv
fv
fv
fv
fv
fv
fv
"}
(22,1,1) = {"
fv
fv
fv
fv
fv
fv
fv
fv
fv
fv
fv
fv
fv
fv
fv
fv
fv
mG
bB
sA
eg
CE
Tx
Tx
Tx
TE
zL
Tx
Tx
Tx
CE
GB
Us
uT
mG
fv
fv
fv
fv
fv
fv
fv
fv
fv
fv
fv
fv
fv
fv
fv
"}
(23,1,1) = {"
fv
fv
fv
fv
fv
fv
fv
fv
fv
fv
fv
fv
fv
fv
fv
fv
fv
CE
CE
CE
CE
CE
fE
Tx
Tx
Tx
Tx
Tx
Tx
Tx
CE
CE
CE
CE
CE
fv
fv
fv
fv
fv
fv
fv
fv
fv
fv
fv
fv
fv
fv
fv
"}
(24,1,1) = {"
fv
fv
fv
fv
fv
fv
fv
fv
fv
fv
fv
fv
fv
fv
fv
fv
fv
LW
CE
CE
qG
Tx
Tx
Tx
Tx
Tx
Tx
Tx
Tx
Tx
Tx
jJ
CE
CE
Cl
fv
fv
fv
fv
fv
fv
fv
fv
fv
fv
fv
fv
fv
fv
fv
"}
(25,1,1) = {"
fv
fv
fv
fv
fv
fv
fv
fv
fv
fv
fv
fv
fv
fv
fv
fv
fv
fv
qV
CE
CE
Tx
Tx
CE
CE
gn
gn
CE
CE
Tx
Tx
Tx
gn
fv
fv
fv
fv
fv
fv
fv
fv
fv
fv
fv
fv
fv
fv
fv
fv
fv
"}
(26,1,1) = {"
fv
fv
fv
fv
fv
fv
fv
fv
fv
fv
fv
fv
fv
fv
fv
fv
fv
fv
fv
Gp
CE
Tx
bv
CE
Zf
jY
jY
mp
CE
Tx
Tx
CE
CE
fv
fv
fv
fv
fv
fv
fv
fv
fv
fv
fv
fv
fv
fv
fv
fv
fv
"}
(27,1,1) = {"
fv
fv
fv
fv
fv
fv
fv
fv
fv
fv
fv
fv
fv
fv
fv
fv
fv
fv
fv
fv
CE
CE
CE
CE
su
Ez
Vi
CB
CE
CE
CE
CE
qV
fv
fv
fv
fv
fv
fv
fv
fv
fv
fv
fv
fv
fv
fv
fv
fv
fv
"}
(28,1,1) = {"
fv
fv
fv
fv
fv
fv
fv
fv
fv
fv
fv
fv
fv
fv
fv
fv
fv
fv
fv
fv
fv
qV
CE
CE
hy
Us
Us
uT
CE
CE
qV
fv
fv
fv
fv
fv
fv
fv
fv
fv
fv
fv
fv
fv
fv
fv
fv
fv
fv
fv
"}
(29,1,1) = {"
fv
fv
fv
fv
fv
fv
fv
fv
fv
fv
fv
fv
fv
fv
fv
fv
fv
fv
fv
fv
fv
fv
xb
CE
RT
DS
DS
mG
CE
xb
fv
fv
fv
fv
fv
fv
fv
fv
fv
fv
fv
fv
fv
fv
fv
fv
fv
fv
fv
fv
"}
(30,1,1) = {"
fv
fv
fv
fv
fv
fv
fv
fv
fv
fv
fv
fv
fv
fv
fv
fv
fv
fv
fv
fv
fv
fv
fv
fv
fv
fv
fv
fv
fv
fv
fv
wn
fv
fv
fv
fv
fv
fv
fv
fv
fv
fv
fv
fv
fv
fv
fv
fv
fv
fv
"}
(31,1,1) = {"
fv
fv
fv
fv
fv
fv
fv
fv
fv
fv
fv
fv
fv
fv
fv
fv
fv
fv
fv
fv
fv
fv
fv
fv
fv
fv
fv
fv
fv
fv
fv
fv
fv
fv
fv
fv
fv
fv
fv
fv
fv
fv
fv
fv
fv
fv
fv
fv
fv
fv
"}
(32,1,1) = {"
fv
fv
fv
fv
fv
fv
fv
fv
fv
fv
fv
fv
fv
fv
fv
fv
fv
fv
fv
fv
fv
fv
fv
fv
fv
fv
fv
fv
fv
fv
fv
fv
fv
fv
fv
fv
fv
fv
fv
fv
fv
fv
fv
fv
fv
fv
fv
fv
fv
fv
"}
(33,1,1) = {"
fv
fv
fv
fv
fv
fv
fv
fv
fv
fv
fv
fv
fv
fv
fv
fv
fv
fv
fv
fv
fv
fv
fv
fv
fv
fv
fv
fv
fv
fv
fv
fv
fv
fv
fv
fv
fv
fv
fv
fv
fv
fv
fv
fv
fv
fv
fv
fv
fv
fv
"}
(34,1,1) = {"
fv
fv
fv
fv
fv
fv
fv
fv
fv
fv
fv
fv
fv
fv
fv
fv
fv
fv
fv
fv
fv
fv
fv
fv
fv
fv
fv
fv
fv
fv
fv
fv
fv
fv
fv
fv
fv
fv
fv
fv
fv
fv
fv
fv
fv
fv
fv
fv
fv
fv
"}
(35,1,1) = {"
fv
fv
fv
fv
fv
fv
fv
fv
fv
fv
fv
fv
fv
fv
fv
fv
fv
fv
fv
fv
fv
fv
fv
fv
fv
fv
fv
fv
fv
fv
fv
fv
fv
fv
fv
fv
fv
fv
fv
fv
fv
fv
fv
fv
fv
fv
fv
fv
fv
fv
"}
(36,1,1) = {"
fv
fv
fv
fv
fv
fv
fv
fv
fv
fv
fv
fv
fv
fv
fv
fv
fv
fv
fv
fv
fv
fv
fv
fv
fv
fv
fv
fv
fv
fv
fv
fv
fv
fv
fv
fv
fv
fv
fv
fv
fv
fv
fv
fv
fv
fv
fv
fv
fv
fv
"}
(37,1,1) = {"
fv
fv
fv
fv
fv
fv
fv
fv
fv
fv
fv
fv
fv
fv
fv
fv
fv
fv
fv
fv
fv
fv
fv
fv
fv
fv
fv
fv
fv
fv
fv
fv
fv
fv
fv
fv
fv
fv
fv
fv
fv
fv
fv
fv
fv
fv
fv
fv
fv
fv
"}
(38,1,1) = {"
fv
fv
fv
fv
fv
fv
fv
fv
fv
fv
fv
fv
fv
fv
fv
fv
fv
fv
fv
fv
fv
fv
fv
fv
fv
fv
fv
fv
fv
fv
fv
fv
fv
fv
fv
fv
fv
fv
fv
fv
fv
fv
fv
fv
fv
fv
fv
fv
fv
fv
"}
(39,1,1) = {"
fv
fv
fv
fv
fv
fv
fv
fv
fv
fv
fv
fv
fv
fv
fv
fv
fv
fv
fv
fv
fv
fv
fv
fv
fv
fv
fv
fv
fv
fv
fv
fv
fv
fv
fv
fv
fv
fv
fv
fv
fv
fv
fv
fv
fv
fv
fv
fv
fv
fv
"}
(40,1,1) = {"
fv
fv
fv
fv
fv
fv
fv
fv
fv
fv
fv
fv
fv
fv
fv
fv
fv
fv
fv
fv
fv
fv
fv
fv
fv
fv
fv
fv
fv
fv
fv
fv
fv
fv
fv
fv
fv
fv
fv
fv
fv
fv
fv
fv
fv
fv
fv
fv
fv
fv
"}
(41,1,1) = {"
fv
fv
fv
fv
fv
fv
fv
fv
fv
fv
fv
fv
fv
fv
fv
fv
fv
fv
fv
fv
fv
fv
fv
fv
fv
fv
fv
fv
fv
fv
fv
fv
fv
fv
fv
fv
fv
fv
fv
fv
fv
fv
fv
fv
fv
fv
fv
fv
fv
fv
"}
(42,1,1) = {"
fv
fv
fv
fv
fv
fv
fv
fv
fv
fv
fv
fv
fv
fv
fv
fv
fv
fv
fv
fv
fv
fv
fv
fv
fv
fv
fv
fv
fv
fv
fv
fv
fv
fv
fv
fv
fv
fv
fv
fv
fv
fv
fv
fv
fv
fv
fv
fv
fv
fv
"}
(43,1,1) = {"
fv
fv
fv
fv
fv
fv
fv
fv
fv
fv
fv
fv
fv
fv
fv
fv
fv
fv
fv
fv
fv
fv
fv
fv
fv
fv
fv
fv
fv
fv
fv
fv
fv
fv
fv
fv
fv
fv
fv
fv
fv
fv
fv
fv
fv
fv
fv
fv
fv
fv
"}
(44,1,1) = {"
fv
fv
fv
fv
fv
fv
fv
fv
fv
fv
fv
fv
fv
fv
fv
fv
fv
fv
fv
fv
fv
fv
fv
fv
fv
fv
fv
fv
fv
fv
fv
fv
fv
fv
fv
fv
fv
fv
fv
fv
fv
fv
fv
fv
fv
fv
fv
fv
fv
fv
"}
(45,1,1) = {"
fv
fv
fv
fv
fv
fv
fv
fv
fv
fv
fv
fv
fv
fv
fv
fv
fv
fv
fv
fv
fv
fv
fv
fv
fv
fv
fv
fv
fv
fv
fv
fv
fv
fv
fv
fv
fv
fv
fv
fv
fv
fv
fv
fv
fv
fv
fv
fv
fv
fv
"}
(46,1,1) = {"
fv
fv
fv
fv
fv
fv
fv
fv
fv
fv
fv
fv
fv
fv
fv
fv
fv
fv
fv
fv
fv
fv
fv
fv
fv
fv
fv
fv
fv
fv
fv
fv
fv
fv
fv
fv
fv
fv
fv
fv
fv
fv
fv
fv
fv
fv
fv
fv
fv
fv
"}
(47,1,1) = {"
fv
fv
fv
fv
fv
fv
fv
fv
fv
fv
fv
fv
fv
fv
fv
fv
fv
fv
fv
fv
fv
fv
fv
fv
fv
fv
fv
fv
fv
fv
fv
fv
fv
fv
fv
fv
fv
fv
fv
fv
fv
fv
fv
fv
fv
fv
fv
fv
fv
fv
"}
(48,1,1) = {"
fv
fv
fv
fv
fv
fv
fv
fv
fv
fv
fv
fv
fv
fv
fv
fv
fv
fv
fv
fv
fv
fv
fv
fv
fv
fv
fv
fv
fv
fv
fv
fv
fv
fv
fv
fv
fv
fv
fv
fv
fv
fv
fv
fv
fv
fv
fv
fv
fv
fv
"}
(49,1,1) = {"
fv
fv
fv
fv
fv
fv
fv
fv
fv
fv
fv
fv
fv
fv
fv
fv
fv
fv
fv
fv
fv
fv
fv
fv
fv
fv
fv
fv
fv
fv
fv
fv
fv
fv
fv
fv
fv
fv
fv
fv
fv
fv
fv
fv
fv
fv
fv
fv
fv
fv
"}
(50,1,1) = {"
fv
fv
fv
fv
fv
fv
fv
fv
fv
fv
fv
fv
fv
fv
fv
fv
fv
fv
fv
fv
fv
fv
fv
fv
fv
fv
fv
fv
fv
fv
fv
fv
fv
fv
fv
fv
fv
fv
fv
fv
fv
fv
fv
fv
fv
fv
fv
fv
fv
fv
"}
